morgunmatur	m ɔ r k ʏ n m aː t ʏ r
wiium	v iː j ʏ m
ári	a uː r ɪ
þorlákína	θ ɔ r l a uː c iː n a
kengur	cʰ e i ŋ k ʏ r
græðgi	k r a i ð c ɪ
lundur	l ʏ n t ʏ r
trúarlegur	tʰ r uː a r l ɛː ɣ ʏ r
nýr	n iː r
bílskúr	p i l s k uː r
dimma	t ɪ mː a
alræði	a l r a iː ð ɪ
sannfærandi	s a nː f a iː r a n t ɪ
pistasía	pʰ ɪ s t a s iː j a
fæ	f a iː
sjálfsmynd	s j a u l v s m ɪ n t
mjöl	m j œː l
áræði	a uː r a iː ð ɪ
aldin	a l t ɪ n
miðbaugur	m ɪ ð p ø yː ɣ ʏ r
klerkur	kʰ l ɛ r̥ k ʏ r
skíðaþjálfari	s c iː ð a θ j a u l v aː r ɪ
lindifura	l ɪ n t ɪ f ʏː r a
hallgerður	h a t l c ɛ r ð ʏ r
meik	m e iː k
gangbraut	k a u ŋ k p r ø yː t
undirlendi	ʏ n t ɪ r l ɛ n t ɪ
kalkúnn	kʰ a l̥ k u t n
víst	v i s t
þema	θ ɛː m a
baks	p a k s
sögur	s œː ɣ ʏ r
baðkar	p a ð kʰ aː r
blýantur	p l iː a n t ʏ r
einarína	e iː n aː r iː n a
líffræðilegur	l i f f r a iː ð ɪ l ɛː ɣ ʏ r
inséníör	ɪ n s j ɛː n i j œː r
dirfska	t ɪ r v s k a
minnismerki	m ɪ nː ɪ s m ɛ r̥ c ɪ
fórna	f o u r t n a
málfar	m a u l f aː r
hjálparsagnorð	ç a u l̥ p a r s a k n ɔ r ð
serða	s ɛ r ð a
höfuðsmaður	h œː v ʏ ð s m aː ð ʏ r
lokkur	l ɔ h k ʏ r
anda	a n t a
yrkja	ɪ r̥ c a
skemmtilegur	s k ɛ m̥ t ɪ l ɛː ɣ ʏ r
laugasef	l ø yː ɣ a s ɛː v
fangi	f a u ɲ c ɪ
smetti	s m ɛ h t ɪ
skemill	s c ɛː m ɪ t l
hlera	l̥ ɛː r a
sníkja	s n iː c a
þegn	θ ɛ k n
æruprís	a iː r ʏ pʰ r iː s
bú	p uː
eyjafjallajökull	e iː j a f j a t l a j œː k ʏ t l
hringtorg	r̥ i ŋ k tʰ ɔ r k
brot	p r ɔː t
ættkvísl	a i h t kʰ v i s t l
vanrækja	v a n r a iː c a
ambaga	a m p aː ɣ a
brúðkaupsnótt	p r u ð kʰ ø y p s n o u h t
kálfi	kʰ a u l v ɪ
halldórsdóttir	h a l t o u r̥ s t o u h t ɪ r
sökkva	s œ h k v a
þúbróðir	θ uː p r o uː ð ɪ r
vordís	v ɔ r t iː s
útlendur	uː t l ɛ n t ʏ r
skjótur	s c o uː t ʏ r
vilji	v ɪ l j ɪ
fólínsýra	f o uː l iː n s iː r a
skeyti	s c e iː t ɪ
kleppur	kʰ l ɛ h p ʏ r
trikk	tʰ r ɪ h k
nískur	n i s k ʏ r
skoskur	s k ɔ s k ʏ r
tónfræði	tʰ o u n f r a iː ð ɪ
vistvænn	v ɪ s t v a i t n
samsæta	s a m s a iː t a
grind	k r ɪ n t
skúlína	s k uː l iː n a
samnefndur	s a m n ɛ m t ʏ r
alaskavíðir	aː l a s k a v iː ð ɪ r
kýta	cʰ iː t a
drykkja	t r ɪ h c a
þerra	θ ɛ rː a
gýgur	c iː ɣ ʏ r
rán	r a uː n
endaþarmsmök	ɛ n t a θ a r m s m œː k
fylla	f ɪ t l a
prjónn	pʰ r j o u t n
félagaskiptagluggi	f j ɛː l aː ɣ a s c ɪ f t a k l ʏ cː ɪ
sleppa	s t l ɛ h p a
afbrigði	a v p r ɪ ɣ ð ɪ
sloj	s t l ɔ iː
gúrka	k u r̥ k a
strikamerki	s t r ɪː k a m ɛ r̥ c ɪ
erfðamengi	ɛ r v ð a m e i ɲ c ɪ
aðall	aː ð a t l
frískur	f r i s k ʏ r
skelfa	s c ɛ l v a
vettvangur	v ɛ h t v a u ŋ k ʏ r
smygill	s m ɪː j ɪ t l
flaski	f l a s c ɪ
efi	ɛː v ɪ
dul	t ʏː l
frí	f r iː
pía	pʰ iː j a
kyrr	cʰ ʏː r
fjáður	f j a uː ð ʏ r
hreinn	r̥ e i t n
tog	tʰ ɔː ɣ
minnihluti	m ɪ nː ɪ l̥ ʏː t ɪ
byrði	p ɪ r ð ɪ
seiður	s e iː ð ʏ r
þykja	θ ɪː c a
rödd	r œ tː
péttneska	pʰ j ɛ h t n ɛ s k a
bika	p ɪː k a
afturbeygður	a f t ʏ r p e i ɣ ð ʏ r
daglega	t a ɣ l ɛː ɣ a
sjúkdómur	s j uː k t o uː m ʏ r
stirður	s t ɪ r ð ʏ r
tittlingur	tʰ ɪ h t l i ŋ k ʏ r
gróp	k r o uː p
syrja	s ɪ r j a
lappi	l a h p ɪ
bann	p a nː
fallbyssa	f a t l p ɪ sː a
ösp	œ s p
hvap	kʰ v aː p
faldur	f a l t ʏ r
olnbogabót	ɔ l n p ɔː ɣ a p o uː t
andlag	a n t l aː ɣ
men	m ɛː n
keisaraskurður	cʰ e iː s aː r a s k ʏ r ð ʏ r
afæta	aː v a iː t a
birgir	p ɪ r c ɪ r
át	a uː t
huggulegur	h ʏ kː ʏ l ɛː ɣ ʏ r
þána	θ a uː n a
örlög	œ r l œː ɣ
lyndi	l ɪ n t ɪ
friður	f r ɪː ð ʏ r
gleypa	k l e iː p a
box	p ɔ x s
ómega	o uː m ɛː k a
bjöggi	p j œ cː ɪ
kvabba	kʰ v a pː a
hvíld	xʷ i l t
nærverufall	n a i r v ɛː r ʏ f a t l
enska	ɛ n s k a
bæklingur	p a i h k l i ŋ k ʏ r
zeta	s ɛː t a
tugabrot	tʰ ʏː ɣ a p r ɔː t
karlmaður	kʰ a r t l m aː ð ʏ r
legnám	l ɛ ɣ n a uː m
móeiður	m o uː e iː ð ʏ r
erfingi	ɛ r v i ɲ c ɪ
glúmur	k l uː m ʏ r
hvalur	kʰ v aː l ʏ r
akbraut	aː k p r ø yː t
markstöng	m a r̥ k s t ø y ŋ k
imbakassi	ɪ m p a kʰ a sː ɪ
rísa	r iː s a
bjáni	p j a uː n ɪ
spendýr	s p ɛ n t iː r
brómber	p r o u m p ɛː r
stoppun	s t ɔ h p ʏ n
þráðnykra	θ r a u ð n ɪː k r a
maltur	m a l̥ t ʏ r
framan	f r aː m a n
orðhlutafræði	ɔ r ð l̥ ʏː t a f r a iː ð ɪ
aðili	aː ð ɪː l ɪ
mánudagur	m a uː n ʏ t aː ɣ ʏ r
blíður	p l iː ð ʏ r
gikkur	c ɪ h k ʏ r
seifur	s e iː v ʏ r
svona	s ɔː n a
skeggburkni	s c ɛ kː p ʏ r̥ k n ɪ
fægja	f a iː j a
forsæla	f ɔ r̥ s a iː l a
segl	s ɛ k l
píla	pʰ iː l a
spítt	s p i h t
rauður	r ø yː ð ʏ r
feitur	f e iː t ʏ r
hryssingur	r̥ ɪ sː i ŋ k ʏ r
keipur	cʰ e iː p ʏ r
grúi	k r uː ɪ
leikvangur	l e iː k v a u ŋ k ʏ r
orgel	ɔ r k ɛː l
beykitré	p e iː c ɪ t r j ɛː
jórunn	j o uː r ʏ nː
eldur	ɛ l t ʏ r
hæð	h a iː ð
hor	h ɔː r
píning	pʰ iː n i ŋ k
útibú	uː t ɪ p uː
repja	r ɛː p j a
hárleggjastör	h a u r l ɛ cː a s t œː r
viðja	v ɪ ð j a
tregða	tʰ r ɛ ɣ ð a
kirtill	cʰ ɪ r̥ t ɪ t l
föt	f œː t
gæfa	c a iː v a
lögregluþjónn	l œ ɣ r ɛ k l ʏ θ j o u t n
lýðræði	l i ð r a iː ð ɪ
þórdís	θ o u r t iː s
öryggisstig	œː r ɪ cː ɪ s s t ɪː ɣ
jafnt	j a m̥ t
málverk	m a u l v ɛ r̥ k
tefja	tʰ ɛ v j a
hreppur	r̥ ɛ h p ʏ r
eykt	e i x t
baða	p aː ð a
auðvald	ø y ð v a l t
sem	s ɛː m
kommúnismi	kʰ ɔ mː uː n ɪ s m ɪ
snjór	s n j o uː r
virka	v ɪ r̥ k a
afturhald	a f t ʏ r h a l t
hreindýrakjöt	r̥ e i n t iː r a cʰ œː t
kónguló	kʰ o u ŋ k ʏ l o uː
viða	v ɪː ð a
iðulega	ɪː ð ʏ l ɛː ɣ a
natrín	n aː t r iː n
kaffivél	kʰ a fː ɪ v j ɛː l
afríkanska	aː f r iː kʰ a n s k a
rotna	r ɔ h t n a
rota	r ɔː t a
prenta	pʰ r ɛ n̥ t a
bergsóley	p ɛ r k s o uː l e iː
trufla	tʰ r ʏ p l a
smit	s m ɪː t
nifteind	n ɪ f t e i n t
lautinant	l ø yː tʰ ɪ n a n̥ t
keifa	cʰ e iː v a
hljóðkerfisfræði	l̥ j o uː ð cʰ ɛ r v ɪ s f r a iː ð ɪ
byssukúla	p ɪ sː ʏ kʰ uː l a
maurígull	m ø yː r iː ɣ ʏ t l
herða	h ɛ r ð a
salvadori	s a l v a t ɔː r ɪ
traust	tʰ r ø y s t
hlána	l̥ a uː n a
hyr	h ɪː r
þrútna	θ r u h t n a
refsa	r ɛ f s a
púls	pʰ u l s
páskabróðir	pʰ a u s k a p r o uː ð ɪ r
öryggisfyrirtæki	œː r ɪ cː ɪ s f ɪː r ɪ r tʰ a iː c ɪ
þeyja	θ e iː j a
brúka	b r uː k a
stokkhólmur	s t ɔ h k h o u l m ʏ r
stó	s t o uː
vilhjálmína	v ɪ l ç a u l m iː n a
brýna	p r iː n a
fjallavíðir	f j a t l a v iː ð ɪ r
lógresi	l o uː k r ɛː s ɪ
hænsn	h a i n s t n
hrókering	r̥ o uː c ɛ r i ŋ k
jarðhneta	j a r ð n̥ ɛː t a
leið	l e iː ð
kassi	kʰ a sː ɪ
sinfónía	s ɪ n f o uː n iː j a
vísifingur	v iː s ɪ f i ŋ k ʏ r
kaup	kʰ ø yː p
möller	m œ lː ɛ r
gálaus	k a uː l ø yː s
áður	a uː ð ʏ r
traustur	tʰ r ø y s t ʏ r
laut	l ø yː t
fjandi	f j a n t ɪ
sagnfylling	s a k n f ɪ t l i ŋ k
kynlaus	cʰ ɪ n l ø yː s
rjátl	r j a u h t l
blóraböggull	p l o uː r a p œ kː ʏ t l
trésmíði	tʰ r j ɛː s m iː ð ɪ
má	m a uː
stjörnuspeki	s t j œ r t n ʏ s p ɛː c ɪ
stjúpdóttir	s t j uː p t o u h t ɪ r
rós	r o uː s
unna	ʏ nː a
hnetubrjótur	n̥ ɛː t ʏ p r j o uː t ʏ r
lipurð	l ɪː p ʏ r ð
luma	l ʏː m a
staðhæfa	s t a ð h a iː v a
haull	h ø y t l
tabú	tʰ aː p uː
þrennur	θ r ɛ nː ʏ r
fregna	f r ɛ k n a
forrita	f ɔ rː ɪː t a
lífeðlisfræði	l iː v ɛ ð l ɪ s f r a iː ð ɪ
klippur	kʰ l ɪ h p ʏ r
stelkur	s t ɛ l̥ k ʏ r
áttundi	a u h t ʏ n t ɪ
hringvöðvi	r̥ i ŋ k v œ ð v ɪ
eyja	e iː j a
túnfífill	tʰ u n f iː v ɪ t l
mjókka	m j o u h k a
kaggi	kʰ a cː ɪ
friðarbogi	f r ɪː ð a r p ɔː j ɪ
hóll	h o u t l
áhrifsfall	a uː r̥ ɪ f s f a t l
rök	r œː k
þakka	θ a h k a
hrefna	r̥ ɛ p n a
gálma	k a u l m a
mustarður	m ʏ s t a r ð ʏ r
fálm	f a u l m
kaupunautur	kʰ ø yː p ʏ n ø yː t ʏ r
ríbónúkleasi	r iː p o uː n uː kʰ l ɛː aː s ɪ
kolefni	kʰ ɔː l ɛ p n ɪ
þriðji	θ r ɪ ð j ɪ
unglingur	u ŋ k l i ŋ k ʏ r
egyptaland	ɛː c ɪ f t a l a n t
landslag	l a n s l aː ɣ
aðdragandi	a ð t r aː ɣ a n t ɪ
gjöf	c œː v
fursti	f ʏ r̥ s t ɪ
bloti	p l ɔː t ɪ
heiðni	h e i ð n ɪ
andrésína	a n t r j ɛː s iː n a
prófastur	pʰ r o uː v a s t ʏ r
konráð	kʰ ɔ n r a uː ð
nálgunarbann	n a u l k ʏ n a r p a nː
biti	p ɪː t ɪ
bergdís	p ɛ r k t iː s
jóna	j o uː n a
umfang	ʏ m f a u ŋ k
nábítur	n a uː p iː t ʏ r
lefsa	l ɛ f s a
nesti	n ɛ s t ɪ
gerla	c ɛ r t l a
dyflinn	t ɪ p l ɪ nː
tól	tʰ o uː l
ítali	iː tʰ aː l ɪ
frelsi	f r ɛ l s ɪ
hálfvirði	h a u l v v ɪ r ð ɪ
iðnaður	ɪ ð n aː ð ʏ r
óhreinn	o uː r̥ e i t n
hundur	h ʏ n t ʏ r
orðsifjabók	ɔ r ð s ɪ v j a p o uː k
sagnbeyging	s a k n p e iː j i ŋ k
fullyrða	f ʏ t l ɪ r ð a
háband	h a uː p a n t
þumall	θ ʏː m a t l
skæla	s c a iː l a
ótti	o u h t ɪ
spakur	s p aː k ʏ r
fiskibolla	f ɪ s c ɪ p ɔ lː a
svefnherbergi	s v ɛ p n h ɛ r p ɛ r c ɪ
himnaríki	h ɪ m n a r iː c ɪ
finnland	f ɪ nː l a n t
hagga	h a kː a
hvæsa	xʷ a iː s a
dúskur	t u s k ʏ r
kók	kʰ o uː k
bágur	p a uː ʏ r
göngutúr	k ø y ŋ k ʏ tʰ uː r
trúlofa	tʰ r uː l ɔ v a
riflás	r ɪ v l a uː s
össurína	œ sː ʏ r iː n a
tollera	tʰ ɔ lː ɛː r a
heimsmethafi	h e i m s m ɛː t h aː v ɪ
æður	a iː ð ʏ r
fastur	f a s t ʏ r
mór	m o uː r
þessi	θ ɛ sː ɪ
sjötti	s j œ h t ɪ
adda	a tː a
fjarki	f j a r̥ c ɪ
hafald	h aː v a l t
ístra	i s t r a
klukkustund	kʰ l ʏ h k ʏ s t ʏ n t
lunga	l u ŋ k a
gagntaka	k a k n tʰ aː k a
drepsótt	t r ɛː p s o u h t
hagur	h aː ɣ ʏ r
háttaratviksorð	h a u h t a r aː t v ɪ k s ɔ r ð
eplamús	ɛ h p l a m uː s
stafróf	s t a v r o uː v
guma	k ʏː m a
tíra	tʰ iː r a
bakki	p a h c ɪ
hljómsveit	l̥ j o u m s v e iː t
gusa	k ʏː s a
duga	t ʏː ɣ a
sakna	s a h k n a
björg	p j œ r k
smiður	s m ɪː ð ʏ r
grænmetisæta	k r a i n m ɛː t ɪ s a iː t a
sjúkrahús	s j uː k r a h uː s
tokkata	tʰ ɔ h k aː t a
slátra	s t l a uː t r a
alúðlegur	aː l u ð l ɛː ɣ ʏ r
sókn	s o ʊ k n̥
aftursæti	a f t ʏ r s a iː t ɪ
standpína	s t a n t pʰ iː n a
handfylli	h a n t f ɪ t l ɪ
bryti	p r ɪː t ɪ
bassetthorn	p a sː ɛ h t h ɔ r t n
lumma	l ʏ mː a
spekt	s p ɛ x t
sauðvingull	s ø y ð v i ŋ k ʏ t l
loga	l ɔː ɣ a
olgeirína	ɔ l c e iː r iː n a
tylla	tʰ ɪ t l a
kofa	kʰ ɔː v a
eldgos	ɛ l t k ɔː s
manni	m a nː ɪ
guðríður	k v ʏ ð r iː ð ʏ r
skriðsund	s k r ɪ ð s ʏ n t
geit	c e iː t
reyndar	r e i n t a r
havaí	h aː v a iː
fylking	f ɪ l̥ c i ŋ k
legill	l e iː j ɪ t l
styrmir	s t ɪ r m ɪ r
mosadýr	m ɔː s a t iː r
kjói	cʰ o uː ɪ
káka	kʰ a uː k a
hjóla	ç o uː l a
möl	m œː l
sálumessa	s a uː l ʏ m ɛ sː a
jafnvægi	j a p n v a iː j ɪ
kirsuber	cʰ ɪ r̥ s ʏ p ɛː r
fálma	f a u l m a
lesa	l ɛː s a
heimspekingur	h e i m s p ɛː c i ŋ k ʏ r
léttur	l j ɛ h t ʏ r
svangur	s v a u ŋ k ʏ r
loft	l ɔ f t
kalksteinn	kʰ a l̥ k s t e i t n
rafstöð	r a v s t œː ð
mergur	m ɛ r k ʏ r
strekkingur	s t r ɛ h c i ŋ k ʏ r
spenntur	s p ɛ n̥ t ʏ r
tyggja	tʰ ɪ cː a
laug	l ø yː ɣ
seinn	s e i t n
bakkus	p a h k ʏ s
mjöðm	m j œ ð m
flagasóley	f l aː ɣ a s o uː l e iː
kvittur	kʰ v ɪ h t ʏ r
skjal	s c aː l
snarka	s n a r̥ k a
forsíða	f ɔ r̥ s iː ð a
tin	tʰ ɪː n
fjallganga	f j a t l̥ k a u ŋ k a
austur	ø y s t ʏ r
háskóli	h a uː s k o uː l ɪ
neptúnus	n ɛ f tʰ uː n ʏ s
pólland	p o u l l a n t
andstæðingur	a n t s t a iː ð i ŋ k ʏ r
urra	ʏ rː a
slitna	s t l ɪ h t n a
pota	pʰ ɔː t a
heilindi	h e iː l ɪ n t ɪ
bólstur	p o u l s t ʏ r
hvítasunna	xʷ iː t a s ʏ nː a
pistill	pʰ ɪ s t ɪ t l
laska	l a s k a
reiða	r e iː ð a
frasi	f r aː s ɪ
geislaspilari	c e i s t l a s p ɪː l aː r ɪ
tillit	tʰ ɪ l l ɪː t
annríki	a nː r iː c ɪ
skíði	s c iː ð ɪ
kokkur	kʰ ɔ h k ʏ r
frekna	f r ɛ h k n a
misþyrming	m ɪː s θ ɪ r m i ŋ k
starfsemi	s t a r v s ɛː m ɪ
deild	t e i l t
wathne	v a h t n ɛː
jólaköttur	j o uː l a kʰ œ h t ʏ r
baksa	p a k s a
brunahani	p r ʏː n a h aː n ɪ
krappur	kʰ r a h p ʏ r
skrímsli	s k r i m s t l ɪ
flaska	f l a s k a
mjólkurmatur	m j o u l̥ k ʏ r m aː t ʏ r
bákn	p a u h k n
sakaskrá	s aː k a s k r a uː
mar	m aː r
sæla	s a iː l a
arkitekt	a r̥ c ɪ tʰ ɛ x t
skipasmíði	s c ɪː p a s m iː ð ɪ
safnheiti	s a p n h e iː t ɪ
veðurtunglamynd	v ɛː ð ʏ r tʰ u ŋ l a m ɪ n t
léttúðugur	l j ɛ h t uː ð ʏː ɣ ʏ r
flugmaður	f l ʏ ɣ m aː ð ʏ r
arndís	a r t n t iː s
rispa	r ɪ s p a
páfi	pʰ a uː v ɪ
þig	θ ɪː ɣ
kyrrsetning	cʰ ɪ r s ɛ h t n i ŋ k
sóli	s o uː l ɪ
elta	ɛ l̥ t a
sól	s o uː l
kjöt	kʰ j œː t
breyta	p r e iː t a
hollenska	h ɔ l l ɛ n s k a
ógeðslegur	o uː c ɛ ð s l ɛː ɣ ʏ r
rell	r ɛ t l
hettupeysa	h ɛ h t ʏ pʰ e iː s a
jónas	j o uː n aː s
rafgreining	r a v k r e iː n i ŋ k
dýrka	t i r̥ k a
nábúi	n a uː p uː ɪ
mjór	m j o uː r
kúlupenni	kʰ uː l ʏ pʰ ɛ nː ɪ
blæðari	p l a iː ð a r ɪ
gylta	c ɪ l̥ t a
aðeins	aː ð e i n s
áreynsla	a uː r e i n s t l a
hreyfill	r̥ e iː v ɪ t l
froskur	f r ɔ s k ʏ r
krampi	kʰ r a m̥ p ɪ
stærðfræði	s t a i r ð f r a iː ð ɪ
stara	s t aː r a
örn	œ r t n
dreitill	t r e iː t ɪ t l
hafragrautur	h a v r a k r ø yː t ʏ r
þríleikur	θ r iː l e iː k ʏ r
kynkirtill	cʰ ɪː n cʰ ɪ r̥ t ɪ t l
glundur	k l ʏ n t ʏ r
þreyta	θ r e iː t a
fokk	f ɔ h k
vaf	v aː v
prentun	pʰ r ɛ n̥ t ʏ n
beygingarlýsing	p e iː j i ŋ k a r l iː s i ŋ k
teppa	tʰ ɛ h p a
seyði	s e iː ð ɪ
samþykki	s a m θ ɪ h c ɪ
svíða	s v iː ð a
stjörnuspekingur	s t j œ r t n ʏ s p ɛː c i ŋ k ʏ r
þvottabjörn	θ v ɔ h t a p j œ r t n
ríta	r iː t a
gagnauga	k a k n ø yː ɣ a
stör	s t œː r
pýroxen	pʰ iː r ɔ k s ɛː n
vistfræði	v ɪ s t f r a iː ð ɪ
orkugjafi	ɔ r̥ k ʏ c aː v ɪ
skjóttur	s c o u h t ʏ r
hæfa	h a iː v a
ást	a u s t
aðalmerki	aː ð a l m ɛ r̥ c ɪ
íslenska	i s t l ɛ n s k a
rak	r aː k
snjallúr	s n j a t l uː r
túba	tʰ uː p a
kjálki	cʰ a u l̥ c ɪ
biðstofa	p ɪ ð s t ɔː v a
heimsyfirráð	h e i m s ɪː v ɪ r r a uː ð
þörungur	θ œː r u ŋ k ʏ r
hrjúfur	r̥ j uː v ʏ r
rússland	r u s t l a n t
kettlingur	cʰ ɛ h t l i ŋ k ʏ r
sandlægja	s a n t l a iː j a
ragnheiður	r a k n h e iː ð ʏ r
mekka	m ɛ h k a
krepja	kʰ r ɛː p j a
frímerki	f r iː m ɛ r̥ c ɪ
bjór	p j o uː r
hvítmosi	kʰ v iː t m ɔː s ɪ
kampur	kʰ a m̥ p ʏ r
vaka	v aː k a
góa	k o uː a
bleyta	p l e iː t a
nei	n e iː
kristí	kʰ r ɪ s t iː
hnefafylli	n̥ ɛː v a f ɪ t l ɪ
hnefi	n̥ ɛː v ɪ
skjaldarmerki	s c a l t a r m ɛ r̥ k ɪ
hvöt	kʰ v œː t
heflaður	h ɛ p l aː ð ʏ r
vissa	v ɪ sː a
rabarbari	r aː p a r p aː r ɪ
bjarma	p j a r m a
lara	l aː r a
bróðurdóttir	p r o uː ð ʏ r t o u h t ɪ r
geirdís	c e i r t iː s
veðurfræði	v e ɛ̯ ð ʏ r f r a i̯ ð ɪ
vangi	v a u ɲ c ɪ
deyfing	t e iː v i ŋ k
áskrifandi	a uː s k r ɪː v a n t ɪ
dalalilja	t aː l a l ɪ l j a
áflog	a uː f l ɔː ɣ
bylgja	p ɪ l c a
ólund	o uː l ʏ n t
kaktus	kʰ a x t ʏ s
kaplamjólk	kʰ a h p l a m j o u l̥ k
sáðfruma	s a u ð f r ʏː m a
leiður	l e iː ð ʏ r
rusti	r ʏ s t ɪ
ræna	r a iː n a
stofa	s t ɔː v a
rjóður	r j o uː ð ʏ r
andi	a n t ɪ
hræla	r̥ a iː l a
dýrslegur	t i r̥ s l ɛː ɣ ʏ r
sjónskertur	s j o u n s c ɛ r̥ t ʏ r
klína	kʰ l iː n a
vanræksla	v a n r a i k s t l a
skraf	s k r aː v
prammi	pʰ r a mː ɪ
beður	p ɛː ð ʏ r
forsetningarliður	f ɔ r̥ s ɛ h t n i ŋ k a r l ɪː ð ʏ r
ljóður	l j o uː ð ʏ r
bróðir	p r o uː ð ɪ r
kólibrífugl	kʰ o uː l ɪ p r iː f ʏ k l
landamæri	l a n t a m a iː r ɪ
pensill	pʰ ɛ n s ɪ t l
kjötbolla	cʰ œ t p ɔ lː a
klinka	kʰ l i ŋ̊ k a
magapína	m aː ɣ a pʰ iː n a
mannvit	m a nː v ɪː t
grallari	k r a t l aː r ɪ
liðugur	l ɪː ð ʏː ɣ ʏ r
kusa	kʰ ʏː s a
þinn	θ ɪ nː
hræða	r̥ a iː ð a
skvísa	s k v iː s a
hvala	kʰ v aː l a
syngja	s i ɲ c a
ástand	a uː s t a n t
belgía	p ɛ l c i j a
skin	s c ɪː n
nafli	n a p l ɪ
forréttur	f ɔ r r j ɛ h t ʏ r
fága	f a uː a
gervitungl	c ɛ r v ɪ tʰ u ŋ l
standa	s t a n t a
trúr	t r uː r
vasareiknir	v aː s a r e i h k n ɪ r
næra	n a iː r a
galgopi	k a l k ɔː p ɪ
höfuðborg	h œː v ʏ ð p ɔ r k
skógarkerfill	s k o uː a r cʰ ɛ r v ɪ t l
framreiða	f r a m r e iː ð a
vatt	v a h t
túnsúra	tʰ u n s uː r a
aldingarður	a l t ɪ n k a r ð ʏ r
fjallnykra	f j a t l n ɪː k r a
aðgerð	a ð c ɛ r ð
keyra	cʰ e iː r a
lofðungur	l ɔ v ð u ŋ k ʏ r
útvarp	uː t v a r̥ p
hópur	h o uː p ʏ r
póstur	pʰ o u s t ʏ r
skinna	s k ɪ nː a
partur	pʰ a r̥ t ʏ r
hlé	l̥ j ɛː
zóphonías	s o uː f ɔː n iː j a s
jólagjöf	j o uː l a c œː v
þorbjörg	θ ɔ r p j œ r k
raup	r ø yː p
langatöng	l a u ŋ k a tʰ ø y ŋ k
nár	n a uː r
hörfinka	h œ r f i ŋ k a
jón	j o uː n
kolsýra	kʰ ɔ l s iː r a
smjörlauf	s m j œ r l ø yː v
vörður	v œ r ð ʏ r
kynhvöt	cʰ ɪː n xʷ œː t
borgaralegur	p ɔ r k aː r a l ɛː ɣ ʏ r
fangelsi	f a u ŋ c ɛ l s ɪ
vinnukona	v ɪ nː ʏ kʰ ɔː n a
veldi	v ɛ l t ɪ
gott	k ɔ h t
stíga	s t iː ɣ a
stunda	s t ʏ n t a
svalir	s v aː l ɪ r
jóhannesína	j o uː h a nː ɛː s iː n a
bambus	p a m p ʏ s
kynning	cʰ ɪ nː i ŋ k
sinni	s ɪ nː ɪ
slag	s t l aː ɣ
elska	ɛ l s k a
guðrún	k v ʏ ð r uː n
þúa	θ uː a
ásþrúður	a uː s θ r uː ð ʏ r
munda	m ʏ n t a
stafli	s t a p l ɪ
torvelda	tʰ ɔ r v ɛ l t a
níðingur	n iː ð i ŋ k ʏ r
löskur	l œ s k ʏ r
ófreskja	o uː f r ɛ s c a
vasabók	v aː s a p o uː k
fælinn	f a iː l ɪ nː
moldvarpa	m ɔ l t v a r̥ p a
augnhár	ø y k n h a uː r
sveðja	s v ɛ ð j a
hrökkbrauð	r̥ œ h k p r ø yː ð
tilgangur	tʰ ɪ l k a u ŋ k ʏ r
faðirvor	f aː ð ɪ r v ɔː r
pása	pʰ a uː s a
steik	s t e iː k
örvun	œ r v ʏ n
efa	ɛː v a
þrándheimur	θ r a u n t h e iː m ʏ r
dunda	t ʏ n t a
kveif	kʰ v e iː v
þeyr	θ e iː r
mjalli	m j a t l ɪ
vefstóll	v ɛ f s t o u t l
skítugur	s c iː t ʏː ɣ ʏ r
nafarsrauf	n aː v a r̥ s r ø yː v
drift	t r ɪ f t
erja	ɛ r j a
kunnur	kʰ ʏ nː ʏ r
metfé	m ɛː t f j ɛː
plampa	pʰ l a m̥ p a
sökk	s œ h k
miðvörður	m ɪ ð v œ r ð ʏ r
fasteign	f a s t e i k n
litningsendi	l ɪ h t n i ŋ k s ɛ n t ɪ
hljómlist	l̥ j o u m l ɪ s t
viss	v ɪ sː
ausa	ø yː s a
farsi	f a r̥ s ɪ
dyggð	t ɪ ɣ ð
klöpp	kʰ l œ h p
býfur	p iː v ʏ r
sólarlag	s o uː l a r l aː ɣ
fjallasveifgras	f j a t l a s v e i v k r aː s
áreiðanleiki	a uː r e iː ð a n l e iː c ɪ
falstur	f a l s t ʏ r
anemóna	aː n ɛ m o uː n a
gerill	c ɛː r ɪ t l
kjúklingur	cʰ u h k l i ŋ k ʏ r
kroppa	kʰ r ɔ h p a
veldissproti	v ɛ l t ɪ s s p r ɔː t ɪ
leppur	l ɛ h p ʏ r
víngarður	v i n k a r ð ʏ r
brjóstsviði	p r j o u s t s v ɪː ð ɪ
vopn	v ɔ h p n
flak	f l aː k
sýgill	s iː j ɪ t l
ellingsen	ɛ lː i ŋ k s ɛ n
virkni	v ɪ r̥ k n ɪ
dauðafræði	t ø yː ð a f r a iː ð ɪ
stikill	s t ɪː c ɪ t l
jarðskorpa	j a r ð s k ɔ r̥ p a
ofurhetja	ɔː v ʏ r h ɛː t j a
bugt	p ʏ x t
japanskur	j aː pʰ a n s k ʏ r
ragnarök	r a k n a r œː k
renín	r ɛː n iː n
vefa	v ɛː v a
kanína	kʰ aː n iː n a
krukka	kʰ r ʏ h k a
blómvöndur	p l o u m v œ n t ʏ r
sprauta	s p r ø yː t a
vildís	v ɪ l t iː s
kveikja	kʰ v e iː c a
barbari	p a r p aː r ɪ
þruma	θ r ʏː m a
smyrja	s m ɪ r j a
riffill	r ɪ fː ɪ t l
fagurfræði	f aː ɣ ʏ r f r a iː ð ɪ
mót	m o uː t
gramúlfur	k r aː m u l v ʏ r
dingla	t i ŋ l a
bútur	p uː t ʏ r
fjölbreytni	f j œ l p r e i h t n ɪ
skriðsóley	s k r ɪ ð s o uː l e iː
moskítófluga	m ɔ s c iː t o uː f l ʏː ɣ a
thorlacius	tʰ ɔ r l a s iː j ʏ s
málefni	m a uː l ɛ p n ɪ
ökkli	œ h k l ɪ
fúlmár	f u l m a uː r
dugur	t ʏː ɣ ʏ r
kross	kʰ r ɔ sː
jess	j ɛ sː
simpansi	s ɪ m̥ p a n s ɪ
lesminni	l ɛː s m ɪ nː ɪ
daus	t ø yː s
kútur	kʰ uː t ʏ r
innritun	ɪ nː r ɪː t ʏ n
kerfi	cʰ ɛ r v ɪ
glápa	k l a uː p a
fýluferð	f iː l ʏ f ɛ r ð
gyða	c ɪː ð a
einangrari	e iː n a u ŋ k r aː r ɪ
setja	s ɛː t j a
auðmjúkur	ø y ð m j uː k ʏ r
einræða	e i n r a iː ð a
persónufornafn	pʰ ɛ r̥ s o uː n ʏ f ɔ r n a p n
forritun	f ɔ rː ɪː t ʏ n
hreysiköttur	r̥ e iː s ɪ kʰ œ h t ʏ r
kára	kʰ a uː r a
köldugras	kʰ œ l t ʏ k r aː s
krýna	kʰ r iː n a
líffæri	l i f f a iː r ɪ
blogga	p l ɔ kː a
gígur	c iː ɣ ʏ r
mólendi	m o uː l ɛ n t ɪ
lilja	l ɪ l j a
nafn	n a p n
kind	cʰ ɪ n t
nes	n ɛː s
túnvorblóm	tʰ u n v ɔ r p l o uː m
keila	cʰ e iː l a
barrspæta	p a rː s p a iː t a
afskrá	a f s k r a uː
sjóða	s j o uː ð a
nína	n iː n a
eftirlaun	ɛ f t ɪ r l ø yː n
knútur	kʰ n uː t ʏ r
eiturlyfjanotandi	e iː t ʏ r l ɪ v j a n ɔː t a n t ɪ
hver	xʷ ɛː r
hræring	r̥ a iː r i ŋ k
húsfreyja	h uː s f r e iː j a
lyst	l ɪ s t
feiti	f e iː t ɪ
upplifun	ʏ h p l ɪː v ʏ n
hormón	h ɔ r m o uː n
algerlega	a l c ɛ r l ɛː ɣ a
rafhlaða	r a v l̥ aː ð a
búkur	p uː k ʏ r
unnusta	ʏ nː ʏ s t a
markmaður	m a r̥ k m aː ð ʏ r
hem	h ɛː m
purpuraþistill	pʰ ʏ r̥ p ʏː r a θ ɪ s t ɪ t l
monta	m ɔ n̥ t a
fóstri	f o u s t r ɪ
spilling	s p ɪ t l i ŋ k
dáinn	t a uː ɪ nː
málafærslumaður	m a uː l a f a i r̥ s t l ʏ m aː ð ʏ r
för	f œː r
kaaber	kʰ ɔː p ɛ r
uppkast	ʏ h p kʰ a s t
þorgilsína	θ ɔ r c ɪ l s iː n a
hella	h ɛ t l a
tína	tʰ iː n a
manngera	m a nː c ɛː r a
yfirlæti	ɪː v ɪ r l a iː t ɪ
rampur	r a m̥ p ʏ r
kaupstefna	kʰ ø y p s t ɛ p n a
stafafura	s t aː v a f ʏː r a
ernir	ɛ r t n ɪ r
örðugleiki	œ r ð ʏ k l e iː c ɪ
haugarfi	h ø yː ɣ a r v ɪ
spánn	s p a u t n
lappland	l a h p l a n t
nettóþyngd	n ɛ h t o uː θ i ŋ t
þurfa	θ ʏ r v a
gelding	c ɛ l t i ŋ k
hæna	h a iː n a
klessa	kʰ l ɛ sː a
telma	tʰ ɛ l m a
kryppa	kʰ r ɪ h p a
retta	r ɛ h t a
kryfja	kʰ r ɪ v j a
gríð	k r iː ð
förðun	f œ r ð ʏ n
doktor	t ɔ x t ɔ r
stöngull	s t ø y ŋ k ʏ t l
þyngdarsvið	θ i ŋ t a r s v ɪː ð
hnakki	n̥ a h c ɪ
ásamt	a uː s a m̥ t
gáleysi	k a uː l e iː s ɪ
tjull	tʰ j ʏ lː
nógur	n o uː ʏ r
haf	h aː v
röð	r œː ð
tyrkjasól	tʰ ɪ r̥ c a s o uː l
kakkalakki	kʰ a h k a l a h c ɪ
kamelljón	kʰ aː m ɛ l l j o uː n
rófa	r o uː v a
banani	p aː n a n ɪ
gatnamót	k a h t n a m o uː t
uppsetning	ʏ h p s ɛ h t n i ŋ k
happdrætti	h a h p t r a i h t ɪ
dýrgripur	t i r k r ɪː p ʏ r
konungsríki	kʰ ɔː n u ŋ k s r iː c ɪ
pyttur	pʰ ɪ h t ʏ r
nafni	n a p n ɪ
olla	ɔ lː a
höfðingi	h œ v ð i ɲ c ɪ
rista	r ɪ s t a
efnilegur	ɛ p n ɪ l ɛː ɣ ʏ r
ugla	ʏ k l a
mata	m aː t a
töframaður	tʰ œ v r a m aː ð ʏ r
frygð	f r ɪ ɣ ð
hérað	ç ɛː r a ð
skyndilegur	s c ɪ n t ɪ l ɛː ɣ ʏ r
þórmundur	θ o u r m ʏ n t ʏ r
brjóstkassi	p r j o u s t kʰ a sː ɪ
frumskógur	f r ʏ m s k o uː ʏ r
hafnabolti	h a p n a p ɔ l̥ t ɪ
hlykkja	l̥ ɪ h c a
árásarmaður	a uː r a uː s a r m aː ð ʏ r
efnasamband	ɛ p n a s a m p a n t
braut	p r ø yː t
annáll	a nː a u t l
veiði	v e iː ð ɪ
ládauður	l a uː t ø yː ð ʏ r
rafall	r aː v a t l
rýna	r iː n a
eruð	ɛː r ʏ ð
kroppur	kʰ r ɔ h p ʏ r
skrifa	s k r ɪː v a
tromp	tʰ r ɔ m̥ p
trjóna	tʰ r j o uː n a
betla	p ɛ h t l a
knéfiðla	kʰ n j ɛː f ɪ ð l a
garpur	k a r̥ p ʏ r
fart	f a r̥ t
dropi	t r ɔː p ɪ
fótboltafélag	f o uː t p ɔ l̥ t a f j ɛː l aː ɣ
vara	v aː r a
eva	ɛː v a
nýyrði	n iː ɪ r ð ɪ
slóð	s t l o uː ð
marksúla	m a r̥ k s uː l a
goði	k ɔː ð ɪ
mikilvægi	m ɪː c ɪ l v a iː j ɪ
lögreglumaður	l œ ɣ r ɛ k l ʏ m aː ð ʏ r
vekja	v ɛː c a
frelsisstyttan	f r ɛ l s ɪ s s t ɪ h t a n
svefnpoki	s v ɛ p n pʰ ɔː c ɪ
tjása	tʰ j a uː s a
formkaka	f ɔ r m kʰ aː k a
þumbaralegur	θ ʏ m p a r a l ɛː ɣ ʏ r
hjartafífill	ç a r̥ t a f iː v ɪ t l
hittni	h ɪ h t n ɪ
valur	v aː l ʏ r
flokkur	f l ɔ h k ʏ r
grafít	k r aː f iː t
smáorð	s m a uː ɔ r ð
jórdanía	j o u r t aː n iː j a
jónína	j o uː n iː n a
bur	p ʏː r
sala	s aː l a
timburmaður	tʰ ɪ m p ʏ r m aː ð ʏ r
ítreka	iː tʰ r ɛː k a
rappa	r a h p a
rjómaostur	r j o uː m a ɔ s t ʏ r
blámaður	p l a uː m aː ð ʏ r
lífvörður	l i v v œ r ð ʏ r
húnn	h u t n
gulvíðir	k ʏ l v iː ð ɪ r
hundasúra	h ʏ n t a s uː r a
konunglegur	kʰ ɔː n u ŋ k l ɛː ɣ ʏ r
ostahnífur	ɔ s t a n̥ iː v ʏ r
hvirfilvindur	xʷ ɪ r v ɪ l v ɪ n t ʏ r
tröllatré	tʰ r œ t l a tʰ r j ɛː
netjuský	n ɛː t j ʏ s c iː
fylki	f ɪ l̥ c ɪ
deyfð	t e i v ð
aldur	a l t ʏ r
bossi	p ɔ sː ɪ
umhyggja	ʏ m h ɪ cː a
einhver	e i n xʷ ɛː r
fúga	f uː a
skán	s k a uː n
þenja	θ ɛ n j a
skýring	s c iː r i ŋ k
jaki	j aː c ɪ
mögulegur	m œː ɣ ʏ l ɛː ɣ ʏ r
melta	m ɛ l̥ t a
ósk	o u s k
textavarp	tʰ ɛ x s t a v a r̥ p
díll	t i t l
danskur	t a n s k ʏ r
heimsendir	h e i m s ɛ n t ɪ r
ánægjulegur	a uː n a i j ʏ l ɛː ɣ ʏ r
einingarfylki	e iː n i ŋ k a r f ɪ l̥ c ɪ
hneggja	n̥ ɛ cː a
sykurrófa	s ɪː k ʏ r r o uː v a
handleggur	h a n t l ɛ kː ʏ r
kjáni	cʰ a uː n ɪ
lófatölva	l o uː v a tʰ œ l v a
bringa	p r i ŋ k a
beyki	p e iː c ɪ
beiti	p e iː t ɪ
bergmann	p ɛ r k m a nː
gnótt	k n o u h t
brokka	p r ɔ h k a
flugur	f l ʏː ɣ ʏ r
álfadrottning	a u l v a t r ɔ h t n i ŋ k
marbendill	m a r p ɛ n t ɪ t l
sveigja	s v e iː j a
þórshöfn	θ o u r̥ s h œ p n
ölvun	œ l v ʏ n
tilraun	t ɪ l r ø yː n
rannsóknarstofa	r a nː s o u h k n a r s t ɔː v a
hljóð	l̥ j o uː ð
forskot	f ɔ r̥ s k ɔː t
kokkteill	kʰ ɔ h k tʰ e i t l
gunnlaug	k ʏ nː l ø yː ɣ
fyrirgjöra	f ɪː r ɪ r c œː r a
telja	tʰ ɛ l j a
fótsnyrting	f o uː t s n ɪ r̥ t i ŋ k
haugalygi	h ø yː ɣ a l ɪː j ɪ
úlfaldi	u l v a l t ɪ
háls	h a u l s
þorn	θ ɔ t n
vasaljós	v aː s a l j o uː s
kekkur	cʰ ɛ h k ʏ r
regnkápa	r ɛ k n kʰ a uː p a
flengja	f l e i ɲ c a
súkkulaði	s u h k ʏ l aː ð ɪ
hjú	ç uː
svæfing	s v a iː v i ŋ k
án	a uː n
elía	ɛː l iː j a
ginna	c ɪ nː a
rugga	r ʏ kː a
stuðlun	s t ʏ ð l ʏ n
eggertína	ɛ cː ɛ r̥ t iː n a
redda	r ɛ tː a
býli	p iː l ɪ
verkfæri	v ɛ r̥ k f a iː r ɪ
mannvitsbrekka	m a nː v ɪ t s p r ɛ h k a
akrein	aː k r e iː n
strá	s t r a uː
fretta	f r ɛ h t a
völvuhnoðri	v œ l v ʏ n̥ ɔ ð r ɪ
guðmundína	k v ʏ ð m ʏ n t iː n a
hrífa	r̥ iː v a
andheiti	a n t h e iː t ɪ
lotning	l ɔ h t n i ŋ k
hrár	r̥ a uː r
skagi	s k aː j ɪ
sviði	s v ɪː ð ɪ
klúbbur	kʰ l u pː ʏ r
popp	pʰ ɔ h p
núbbi	n u pː ɪ
varalitur	v aː r a l ɪː t ʏ r
efnisyfirlit	ɛ p n ɪ s ɪː v ɪ r l ɪː t
einteymingur	e i n tʰ e iː m i ŋ k ʏ r
doðrantur	t ɔ ð r a n̥ t ʏ r
hyrni	h ɪ r t n ɪ
bygging	p ɪ cː i ŋ k
birna	p ɪ r t n a
stinga	s t i ŋ k a
spark	s p a r̥ k
rífast	r iː v a s t
disketta	t ɪ s k ɛ h t a
brauðhnífur	p r ø y ð n̥ iː v ʏ r
skjáborð	s c a uː p ɔ r ð
brandari	p r a n t aː r ɪ
sitkagreni	s ɪː t k a k r ɛː n ɪ
steinselja	s t e i n s ɛ l j a
eftirlíking	ɛ f t ɪ r l iː c i ŋ k
kjartan	cʰ a r̥ t a n
hvalur	xʷ aː l ʏ r
nútími	n uː tʰ iː m ɪ
fró	f r o uː
brennivín	p r ɛ nː ɪ v iː n
lækjasóley	l a iː c a s o uː l e iː
kvikasilfur	kʰ v ɪː k a s ɪ l v ʏ r
spjaldtölva	s p j a l t tʰ œ l v a
línuleiki	l iː n ʏ l e iː c ɪ
löm	l œː m
yngja	i ɲ c a
glóðarauga	k l o uː ð a r ø yː ɣ a
þorkell	θ ɔ r̥ cʰ ɛ t l
daðra	t a ð r a
sulla	s ʏ t l a
fjólublár	f j o uː l ʏ p l a uː r
ólafur	o uː l aː v ʏ r
ritkerfi	r ɪː t cʰ ɛ r v ɪ
kynda	cʰ ɪ n t a
kúfa	kʰ uː v a
súpa	s uː p a
kynna	cʰ ɪ nː a
eignarfornafn	e i k n a r f ɔ r n a p n
efli	ɛ p l ɪ
hreindýr	r̥ e i n t iː r
raggeit	r a ɣ c e iː t
krumla	kʰ r ʏ m l a
fals	f a l s
spínat	s p iː n aː t
hljóðeind	l̥ j o uː ð e i n t
arsen	a r̥ s ɛ n
skrun	s k r ʏː n
margur	m a r k ʏ r
há	h a uː
endaþarmsop	ɛ n t a θ a r m s ɔː p
hjónaskilnaður	ç o uː n a s c ɪ l n aː ð ʏ r
finsen	f ɪ n s ɛː nː
broddur	p r ɔ tː ʏ r
hjarðmaður	ç a r ð m aː ð ʏ r
undrabarn	ʏ n t r a p a r t n
bensínsala	p ɛ n s i n s aː l a
guðjohnsen	k v ʏ ð j o u n s ɛː nː
hneigð	n̥ e i ɣ ð
rostungur	r ɔ s t u ŋ k ʏ r
endurvekja	ɛ n t ʏ r v ɛː c a
þíður	θ iː ð ʏ r
karma	kʰ a r m a
markslá	m a r̥ k s t l a uː
þarfaþing	θ a r v a θ i ŋ k
farlama	f a r l a m a
kerúb	cʰ ɛː r uː p
þekkja	θ ɛ h c a
vigfús	v ɪ x f uː s
rusl	r ʏ s t l
prútta	pʰ r u h t a
hvítmaðra	kʰ v iː t m a ð r a
meistaraverk	m e i s t aː r a v ɛ r̥ k
hlæja	l̥ a iː j a
halldís	h a l t iː s
þefa	θ ɛː v a
kúkur	kʰ uː k ʏ r
kaþólskur	k aː θ o u l s k ʏ r
hörund	h œː r ʏ n t
benjamín	p ɛ n j a m iː n
rella	r ɛ t l a
albanskur	a l p a n s k ʏ r
skola	s k ɔː l a
mjög	m j œː ɣ
ýmis	iː m ɪ s
reigja	r e iː j a
kantaraborg	kʰ a n̥ t a r a p ɔ r k
hjálmar	ç a u l m a r
mí	m iː
kort	kʰ ɔ r̥ t
sæði	s a iː ð ɪ
bringusund	p r i ŋ k ʏ s ʏ n t
súrkál	s u r̥ kʰ a uː l
ritgerð	r ɪː t c ɛ r ð
fótboltaþjálfari	f o uː t p ɔ l̥ t a θ j a u l v aː r ɪ
spuni	s p ʏː n ɪ
laun	l ø yː n
leirburður	l e i r p ʏ r ð ʏ r
hringl	r̥ i ŋ l
hetja	h ɛː t j a
heimsvaldastefna	h e i m s v a l t a s t ɛ p n a
hjónaband	ç o uː n a p a n t
foreldri	f ɔː r ɛ l t r ɪ
mexíkó	m ɛ k s iː kʰ o uː
rauðvín	r ø y ð v iː n
persía	pʰ ɛ r̥ s iː j a
júkki	j u h c ɪ
gnoð	k n ɔː ð
koma	kʰ ɔː m a
þorleifína	θ ɔ r l e iː v iː n a
hnjóta	n̥ j o uː t a
megra	m ɛ ɣ r a
orðhluti	ɔ r ð l̥ ʏː t ɪ
gimbur	c ɪ m p ʏ r
hæla	h a iː l a
hrísgrjón	r̥ iː s k r j o uː n
bumba	p ʏ m p a
vínandi	v iː n a n t ɪ
sólveig	s o u l v e iː ɣ
ugga	ʏ kː a
dylja	t ɪ l j a
vömb	v œ m p
þrýstilína	θ r i s t ɪ l iː n a
tískupallur	tʰ ɪ s k ʏ pʰ a t l ʏ r
alþjóðlegur	a l θ j o u ð l ɛː ɣ ʏ r
surtur	s ʏ r̥ t ʏ r
haddur	h a tː ʏ r
kaupa	kʰ ø yː p a
pláss	pʰ l a u sː
hárlýja	h a u r l iː j a
járna	j a u r t n a
rafgas	r a v k aː s
karst	kʰ a r̥ s t
laga	l aː ɣ a
þrettándi	θ r ɛ h t a u n t ɪ
beita	p e iː t a
nauðgun	n ø y ð k ʏ n
fyrirliði	f ɪː r ɪ r l ɪː ð ɪ
grávíðir	k r a uː v iː ð ɪ r
athæfi	aː t h a iː v ɪ
skírnarfontur	s c i r t n a r f ɔ n̥ t ʏ r
rúmteppi	r u m tʰ ɛ h p ɪ
skoti	s k ɔː t ɪ
sessunautur	s ɛ sː ʏ n ø yː t ʏ r
heimasími	h e iː m a s iː m ɪ
dyntur	t ɪ n̥ t ʏ r
vanur	v aː n ʏ r
þáttaskil	θ a u h t a s k ɪː l
spretta	s p r ɛ h t a
tappatogari	tʰ a h p a tʰ ɔː ɣ a r ɪ
mótgerð	m o uː t c ɛ r ð
hér	ç ɛː r
fabúla	f aː p uː l a
gallblaðra	k a t l p l a ð r a
namibía	n aː m ɪ p iː j a
hurð	h ʏ r ð
elda	ɛ l t a
eyðni	e i ð n ɪ
pressa	pʰ r ɛ sː a
pallur	pʰ a t l ʏ r
vasapeli	v aː s a pʰ ɛː l ɪ
minnka	m i ŋ̊ k a
afturkræfur	a f t ʏ r kʰ r a iː v ʏ r
girnd	c ɪ r n t
túvalú	tʰ uː v a l uː
katrín	kʰ aː t r iː n
eftirmynd	ɛ f t ɪ r m ɪ n t
kristni	kʰ r ɪ s t n ɪ
miga	m ɪː ɣ a
orsök	ɔ r̥ s œː k
gís	c iː s
hjúkrunarfræði	ç uː k r ʏ n a r f r a iː ð ɪ
spyrja	s p ʏ r j a
sársauki	s a u r̥ s ø yː c ɪ
vígja	v iː j a
þorn	θ ɔ r t n
karlfauskur	kʰ a r t l f ø y s k ʏ r
pirra	pʰ ɪ rː a
krefja	kʰ r ɛ v j a
spaði	s p aː ð ɪ
stórólfur	s t o uː r o u l v ʏ r
keyta	cʰ e iː t a
hræðsla	r̥ a i ð s t l a
zoëga	s o uː ɛː k aː
kundur	kʰ ʏ n t ʏ r
sver	s v ɛː r
breskur	p r ɛ s k ʏ r
prakkarastrik	pʰ r a h k a r a s t r ɪː k
vá	v a uː
hjalti	ç a l̥ t ɪ
ólöglegur	o uː l œ ɣ l ɛː ɣ ʏ r
mjólkursúkkulaði	m j o u l̥ k ʏ r s u h k ʏ l aː ð ɪ
leiðindi	l e iː ð ɪ n t ɪ
hvað	xʷ aː ð
flyksa	f l ɪ x s a
spæll	s p a i t l
stefanía	s t ɛː f aː n iː j a
valdís	v a l t iː s
mosagrænn	m ɔː s a k r a i t n
unnar	ʏ nː aː r
tóbak	tʰ o uː p aː k
böggull	p œ kː ʏ t l
hengill	h e i ɲ c ɪ t l
varanlegur	v aː r a n l ɛː ɣ ʏ r
miðaldir	m ɪː ð a l t ɪ r
dyrgja	t ɪ r c a
rafpóstur	r a v pʰ o u s t ʏ r
lífsmark	l i f s m a r̥ k
hís	ç iː s
bragur	p r aː ɣ ʏ r
þak	θ aː k
gæta	c a iː t a
hönd	h œ n t
skóf	s k o uː v
húsbóndi	h u s p o u n t ɪ
fjárdráttur	f j a u r t r a u h t ʏ r
trompet	tʰ r ɔ m̥ p ɛː t
hnjóðsyrði	n̥ j o u ð s ɪ r ð ɪ
snoppufríður	s t n ɔ h p ʏ f r iː ð ʏ r
guðlaug	k v ʏ ð l ø yː ɣ
skjálfti	s c a u l̥ t ɪ
taumur	tʰ ø yː m ʏ r
lifandi	l ɪː v a n t ɪ
ansa	a n s a
rafali	r aː v aː l ɪ
flýja	f l iː j a
salerni	s aː l ɛ r t n ɪ
ítalska	iː tʰ a l s k a
mýrasauðlaukur	m iː r a s ø y ð l ø yː k ʏ r
fátækur	f a uː tʰ a iː k ʏ r
eignarhaldsfélag	e i k n a r h a l t s f j ɛː l aː ɣ
festa	f ɛ s t a
strimill	s t r ɪː m ɪ t l
rífa	r iː v a
lífefnafræði	l iː v ɛ p n a f r a iː ð ɪ
frumufræði	f r ʏː m ʏ f r a iː ð ɪ
malajíska	m aː l a iː j i s k a
forngríska	f ɔ r t n k r i s k a
ferðamaður	f ɛ r ð a m aː ð ʏ r
líkamsrækt	l iː kʰ a m s r a i x t
jerúsalem	j ɛː r uː s aː l ɛː m
þýska	θ i s k a
sæti	s a iː t ɪ
hvirfill	xʷ ɪ r v ɪ t l
snigill	s n ɪː j ɪ t l
blessa	p l ɛ sː a
hvorttveggja	xʷ ɔ r̥ t tʰ v ɛ cː a
meðal	m ɛː ð a l
skráning	s k r a uː n i ŋ k
lús	l uː s
mosafræðingur	m ɔː s a f r a iː ð i ŋ k ʏ r
nepal	n ɛː pʰ aː l
dílaburkni	t iː l a p ʏ r̥ k n ɪ
ull	ʏ t l
sópur	s o uː p ʏ r
kvennabósi	kʰ v ɛ nː a p o uː s ɪ
gæfur	c a iː v ʏ r
gíslína	c i s t l iː n a
gleraugu	k l ɛː r ø yː ɣ ʏ
púki	pʰ uː c ɪ
sleipur	s t l e iː p ʏ r
fingur	f i ŋ k ʏ r
ruðningur	r ʏ ð n i ŋ k ʏ r
skelkaður	s c ɛ l̥ k a ð ʏ r
brass	p r a sː
slydda	s t l ɪ tː a
týra	tʰ iː r a
kristindómur	kʰ r ɪ s t ɪ n t o uː m ʏ r
göldróttur	k œ l t r o u h t ʏ r
sár	s a uː r
skema	s c ɛː m a
bruna	p r ʏː n a
hnýta	n̥ iː t a
óþarflega	o uː θ a r v l ɛː ɣ a
vélfræðingur	v j ɛː l f r a iː ð i ŋ k ʏ r
glæruvængur	k l a iː r ʏ v a i ŋ k ʏ r
kartafla	k a r̥ t a p l a
ljótunn	l j o uː t ʏ nː
kristín	kʰ r ɪ s t iː n
kvenkyn	kʰ v ɛ n cʰ ɪː n
stafa	s t aː v a
borðstofa	p ɔ r ð s t ɔː v a
stjóri	s t j o uː r ɪ
bogga	p ɔ kː a
frjókorn	f r j o uː kʰ ɔ r t n
grænlenska	k r a i n l ɛ n s k a
kúptur	kʰ u f t ʏ r
funda	f ʏ n t a
gargönd	k a r k œ n t
óætur	o uː a iː t ʏ r
norðymbraland	n ɔ r ð ɪ m p r a l a n t
páskalilja	pʰ a u s k a l ɪ l j a
iðja	ɪ ð j a
aðalfylking	aː ð a l f ɪ l̥ c i ŋ k
föstudagur	f œ s tʰ ʏ t aː ɣ ʏ r
algyðistrú	a l c ɪ ð ɪ s tʰ r u
atvinna	aː t v ɪ nː a
himbrimi	h ɪ m p r ɪː m ɪ
lettneska	l ɛ h t n ɛ s k a
enni	ɛ nː ɪ
rykkur	r ɪ h k ʏ r
gersemi	c ɛ r s ɛː m ɪ
rýtingur	r iː t i ŋ k ʏ r
barátta	p aː r a u h t a
danalög	t aː n a l œː ɣ
lindasef	l ɪ n t a s ɛː v
blána	p l a uː n a
biðstöð	p ɪ ð s t œː ð
treyja	tʰ r e iː j a
gáski	k a u s c ɪ
strý	s t r iː
spanjóli	s p a n j o uː l ɪ
sífelldur	s iː f ɛ l t ʏ r
vaxa	v a x s a
endi	ɛ n t ɪ
narta	n a r̥ t a
verufall	v ɛː r ʏ f a t l
slakna	s t l a h k n a
rökfræði	r œː k f r a iː ð ɪ
gaupa	k ø yː p a
brengla	p r e i ŋ l a
lufsa	l ʏ f s a
afleiðing	a v l e iː ð i ŋ k
blóðfruma	p l o u ð f r ʏː m a
kattarjurt	kʰ a h t a r j ʏ r̥ t
bára	p a uː r a
derhúfa	t ɛ r h uː v a
synd	s ɪ n t
finnska	f ɪ n s k a
gráða	k r a uː ð a
strokka	s t r ɔ h k a
manna	m a nː a
teikna	tʰ e i h k n a
nábrók	n a uː p r o uː k
þurrkur	θ ʏ r̥ k ʏ r
hnappur	n̥ a h p ʏ r
líkindi	l iː c ɪ n t ɪ
súra	s uː r a
starfa	s t a r v a
þjóðverji	θ j o u ð v ɛ r j ɪ
riðill	r ɪː ð ɪ t l
freista	f r e i s t a
duna	t ʏː n a
bati	p aː t ɪ
siglt	s ɪ ɬ t
ekkjumaður	ɛ h c ʏ m aː ð ʏ r
sykurreyr	s ɪː k ʏ r r e iː r
ferð	f ɛ r ð
eís	ɛː iː s
freydís	f r e iː t iː s
víðir	v iː ð ɪ r
ið	ɪː ð
svíi	s v iː ɪ
kyn	cʰ ɪː n
dyngja	t i ɲ c a
köfnunarefni	kʰ œ p n ʏ n a r ɛ p n ɪ
málmblásturshljóðfæri	m a u l m p l a u s t ʏ r̥ s l̥ j o u ð f a iː r ɪ
kristján	kʰ r ɪ s t j a uː n
orðasafn	ɔ r ð a s a p n
slegill	s t l e iː j ɪ t l
apótekari	aː p o uː tʰ ɛː k aː r ɪ
gengur	c e i ŋ k ʏ r
munaðarleysingjahæli	m ʏː n aː ð a r l e iː s i ɲ c a h a iː l ɪ
hjallur	ç a t l ʏ r
þyrla	θ ɪ r t l a
sameina	s aː m e iː n a
patína	pʰ aː tʰ iː n a
biðminni	p ɪ ð m ɪ nː ɪ
deigja	t e iː j a
sýrland	s i r l a n t
troða	tʰ r ɔː ð a
lambakjöt	l a m p a cʰ œː t
snúður	s t n uː ð ʏ r
kíví	kʰ iː v i
gröftur	k r œ f t ʏ r
olía	ɔː l iː j a
grikki	k r ɪ h c ɪ
gauð	k ø yː ð
haugur	h ø yː ɣ ʏ r
spámaður	s p a uː m aː ð ʏ r
þýfður	θ i v ð ʏ r
bleðill	p l ɛː ð ɪ t l
fá	f a uː
hnoðafræhyrna	n̥ ɔː ð a f r a iː h ɪ r t n a
not	n ɔː t
apótek	aː p o uː tʰ ɛː k
greindur	k r e i n t ʏ r
kyrrseta	cʰ ɪ r s ɛː t a
básúnuleikari	p a uː s uː n ʏ l e iː k aː r ɪ
hlutur	l̥ ʏː t ʏ r
ár	a uː r̥
dýri	t iː r ɪ
skarfur	s k a r v ʏ r
ómþýður	o u m θ iː ð ʏ r
karen	kʰ aː r ɛː n
atvik	aː t v ɪː k
fallbeyging	f a t l b e iː j i ŋ k
sýr	s iː r
þíða	θ iː ð a
slétta	s t l j ɛ h t a
kræklóttur	kʰ r a i h k l o u h t ʏ r
hrólfur	r̥ o u l v ʏ r
rými	r iː m ɪ
vatn	v aʰ t n
skinn	s c ɪ nː
skruna	s k r ʏː n a
hjálmtýr	ç a u l m tʰ iː r
hengistör	h e i ɲ c ɪ s t œː r
knippi	kʰ n ɪ h p ɪ
kúmen	kʰ uː m ɛː n
belti	p ɛ l̥ t ɪ
hulda	h ʏ l t a
dökkvíðir	t œ h k v iː ð ɪ r
arnar	a r t n aː r
flokkun	f l ɔ h k ʏ n
hyrna	h ɪ r t n a
íþróttahús	iː θ r o u h t a h uː s
augnablik	ø y k n a p l ɪː k
palestína	pʰ aː l ɛ s t iː n a
hvatur	xʷ aː t ʏ r
blóðvökvi	p l o u ð v œː k v ɪ
músarrindill	m uː s a r r ɪ n t ɪ t l
kanada	kʰ aː n aː t a
ávinningur	a uː v ɪ nː i ŋ k ʏ r
mánajurt	m a uː n a j ʏ r̥ t
taska	tʰ a s k a
mjúkur	m j uː k ʏ r
húfa	h uː a
aukafall	ø yː k a f a t l
melting	m ɛ l̥ t i ŋ k
jaðar	j aː ð a r
huglaus	h ʏ ɣ l ø yː s
halastjarna	h aː l a s t j a r t n a
smók	s m o uː k
kirja	cʰ ɪ r j a
kæna	cʰ a iː n a
úran	uː r aː n
hryggur	r̥ ɪ kː ʏ r
guðlegur	k v ʏ ð l ɛː ɣ ʏ r
helgarferð	h ɛ l k a r f ɛ r ð
jarl	j a r t l
þrauka	θ r ø yː k a
kista	cʰ ɪ s t a
ingvarsson	i ŋ k v a r̥ s s ɔː n
hnappstör	n̥ a h p s t œː r
hata	h aː t a
dýna	t iː n a
tveir	tʰ v e iː r
flákaský	f l a uː k a s c iː
mía	m iː j a
botnlangabólga	p ɔ h t n l a u ŋ k a p o u l k a
útsaumur	uː t s ø yː m ʏ r
þroski	θ r ɔ s c ɪ
brennuvargur	p r ɛ nː ʏ v a r k ʏ r
háseti	h a uː s ɛː t ɪ
dreifa	t r e iː v a
ísmael	iː s m aː ɛː l
lausung	l ø yː s u ŋ k
símgreiðsla	s i m k r e i ð s t l a
hvína	xʷ iː n a
fyrirgefning	f ɪː r ɪ r c ɛ p n i ŋ k
hné	n̥ j ɛː
drösull	t r œː s ʏ t l
huggun	h ʏ kː ʏ n
metnaður	m ɛ h t n aː ð ʏ r̥
hrökkva	r̥ œ h k v a
auðvelda	ø y ð v ɛ l t a
venus	v ɛː n ʏ s
tilviljun	tʰ ɪ l v ɪ l j ʏ n
óperuhús	o uː pʰ ɛː r ʏ h uː s
eintyngdur	e i n t i ŋ t ʏ r
afl	a p l
ritröð	r ɪː t r œː ð
kjarkur	cʰ a r̥ k ʏ r
klæða	kʰ l a iː ð a
hespa	h ɛ s p a
óður	o uː ð ʏ r
lögreglustöð	l œ ɣ r ɛ k l ʏ s t œː ð
skósmiður	s k o uː s m ɪː ð ʏ r
randa	r a n t a
milli	m ɪ lː ɪ
reyrgresi	r e i r k r ɛː s ɪ
reykja	r e iː c a
andúð	a n t uː ð
konungsveldi	kʰ ɔː n u ŋ k s v ɛ l t ɪ
geirvarta	c e i r v a r̥ t a
íslenskur	i s t l ɛ n s k ʏ r
boðháttur	p ɔː ð h a u h t ʏ r
hraður	r̥ aː ð ʏ r
júdit	j uː t ɪː t
föðurbróðir	f œː ð ʏ r p r o uː ð ɪ r
náæta	n a uː a iː t a
bæjarstjóri	p a iː j a r s t j o uː r ɪ
geldingahnappur	c ɛ l t i ŋ k a n̥ a h p ʏ r
slanga	s t l a u ŋ k a
brottför	p r ɔ h t f œː r
skrifstofa	s k r ɪ f s t ɔː v a
káeta	kʰ a uː ɛː t a
tígrisdýr	tʰ iː k r ɪ s t iː r
más	m a uː s
samlandi	s a m l a n t ɪ
kné	kʰ n j ɛː
hneta	n̥ ɛː t a
hjúkrun	ç uː k r ʏ n
flag	f l aː ɣ
leka	l ɛː k a
flóðhestur	f l o uː ð h ɛ s t ʏ r
safírblár	s aː f iː r p l a uː r
hönk	h œ ŋ̊ k
hrafnastör	r̥ a p n a s t œː r
fylgsni	f ɪ l k s t n ɪ
hettumáfur	h ɛ h t a m a uː v ʏ r
kamfóra	kʰ a m f o uː r a
hvar	kʰ v aː r
gula	k ʏː l a
sylgja	s ɪ l c a
flóra	f l o uː r a
prins	pʰ r ɪ n s
raska	r a s k a
poki	pʰ ɔː c ɪ
amaba	aː m aː p a
drottnari	t r ɔ h t n a r ɪ
flauelsblóm	f l ø yː j ɛ l s p l o uː m
skil	s c ɪː l
gunnlaugur	k ʏ nː l ø yː ɣ ʏ r
drengur	t r e i ŋ k ʏ r
fúga	f uː k a
hnupla	n̥ ʏ h p l a
kveikjari	kʰ v e iː c a r ɪ
slá	s t l a uː
hnoð	n̥ ɔː ð
skötuhjú	s k œː t ʏ ç uː
at	aː t
alaskaösp	aː l a s k a œ s p
smurður	s m ʏ r ð ʏ r
svelta	s v ɛ l̥ t a
gjald	c a l t
nótt	n o uʰ t
kjarnavopn	cʰ a r t n a v ɔ h p n
granda	k r a n t a
rissa	r ɪ sː a
ekkja	ɛ h c a
mauraæta	m ø yː r a a iː t a
geta	c ɛː t a
fjallhæra	f j a t l h a iː r a
frelsari	f r ɛ l s aː r ɪ
liðsforingi	l ɪ ð s f ɔː r i ɲ c ɪ
sviss	s v ɪ sː
aðaláhrif	aː ð aː l a uː r̥ ɪː v
andardráttur	a n t a r t r a u h t ʏ r
ball	p a lː
indriðason	ɪ n t r ɪː ð a s ɔː n
knöttur	kʰ n œ h t ʏ r
fyrirferð	f ɪː r ɪ r f ɛ r ð
kotra	kʰ ɔː t r a
rannur	r a nː ʏ r
geirþrúður	c e i r̥ θ r uː ð ʏ r
flói	f l o uː ɪ
brúðkaup	p r u ð kʰ ø yː p
gleðja	k l ɛ ð j a
funa	f ʏː n a
illska	ɪ l s k a
hugsanlegur	h ʏ x s a n l ɛː ɣ ʏ r
finna	f ɪ nː a
myndarlegur	m ɪ n t a r l ɛː ɣ ʏ r
bað	p aː ð
sannarlega	s a nː a r l ɛː ɣ a
koks	kʰ ɔ x s
pósthús	pʰ o u s t h uː s
búlgarska	p u l k a r̥ s k a
vörn	v œ r t n
eðlisfræði	ɛ ð l ɪ s f r a iː ð ɪ
æra	a iː r a
læknisfræðilegur	l a i h k n ɪ s f r a iː ð ɪ l ɛː ɣ ʏ r
taut	tʰ ø yː t
vör	v œː r
mön	m œː n
ræma	r a iː m a
ná	n a uː
útför	uː t f œː r
bras	p r aː s
fáviti	f a uː v ɪː t ɪ
brandönd	p r a n t œ n t
hornspyrna	h ɔ r t n s p ɪ r t n a
tognun	tʰ ɔ k n ʏ n
einær	e iː n a iː r
ærsl	a i r s t l
örvamælir	œ r v a m a iː l ɪ r
neðri	n e ð r ɪ
dórískur	t o uː r i s k ʏ r
heimasæta	h e iː m a s a iː t a
skara	s k aː r a
bruðl	p r ʏ ð l
hjaltalín	ç a l̥ t a l iː n
úð	uː ð
útiloka	uː t ɪ l ɔː k a
tordýfill	tʰ ɔ r t iː v ɪ l̥
hrækja	r̥ a iː c a
verk	v ɛ r̥ k
minningargripur	m ɪ nː i ŋ k a r k r ɪː p ʏ r
stöðugur	s t œː ð ʏ ɣ ʏ r
frádráttur	f r a u t r a u h t ʏ r
kengúra	cʰ e i ŋ k uː r a
tjarnastör	tʰ j a r t n a s t œː r
ada	aː t a
fennikka	f ɛ nː ɪ h k a
sina	s ɪː n a
lexía	l ɛ x s iː j a
teygjudýr	tʰ e iː j ʏ t iː r
súta	s uː t a
altari	a l̥ t a r ɪ
stígvél	s t i ɣ v j ɛː l
viti	v ɪː t ɪ
ofn	ɔ p n
leiðarstef	l e iː ð a r s t ɛː v
flogaveiki	f l ɔː ɣ a v e iː c ɪ
eign	e i k n
nautgripur	n ø yː t k r ɪː p ʏ r
innkaup	ɪ nː kʰ ø yː p
skemma	s c ɛ mː a
framhjáhlaup	f r a m ç a uː l̥ ø yː p
kífa	cʰ iː v a
flaust	f l ø y s t
faðmur	f a ð m ʏ r
vestur	v ɛ s t ʏ r
fullur	f ʏ t ɬ ʏ r
geysa	c e iː s a
greina	k r e iː n a
svífa	s v iː v a
þrívegis	θ r iː v e iː j ɪ s
fegra	f ɛ ɣ r a
mynddiskur	m ɪ n t t ɪ s k ʏ r
hadda	h a tː a
þorsteinína	θ ɔ r̥ s t e iː n iː n a
leiðrétting	l e i ð r j ɛ h t i ŋ k
fljúga	f l j uː a
þumalputtaregla	θ ʏː m a l pʰ ʏ h t a r ɛ k l a
hrappur	r̥ a h p ʏ r
kantata	kʰ a n̥ t aː t a
hilmir	h ɪ l m ɪ r
dorma	t ɔ r m a
eðlilega	ɛ ð l ɪ l ɛː ɣ a
spjótkast	s p j o uː t kʰ a s t
gamburmosi	k a m p ʏ r m ɔː s ɪ
þrakía	θ r aː cʰ iː j a
mjaldur	m j a l t ʏ r
tjalli	tʰ j a lː ɪ
pækill	pʰ a iː c ɪ t l
fíkill	f iː c ɪ t l
greining	k r e iː n i ŋ k
ei	e iː
skáli	s k a uː l ɪ
skíðhvalur	s c i ð kʰ v aː l ʏ r
sambland	s a m p l a n t
heitur	h e iː t ʏ r
verða	v ɛ r ð a
skellihlæja	s c ɛ t l ɪ l̥ a iː j a
gjamma	c a mː a
smána	s m a uː n a
hökull	h œː k ʏ t l
lesblinda	l ɛː s p l ɪ n t a
ljár	l j a uː r
sesín	s ɛː s iː n
niðurlæging	n ɪː ð ʏ r l a iː j i ŋ k
blokkflauta	p l ɔ h k f l ø yː t a
magn	m a k n
rið	r ɪː ð
fjalldalafífill	f j a t l t aː l a f iː v ɪ t l
riðla	r ɪ ð l a
kardináli	kʰ a r t ɪ n a uː l ɪ
svartsýnn	s v a r̥ t s i t n
líkami	l iː kʰ aː m ɪ
árabátur	a uː r a p a uː t ʏ r
víða	v iː ð a
tölustafur	tʰ œː l ʏ s t aː v ʏ r
flís	f l iː s
samvist	s a m v ɪ s t
handknattleiksþjálfari	h a n t kʰ n a h t l e i k s θ j a u l v a r ɪ
ljósapera	l j o uː s a pʰ ɛː r a
herkúles	h ɛ r̥ k uː l ɛː s
kínín	cʰ iː n iː n
rækja	r a iː c a
skvass	s k v a sː
stífla	s t i p l a
skrið	s k r ɪː ð
vasadiskó	v aː s a t ɪ s k o uː
skaðlegur	s k a ð l ɛː ɣ ʏ r
hjólabretti	ç o uː l a p r ɛ h t ɪ
ingi	i ɲ c ɪ
bolti	p ɔ l̥ t ɪ
skómakari	s k o uː m aː k aː r ɪ
sveit	s v e iː t
slóvakíska	s t l o uː v a cʰ i s k a
göndull	k œ n t ʏ t l
karpa	kʰ a r̥ p a
deigur	t e iː ɣ ʏ r
galli	k a lː ɪ
læknisfræði	l a i h k n ɪ s f r a iː ð ɪ
maríustakkur	m aː r iː j ʏ s t a h k ʏ r
feill	f e i t l
bagi	p a iː j ɪ
leyniskytta	l e iː n ɪ s c ɪ h t a
stjórnklefi	s t j o u r t n kʰ l ɛː v ɪ
brekkusóley	p r ɛ h k ʏ s o uː l e iː
valmúi	v a l m uː ɪ
faraó	f aː r a o uː
jólabókaflóð	j o uː l a p o uː k a f l o uː ð
gengi	c e i ɲ c ɪ
kúla	kʰ uː l a
salka	s a l̥ k a
parís	pʰ aː r iː s
kveikur	kʰ v e iː k ʏ r
sykurpúði	s ɪː k ʏ r pʰ uː ð ɪ
lúðalegur	l uː ð a l ɛː ɣ ʏ r
dýfa	t iː v a
melludólgur	m ɛ t l ʏ t o u l k ʏ r
frár	f r a uː r
krossfesting	kʰ r ɔ sː f ɛ s t i ŋ k
alba	a l p a
máta	m a uː t a
ægilegur	a iː j ɪ l ɛː ɣ ʏ r
hví	xʷ iː
flúr	f l uː r
hnýfill	n̥ iː v ɪ t l
gagnlegur	k a k n l ɛ ɣ ʏ r
sekur	s ɛː k ʏ r
hildigunnur	h ɪ l t ɪ k ʏ nː ʏ r
sandbylur	s a n t p ɪː l ʏ r
tilboð	tʰ ɪ l p ɔː ð
eintala	e i n tʰ aː l a
ljóstillífun	l j o uː s t ɪ l l iː v ʏ n
nudd	n ʏ tː
vinna	v ɪ nː a
hlaða	l̥ aː ð a
kopar	kʰ ɔː p a r
sannlega	s a nː l ɛː ɣ a
hringja	r̥ i ɲ c a
framburður	f r a m p ʏ r ð ʏ r
skakkur	s k a h k ʏ r
fingurbjargarblóm	f i ŋ k ʏ r p j a r k a r p l o uː m
búðarborð	p uː ð a r p ɔ r ð
holur	h ɔː l ʏ r
hakka	h a k k a
svíkja	s v iː c a
hryggja	r̥ ɪ cː a
hjarni	ç a r t n ɪ
helgidagur	h ɛ l c ɪ t aː ɣ ʏ r
braggi	p r a cː ɪ
tálvon	tʰ a u l v ɔː n
sunnan	s ʏ nː a n
naggrís	n a ɣ k r iː s
miðvikudagur	m ɪ ð v ɪː kʰ ʏ t aː ɣ ʏ r
djákni	t j a u h k n ɪ
blotna	p l ɔ h t n a
umdeildur	ʏ m t e i l t ʏ r
þrýstinn	θ r i s t ɪ nː
þunnur	θ ʏ nː ʏ r
bresta	p r ɛ s t a
dráttartaug	t r a u h t a r tʰ ø yː ɣ
ríkisráð	r iː c ɪ s r a uː ð
strit	s t r ɪː t
saltfiskur	s a l̥ t f ɪ s k ʏ r
kunta	kʰ ʏ n̥ t a
harðlífi	h a r ð l iː v ɪ
víf	v iː v
aka	aː k a
ljósabekkur	l j o uː s a p ɛ h k ʏ r
lækjagrýta	l a iː c a k r iː t a
móttaka	m o uː t tʰ aː k a
blöðruhálskirtill	p l œ ð r ʏ h a u l s cʰ ɪ r̥ t ɪ t l
hvítabjörn	xʷ iː t a p j œ r t n
færeyska	f a iː r e i s k a
lýra	l iː r a
gljávíðir	k l j a uː v iː ð ɪ r
brella	p r ɛ t l a
hjarn	ç a r t n
hjúkra	ç uː k r a
rakhnífur	r aː k n̥ iː v ʏ r
sundlaug	s ʏ n t l ø yː ɣ
gorma	k ɔ r m a
gaman	k aː m aː n
durgur	t ʏ r k ʏ r
broddkrækill	p r ɔ tː kʰ r a iː c ɪ t l
prússland	pʰ r u s t l a n t
arnfríður	a r t n f r iː ð ʏ r
fullkominn	f ʏ t l̥ kʰ ɔː m ɪ nː
tæring	tʰ a iː r i ŋ k
byrstur	p ɪ r̥ s t ʏ r
sveif	s v e iː v
slóvenska	s t l o uː v ɛ n s k a
hýði	h iː ð ɪ
rakki	r a h c ɪ
bróðursonur	p r o uː ð ʏ r̥ s ɔː n ʏ r
dögun	t œː ɣ ʏ n
strompur	s t r ɔ m̥ p ʏ r
korra	kʰ ɔ rː a
óáreiðanleiki	o uː a uː r e iː ð a n l e iː c ɪ
blettur	p l ɛ h t ʏ r
moppa	m ɔ h p a
sígaretta	s iː ɣ a r ɛ h t a
heiðarlegur	h e iː ð a r l ɛː ɣ ʏ r
peningaseðill	pʰ ɛː n i ŋ k a s ɛː ð ɪ t l
ofnæmi	ɔ v n a iː m ɪ
kelda	cʰ ɛ l t a
kvöð	kʰ v œː ð
hvalveiði	kʰ v a l v e iː ð ɪ
gróðurhús	k r o uː ð ʏ r h uː s
hagi	h aː j ɪ
ildi	ɪ l t ɪ
lemja	l ɛ m j a
hjaðna	ç a ð n a
helta	h ɛ l̥ t a
brugghús	p r ʏ kː h uː s
þrenna	θ r ɛ nː a
jarða	j a r ð a
álfrek	a u l v r eː k
krista	kʰ r ɪ s t a
skata	s k aː t a
grænspæta	k r a i n s p a iː t a
virkjun	v ɪ r̥ c ʏ n
limafjörður	l ɪː m a f j œ r ð ʏ r
smaragður	s m aː r a ɣ ð ʏ r
guðlaugur	k v ʏ ð l ø yː ɣ ʏ r
hvítlaukur	xʷ iː t l ø yː k ʏ r
offita	ɔ f f ɪː t a
tennis	tʰ ɛ nː ɪ s
frumstig	f r ʏ m s t ɪː ɣ
glymur	k l ɪː m ʏ r
slitur	s t l ɪː t ʏ r
genf	c ɛ n f
snökta	s n œ x t a
minni	m ɪ nː ɪ
hilla	h ɪ t l a
ljósakróna	l j o uː s a kʰ r o uː n a
hleifur	l̥ e iː v ʏ r
fóður	f o uː ð ʏ r
slarkari	s t l a r̥ k a r ɪ
endurlífgun	ɛ n t ʏ r l i v k ʏ n
hristingur	r̥ ɪ s t i ŋ k ʏ r
forn	f ɔ r t n
hald	h a l t
stjörnuarfi	s t j œ r t n ʏ a r v ɪ
róður	r o uː ð ʏ r
persóna	pʰ ɛ r̥ s o uː n a
frumuhimna	f r ʏː m ʏ h ɪ m n a
algjörlega	a l c œ r l ɛː ɣ a
jónatan	j o uː n a tʰ aː n
höfnun	h œ p n ʏ n
tæfa	tʰ a iː v a
biðill	p ɪː ð ɪ t l
sífellt	s iː f ɛ l̥ t
símaskrá	s iː m a s k r a uː
eftirmiðdagur	ɛ f t ɪ r m ɪ ð t aː ɣ ʏ r
viðbragð	v ɪ ð p r a ɣ ð
páhæna	pʰ a uː h a iː n a
táningur	tʰ a uː n i ŋ k ʏ r
laugaskarð	l ø yː ɣ a s k a r ð
bjarnheiður	p j a r t n h e iː ð ʏ r
hastur	h a s t ʏ r
kerfill	cʰ ɛ r v ɪ t l
vallhæra	v a t l h a iː r a
brekka	p r ɛ h k a
margæs	m a r c a iː s
reglugerð	r ɛ k l ʏ c ɛ r ð
tárvotur	tʰ a u r v ɔː t ʏ r
ríkharður	r iː k h a r ð ʏ r
þynnka	θ i ŋ̊ k a
búrma	p u r m a
hárbursti	h a u r p ʏ r̥ s t ɪ
miðlari	m ɪ ð l aː r ɪ
forstaða	f ɔ r̥ s t aː ð a
hallgrímína	h a t l k r iː m iː n a
fulltingi	f ʏ t l̥ tʰ i ɲ c ɪ
liðfætla	l ɪ ð f a i h t l a
stálull	s t a uː l ʏ t l
krossferð	kʰ r ɔ sː f ɛ r ð
dyntóttur	t ɪ n̥ t o u h t ʏ r
bendill	p ɛ n t ɪ t l
þorvaldur	θ ɔ r v a l t ʏ r
smokkur	s m ɔ h k ʏ r
bjúga	p j uː a
handbremsa	h a n t p r ɛ m s a
haframjöl	h a v r a m j œː l
freta	f r ɛː t a
ges	c ɛː s
hnupl	n̥ ʏ h p l
luri	l ʏː r ɪ
konur	kʰ ɔː n ʏ r
kapall	kʰ aː p a t l
sjal	s j aː l
símasamband	s iː m a s a m p a n t
mát	m a uː t
bárujárn	p a uː r ʏ j a u r t n
hrææta	r̥ a iː j a iː t a
orðsifjar	ɔ r ð s ɪ v j aː r
kreditkort	kʰ r ɛː t ɪ t kʰ ɔ r̥ t
móanóra	m o uː a n o uː r a
fíkn	f i h k n
pláneta	pʰ l a uː n ɛː t a
éta	j ɛː t a
sýna	s iː n a
maðkur	m a θ k ʏ r
flagg	f l a kː
vor	v ɔː r
draumur	t r ø yː m ʏ r̥
frækinn	f r a iː c ɪ nː
sölvi	s œ l v ɪ
gríska	k r i s k a
matvara	m aː t v aː r a
pínulítill	pʰ iː n ʏ l iː t ɪ t l
marra	m a rː a
rúnna	r u nː a
ala	aː l a
próf	pʰ r o uː v
skáld	s k a u l t
kvæði	kʰ v a iː ð ɪ
vilma	v ɪ l m a
bæjasvala	p a iː j a s v aː l a
elíasína	ɛː l i j aː s iː n a
vöndur	v œ n t ʏ r
lafði	l a v ð ɪ
ös	œː s
selkjöt	s ɛ l cʰ œː t
koli	kʰ ɔː l ɪ
skaka	s k aː k a
lyftutónlist	l ɪ f t ʏ tʰ o u n l ɪ s t
mosajafni	m ɔː s a j a p n ɪ
pútta	pʰ u h t a
þvegill	θ v e iː j ɪ t l
fastmæli	f a s t m a iː l ɪ
munnþurrka	m ʏ nː θ ʏ r̥ k a
drekkja	t r ɛ h c a
skyn	s c ɪː n
halla	h a t l a
skulu	s k ʏː l ʏ
hjólreiðabraut	ç o u l r e iː ð a p r ø yː t
hannesína	h a nː ɛː s iː n a
fleyta	f l e iː t a
jórtra	j o u r̥ t r a
hrokafullur	r̥ ɔː k a f ʏ t ɬ ʏ r
stranda	s t r a n t a
trog	tʰ r ɔː ɣ
hrak	r̥ aː k
bræðsla	p r a i ð s t l a
svella	s v ɛ t l a
helín	h ɛː l iː n
brennisteinn	p r ɛ nː ɪ s t e i t n
dæsa	t a iː s a
æfing	a iː v i ŋ k
einhver	e i h k v ɛː r
holdsveiki	h ɔ l t s v e iː c ɪ
skírisskógur	s c iː r ɪ s s k o uː ʏ r
tungljurt	tʰ u ŋ l j ʏ r̥ t
tollvirði	t ɔ t l v ɪ r ð ɪ
sjálfur	s j a u l v ʏ r
trymbill	tʰ r ɪ m p ɪ t l
spjót	s p j o uː t
bjálki	p j a u l̥ k ɪ
reynd	r e i n t
runni	r ʏ nː ɪ
kynfruma	c ɪ n f r ʏː m a
seiða	s e iː ð a
sebrabraut	s ɛ p r a p r ø yː t
tjarga	tʰ j a r k a
villigöltur	v ɪ t l ɪ k œ l̥ t ʏ r
þór	θ o uː r
þúsundblaðarós	θ uː s ʏ n t p l aː ð a r o uː s
milta	m ɪ l̥ t a
strumpur	s t r ʏ m̥ p ʏ r
kurt	kʰ ʏ r̥ t
sófókles	s o uː f o uː kʰ l ɛː s
langur	l a ŋ k ʏ r
þverhníptur	θ v ɛ r n̥ i f t ʏ r
stama	s t aː m a
hjátrú	ç a uː tʰ r uː
hershöfðingi	h ɛ r̥ s h œ v ð i ɲ c ɪ
danmörk	t a n m œ r̥ k
nit	n ɪː t
jú	j uː
stuðningur	s t ʏ ð n i ŋ k ʏ r
vallarsveifgras	v a t l a r s v e i v k r aː s
ryðja	r ɪ ð j a
skima	s c ɪː m a
ló	l o uː
févíti	f j ɛː v iː t ɪ
bæheimskur	p a iː h e i m s k ʏ r
draumlaus	t r ø y m l ø yː s
úthaf	uː t h aː v
spítali	s p iː tʰ aː l ɪ
húfur	h uː v ʏ r
hugsa	h ʏ x s a
minnisgóður	m ɪ nː ɪ s k o uː ð ʏ r
vær	v a iː r
kvíði	kʰ v iː ð ɪ
blek	p l ɛː k
kufl	kʰ ʏ p l
bræða	p r a iː ð a
krikket	kʰ r ɪ h c ɛ t
morgunn	m ɔ r k ʏ nː
finnur	f ɪ nː ʏ r
leikari	l e iː k aː r ɪ
prúður	pʰ r uː ð ʏ r
hagi	h a iː j ɪ
mæta	m a iː t a
skelfiskur	s c ɛː l f ɪ s k ʏ r
lyngjafni	l i ŋ k j a p n ɪ
jökulhlaup	j œː k ʏ l l̥ ø yː p
basla	p a s t l a
samviskusamur	s a m v ɪ s k ʏ s aː m ʏ r
kaðlari	kʰ a ð l a r ɪ
brjóta	p r j o uː t a
strauja	s t r ø yː j a
þrábeiðni	θ r a uː p e i ð n ɪ
snertill	s n ɛ r̥ t ɪ t l
lás	l a uː s
hafa	h aː v a
blómavasi	p l o uː m a v aː s ɪ
dvergtré	t v ɛ r k t r j ɛː
kukl	kʰ ʏ h k l
fiskifræði	f ɪ s c ɪ f r a iː ð ɪ
bolsi	p ɔ l s ɪ
hviða	xʷ ɪː ð a
tíðaratviksorð	tʰ iː ð a r aː t v ɪ k s ɔ r ð
flórens	f l o uː r ɛ n s
ljósfræði	l j o uː s f r a iː ð ɪ
skúli	s k uː l ɪ
mygla	m ɪ k l a
lyklaborð	l ɪ h k l a p ɔ r ð
fésbók	f j ɛː s p o uː k
niður	n ɪː ð ʏ r
sjúkur	s j uː k ʏ r
fáni	f a uː n ɪ
glæra	k l a iː r a
guðleysingi	k v ʏ ð l e iː s i ɲ c ɪ
flaga	f l aː ɣ a
siða	s ɪː ð a
krossfífill	kʰ r ɔ sː f iː v ɪ t l
flísatöng	f l iː s a tʰ ø y ŋ k
flinkur	f l i ŋ̊ k ʏ r
steinþór	s t e i n θ o uː r
eski	ɛ s c ɪ
fargjald	f a r c a l t
lím	l iː m
lötra	l œː t r a
snifsi	s t n ɪ f s ɪ
trúfélag	tʰ r uː f j ɛː l aː ɣ
sútun	s uː t ʏ n
kertastjaki	cʰ ɛ r̥ t a s t j aː c ɪ
grís	k r iː s
tröllavíðir	tʰ r œ t l a v iː ð ɪ r
forsprakki	f ɔ r̥ s p r a h c ɪ
brugg	p r ʏ kː
ofurþungur	ɔː v ʏ r θ u ŋ k ʏ r
handtaka	h a n t tʰ aː k a
morfín	m ɔ r̥ f iː n
náma	n a uː m a
stífni	s t i p n ɪ
naga	n aː ɣ a
glóbrystingur	k l o uː p r ɪ s t i ŋ k ʏ r
torveldur	tʰ ɔ r v ɛ l t ʏ r
slefa	s t l ɛː v a
rauðleitur	r ø y ð l e iː t ʏ r
þrái	θ r a uː ɪ
hugaræsing	h ʏː ɣ a r a iː s i ŋ k
tjaldur	tʰ j a l t ʏ r
túrmerik	tʰ u r m ɛː r ɪ k
náladofi	n a uː l a t ɔː v ɪ
rúbín	r uː p iː n
litunarjafni	l ɪː t ʏ n a r j a p n ɪ
jarðarbúi	j a r ð a r p uː ɪ
brýni	p r iː n ɪ
dekka	t ɛ h k a
skræla	s k r a iː l a
lukt	l ʏ x t
tó	tʰ o uː
krossgáta	kʰ r ɔ sː k a uː t a
hnúskur	n̥ u s k ʏ r
elfting	ɛ l̥ʷ t i ŋ k
lífstykki	l i f s t ɪ h c ɪ
blað	p l aː ð
hagskælingur	h a x s c a i l i ŋ k ʏ r
leiðbeining	l e i ð p e iː n i ŋ k
sveifgras	s v e i v k r aː s
gluggi	k l ʏ cː ɪ
hilling	h ɪ t l i ŋ k
hálfur	h a u l v ʏ r
sníða	s n iː ð a
heift	h e i f t
blóðfræði	p l o u ð f r a iː ð ɪ
smyrja	s m ʏ r j a
sortna	s ɔ r̥ t n a
stinnasef	s t ɪ nː a s ɛː v
slíkur	s t l iː k ʏ r
veð	v ɛː ð
hvítlaukspressa	kʰ v iː t l ø y k s pʰ r ɛ sː a
kíll	cʰ i t l
vottur	v ɔ h t ʏ r
von	v ɔː n
þvinga	θ v i ŋ k a
saggi	s a cː ɪ
hnykill	n̥ ɪː c ɪ t l
orðfræði	ɔ r ð f r a iː ð ɪ
drottna	t r ɔ h t n a
lakka	l a h k a
skratti	s k r a h t ɪ
læti	l a iː t ɪ
flakka	f l a h k a
skeyta	s c e iː t a
föðursystir	f œː ð ʏ r s ɪ s t ɪ r
malurt	m aː l ʏ r̥ t
ostabakki	ɔ s t a p a h c ɪ
lærisveinn	l a iː r ɪ s v e i t n
hali	h aː l ɪ
gruna	k r ʏː n a
undirskrift	ʏ n t ɪ r s k r ɪ f t
slagsmál	s t l a x s m a uː l
kringlóttur	kʰ r i ŋ l o u h t ʏ r
kúrbítur	kʰ u r p iː t ʏ r
karsi	kʰ a r̥ s ɪ
átelja	a uː tʰ ɛ l j a
lána	l a uː n a
kjartanía	cʰ a r̥ t a n iː j a
dagblaðapappír	t a ɣ p l aː ð a p a h p iː r
seiva	s e iː v a
skali	s k aː l ɪ
tyggjó	tʰ ɪ cː o uː
tólg	tʰ o u l k
samtenging	s a m tʰ e i ɲ c i ŋ k
þökk	θ œ h k
bull	p ʏ t l
blíða	p l iː ð a
língresi	l i n k r ɛː s ɪ
ætt	a i h t
grafa	k r aː v a
sig	s ɪː ɣ
rósmarín	r o uː s m a r iː n
ratleikur	r aː t l e iː k ʏ r
frumefni	f r ʏː m ɛ p n ɪ
gjöfull	c œː v ʏ t l
sigla	s ɪ k l a
cé	s j ɛː
skjálfa	s c a u l v a
ha	h aː
dómari	t o uː m aː r ɪ
uppi	ʏ h p ɪ
sóley	s o uː l e iː
hýðishrísgrjón	h iː ð ɪ s r̥ iː s k r j o uː n
tunga	tʰ u ŋ k a
lýja	l iː j a
prestastefna	pʰ r ɛ s t a s t ɛ p n a
grafall	k r aː v a t l
eldhúshnífur	ɛ l t h uː s n̥ iː v ʏ r
bæti	p a iː t ɪ
melaskóli	m ɛː l a s k o uː l ɪ
áhugasamur	a u h ʏː ɣ a s aː m ʏ r
pálmar	pʰ a u l m a r
forða	f ɔ r ð a
aldinborg	a l t ɪ n p ɔ r k
þýskur	θ i s k ʏ r
netkorn	n ɛː t kʰ ɔ r t n
gambri	k a m p r ɪ
dyggur	t ɪ kː ʏ r
járning	j a u r t n i ŋ k
múgur	m uː ʏ r
temja	tʰ ɛ m j a
beina	p e iː n a
einn	e i t n
brotna	p r ɔ h t n a
vökva	v œː k v a
kennsla	cʰ ɛ n s t l a
puða	pʰ ʏː ð a
páfagaukur	pʰ a uː v a k ø yː k ʏ r
breytilegur	p r e iː t ɪ l ɛː ɣ ʏ r
mála	m a uː l a
foreldrar	f ɔː r ɛ l t r a r
latína	l aː tʰ iː n a
systur	s ɪ s t ʏ r
fjara	f j aː r a
stóll	s t o u t l
mánuður	m a uː n ʏː ð ʏ r
undirbúa	ʏ n t ɪ r p uː a
dóttir	t o uʰ t ɪ r
dirfð	t ɪ r v ð
eldfimur	ɛ l t f ɪː m ʏ r
blágresi	p l a uː k r ɛː s ɪ
sí	s iː
pípa	pʰ iː p a
háhyrningur	h a u h ɪ r t n i ŋ k ʏ r
martröð	m a r̥ tʰ r œː ð
gerandi	c ɛː r a n t ɪ
króm	kʰ r o uː m
felga	f ɛ l k a
þrír	θ r iː r
broddur	p ɾ ɔ tː ʏ ɹ
fasani	f aː s aː n ɪ
ekill	ɛː c ɪ t l
baðherbergi	p aː ð h ɛ r p ɛ r c ɪ
maðra	m a ð r a
gæði	c a iː ð ɪ
fálki	f a u l̥ c ɪ
reið	r e iː ð
orðaforði	ɔ r ð a f ɔ r ð ɪ
yllir	ɪ t l ɪ r
svikari	s v ɪː k aː r ɪ
hnefahögg	n̥ ɛː v a h œ kː
mannlegur	m a nː l ɛː ɣ ʏ r
saumavél	s ø yː m a v j ɛː l
júnímánuður	j uː n iː m a uː n ʏ ð ʏ r
bráð	p r a uː ð
meyr	m e iː r
tegra	tʰ ɛ ɣ r a
handklæði	h a n t kʰ l a iː ð ɪ
leikmaður	l e iː k m aː ð ʏ r
þistill	θ ɪ s t ɪ t l
rekaviður	r ɛː k a v ɪː ð ʏ r
hamagangur	h aː m a k a u ŋ k ʏ r
mella	m ɛ t l a
haust	h ø y s t
víxl	v i k s t l
snæri	s t n a iː r ɪ
kríli	kʰ r iː l ɪ
stika	s t ɪː k a
múgæsing	m uː a iː s i ŋ k
nashyrningur	n aː s h ɪ r t n i ŋ k ʏ r
tækla	tʰ a i h k l a
línuskauti	l iː n ʏ s k ø yː t ɪ
strengur	s t r e i ŋ k ʏ r
skriða	s k r ɪː ð a
eiði	e iː ð ɪ
svigi	s v ɪː j ɪ
kría	kʰ r iː j a
forhúð	f ɔː r h uː ð
sámsey	s a u m s e iː
hlass	l̥ a sː
einhentur	e iː n h ɛ n̥ t ʏ r
auðveldur	ø y ð v ɛ l t ʏ r
kveðskapur	kʰ v ɛ ð s k aː p ʏ r
augabrún	ø yː ɣ a p r uː n
náð	n a uː ð
spæla	s p a iː l a
eftirsókn	ɛ f t ɪ r s o u h k n
piltur	pʰ ɪ l̥ t ʏ r
morgunverður	m ɔ r k ʏ n v ɛ r ð ʏ r
forritari	f ɔ rː ɪ t aː r ɪ
bílaverkstæði	p iː l a v ɛ r̥ k s t a iː ð ɪ
eldsvoði	ɛ l t s v ɔː ð ɪ
hálsmen	h a u l s m ɛː n
bandingi	p a n t i ɲ c ɪ
hnaus	n̥ ø yː s
diljá	t ɪ l j a uː
pjatla	pʰ j a h t l a
sviftifall	s v ɪ f t ɪ f a t l
tungl	tʰ u ŋ l
ívera	iː v ɛː r a
drottinn	t r ɔ h t ɪ n
kynfæri	cʰ ɪ n f a iː r ɪ
únsa	u n s a
jafnoki	j a p n ɔː c ɪ
fjárhundur	f j a u r h ʏ n t ʏ r
hvala	xʷ aː l a
plága	pʰ l a uː a
sítar	s iː tʰ aː r
samúel	s aː m uː ɛː l
kjörbúð	cʰ œ r p uː ð
þorri	θ ɔ rː ɪ
bekkjarlalli	p ɛ h c a r l a t l ɪ
stemma	s t ɛ mː a
hjúfra	ç u v r a
helgi	h ɛ l c ɪ
smári	s m a uː r ɪ
glóð	k l o uː ð
hertogi	h ɛ r̥ tʰ ɔ j ɪ
skynjun	s c ɪ n j ʏ n
ábyrgð	a uː p ɪ r ɣ ð
svindlari	s v ɪ n t l aː r ɪ
síma	s iː m a
krissa	kʰ r ɪ sː a
hnyttinn	n̥ ɪ h t ɪ nː
hræsnari	r̥ a i s t n a r ɪ
knattspyrnuþjálfari	kʰ n a h t s p ɪ r t n ʏ θ j a u l v a r ɪ
afsaka	a f s aː k a
andlit	a n t l ɪː t
bor	p ɔː r
réttindi	r j ɛ h t ɪ n t ɪ
hjara	ç aː r a
munstur	m ʏ n s t ʏ r
átti	a u h t ɪ
geimfari	c e i m f aː r ɪ
raða	r aː ð a
stærð	s t a i r ð
skoppa	s k ɔ h p a
þroti	θ r ɔː t ɪ
völlur	v œ t l ʏ r
sproti	s p r ɔː t ɪ
kjaftur	cʰ a f t ʏ r
leki	l ɛː c ɪ
aðventa	a ð v ɛ n̥ t a
hrogn	r̥ ɔ k n
aðlaðandi	a ð l aː ð a n t ɪ
leiðsögn	l e i ð s œ k n
streita	s t r e iː t a
skessa	s c ɛ sː a
hugmynd	h ʏ ɣ m ɪ n t
beðja	p ɛ ð j a
skafl	s k a p l
magnúsína	m a k n uː s iː n a
bravó	p r aː v o uː
traf	tʰ r aː v
guð	k v ʏː ð
sefa	s ɛː v a
meta	m ɛː t a
öglir	œ k l ɪː r
jarðhiti	j a r ð h ɪː t ɪ
hermaður	h ɛ r m aː ð ʏ r
aðgætni	a ð c a i h t n ɪ
skyrta	s c ɪ r̥ t a
djús	t j uː s
erkibiskup	ɛ r̥ c ɪ p ɪ s k ʏ p
þýfi	θ iː v ɪ
ástfanginn	a u s t f a u ɲ c ɪ nː
skurn	s k ʏ r t n
skipasmiður	s c ɪː p a s m ɪː ð ʏ r
neitunarháttur	n e iː t ʏ n a r h a u h t ʏ r
kurr	kʰ ʏ rː
hjálpari	ç a u l̥ p a r ɪ
óákveðinn	o uː a uː kʰ v ɛː ð ɪ nː
letur	l ɛː t ʏ r
fyrirferðarmikill	f ɪː r ɪ r f ɛ r ð a r m ɪː c ɪ t l
aukatenging	ø yː k a tʰ e i ɲ c i ŋ k
túr	tʰ uː r
raun	r ø yː n
morðingi	m ɔ r ð i ɲ c ɪ
lásbogi	l a uː s p ɔː j ɪ
tylft	t ɪ l̥ f t
glanni	k l a nː ɪ
helgisiður	h ɛ l c ɪ s ɪː ð ʏ r
lok	l ɔː k
fingurbjörg	f i ŋ k ʏ r p j œ r k
sjónauki	s j o uː n ø yː c ɪ
tað	tʰ aː ð
fylgja	f ɪ l c a
dúdúfugl	t uː t uː f ʏ k l
kvendýr	kʰ v ɛ n t iː r
litur	l ɪː t ʏ r
fóarn	f o uː a r t n
andefni	a n t ɛ p n ɪ
formaður	f ɔ r m aː ð ʏ r
glymja	k l ɪ m j a
mús	m uː s
belgur	p ɛ l k ʏ r
kóraltoppur	kʰ o uː r a l tʰ ɔ h p ʏ r
auglýsing	ø y ɣ l iː s i ŋ k
hljómur	l̥ j o uː m ʏ r
frjór	f r j o uː r
þingforseti	θ i ŋ k f ɔ r̥ s ɛː t ɪ
afla	a p l a
falda	f a l t a
hermd	h ɛ r m t
niðurlægja	n ɪː ð ʏ r l a iː j a
lafa	l aː v a
varp	v a r̥ p
drengskapur	t r e i ŋ k s k aː p ʏ r
aðdráttarafl	a ð t r a u h t a r a p l
bógur	p o uː ʏ r
druna	t r ʏː n a
æmta	a i m̥ t a
hríð	r̥ iː ð
senna	s ɛ nː a
strengja	s t r e i ɲ c a
prússneskur	pʰ r u sː t n ɛ s k ʏ r
sút	s uː t
hvá	xʷ a uː
líf	l iː v
aldís	a l t iː s
þorkelína	θ ɔ r̥ cʰ ɛː l iː n a
dekkja	t ɛ h c a
söluskattur	s œː l ʏ s k a h t ʏ r
neyða	n e iː ð a
vatnsmelóna	v a sː m ɛː l o uː n a
kvos	kʰ v ɔː s
meyja	m e iː j a
reim	r e iː m
edinborg	ɛː t ɪ n p ɔ r k
bender	p ɛ n d ɛː r
iða	ɪː ð a
forvitni	f ɔ r v ɪ h t n ɪ
valhneta	v a l n̥ ɛː t a
dráttarvél	t r a u h t a r v j ɛː l
munnharpa	m ʏ nː h a r̥ p a
greinilega	k r e iː n ɪ l ɛː ɣ a
maí	m a iː
hvítblæði	xʷ iː t p l a iː ð ɪ
glissa	k l ɪ sː a
vinkona	v i ŋ kʰ ɔː n a
tilvísunarfornafn	tʰ ɪ l v iː s ʏː n a r f ɔ r n a p n
atorka	aː t ɔ r̥ k a
fax	f a x s
mörgæs	m œ r c a iː s
lómur	l o uː m ʏ r
bifhjól	p ɪ f ç o uː l
stöðvun	s t œ ð v ʏ n
sérstaklega	s j ɛ r̥ s t aː k l ɛː ɣ a
eldhús	ɛ l t h uː s
búðingur	p uː ð i ŋ k ʏ r
labb	l a pː
fataskápur	f aː t a s k a uː p ʏ r
liður	l ɪː ð ʏ r
streða	s t r ɛː ð a
heftivír	h ɛ f t ɪ v iː r
framleiðsla	f r a m l e i ð s t l a
naddur	n a tː ʏ r
stefni	s t ɛ p n ɪ
sáning	s a uː n i ŋ k
rugla	r ʏ k l a
bjarnharður	p j a r t n h a r ð ʏ r
sinnuleysi	s ɪ nː ʏ l e iː s ɪ
lemúr	l ɛː m uː r
virði	v ɪ r ð ɪ
rjúfa	r j uː v a
daunn	t ø y t n
djúpur	t j uː p ʏ r
sveipa	s v e iː p a
skop	s k ɔ p
lúður	l uː ð ʏ r
tannhvalur	tʰ a nː kʰ v aː l ʏ r
naðurtunga	n aː ð ʏ r tʰ u ŋ k a
freknóttur	f r ɛ h k n o u h t ʏ r
krani	kʰ r aː n ɪ
þarna	θ a t n a
páka	pʰ a uː k a
renna	r ɛ nː a
formatta	f ɔ r m a h t a
kapella	kʰ aː p ɛ t l a
rafeindasmásjá	r aː v e i n t a s m a uː s j a uː
fælni	f a i l n ɪ
rúta	r uː t a
muldra	m ʏ l t r a
stigi	s t ɪ iː j ɪ
flugvél	f l ʏ ɣ v j ɛː l
eintal	e i n tʰ aː l
síður	s iː ð ʏ r
fylgjari	f ɪ l c a r ɪ
hatur	h aː t ʏ r
fána	f a uː n a
tónsproti	tʰ o u n s p r ɔː t ɪ
íslendingur	i s t l ɛ n t i ŋ k ʏ r
kornbretaland	kʰ ɔ r t n p r ɛː t a l a n t
indverji	ɪ n t v ɛ r j ɪ
port	pʰ ɔ r̥ t
hálfkák	h a u l v kʰ a uː k
nægja	n a iː j a
jórdan	j o u r t aː n
hekk	h ɛ h k
grugg	k r ʏ kː
gimbill	c ɪ m p ɪ t l
klausa	kʰ l ø yː s a
fagur	f aː ɣ ʏ r
sirkus	s ɪ r̥ k ʏ s
geispi	c e i s p ɪ
beitukóngur	p e iː t ʏ kʰ o u ŋ k ʏ r
tölt	tʰ œ l̥ t
seðill	s ɛː ð ɪ t l
aukafallsliður	ø yː k a f a l s l ɪː ð ʏ r
veita	v e iː t a
setning	s ɛ h t n i ŋ k
þrár	θ r a uː r
trúss	tʰ r u sː
fok	f ɔː k
gangur	k a u ŋ k ʏ r
margþættur	m a r k θ a i h t ʏ r
patríarki	pʰ aː tʰ r i j a r̥ c ɪ
góðæri	k o uː ð a iː r ɪ
leiftur	l e i f t ʏ r
list	l ɪ s t
hálfendir	h a u l v ɛ n t ɪ r
naðra	n a ð r a
bendir	p ɛ n t ɪ r
eplasafi	ɛ h p l a s aː v ɪ
jarðyrkja	j a r ð ɪ r̥ c a
dissa	t ɪ sː a
skúfur	s k uː v ʏ r
fleirtala	f l e i r̥ t aː l a
samför	s a m f œː r
orka	ɔ r̥ k a
dáleiða	t a uː l e iː ð a
sáta	s a uː t a
mjöður	m j œː ð ʏ r
dýraspítali	t iː r a s p iː t aː l ɪ
stella	s t ɛ lː a
bíti	p iː t ɪ
munaðarleysingi	m ʏː n aː ð a r l e iː s i ɲ c ɪ
þumalína	θ ʏː m aː l iː n a
árlegur	a uː r l ɛ ɣ ʏ r
hampur	h a m̥ p ʏ r
athugasemd	aː t h ʏː ɣ a s ɛ m t
æska	a i s k a
garðakornblóm	k a r ð a kʰ ɔ r t n p l o uː m
aðalritning	aː ð a l r ɪ h t n i ŋ k
ávallt	a uː v a l̥ t
sprunga	s p r u ŋ k a
fríðleiki	f r iː ð l e iː c ɪ
lesbía	l ɛ s p iː j a
líftími	l iː v tʰ iː m ɪ
eyrnamergur	e i r t n a m ɛ r k ʏ r
linur	l ɪː n ʏ r
puð	pʰ ʏː ð
hvíla	kʰ v iː l a
tígur	tʰ iː ɣ ʏ r
knattspyrnufélag	kʰ n a h t s p ɪ r t n ʏ f j ɛː l aː ɣ
kíf	cʰ iː v
prófsumma	pʰ r o u f s ʏ mː a
fellibylur	f ɛ t l ɪ p ɪː l ʏ r
uppfæra	ʏ h p f a iː r a
japani	j aː pʰ aː n ɪ
trójuhestur	tʰ r o uː j ʏ h ɛ s t ʏ r
kringla	kʰ r i ŋ l a
hégilja	ç ɛː k ɪ l j a
kempa	cʰ ɛ m̥ p a
dýjamosi	t iː j a m ɔː s ɪ
þríeinn	θ r iː e i t n
rölta	r œ l̥ t a
lambaklukka	l a m p a kʰ l ʏ h k a
hrognamál	r̥ ɔ k n a m a uː l
amharíska	aː m h a r i s k a
hortugur	h ɔ r̥ t ʏː ɣ ʏ r
mýrdalína	m i r t aː l iː n a
samviskusemi	s a m v ɪ s k ʏ s ɛː m ɪ
daldís	t a l t iː s
innsog	ɪ nː s ɔː k
erill	ɛː r ɪ t l
biskup	p ɪ s k ʏ p
geisladiskur	c e i s t l a t ɪ s k ʏ r
díki	t iː c ɪ
fern	f ɛ r t n
biðröð	p ɪ ð r œː ð
lífsandi	l i f s a n t ɪ
vettugi	v ɛ h t ʏ j ɪ
spánskur	s p a u n s k ʏ r
barr	p a rː
lágþrýstingur	l a u ɣ θ r i s t i ŋ k ʏ r
dýflissa	t i p l ɪ sː a
elli	ɛ lː ɪ
klára	kʰ l a uː r a
meri	m ɛː r ɪ
tign	tʰ ɪ k n
svæði	s v a iː ð ɪ
ferja	f ɛ r j a
járn	j a u r t n
koss	kʰ ɔ sː
sturla	s t ʏ r t l a
flugvöllur	f l ʏ ɣ v œ t l ʏ r
ráp	r a uː p
svað	s v aː ð
ingimundína	i ŋ c ɪ m ʏ n t iː n a
bókaskápur	p o uː k a s k a uː p ʏ r
kyngja	cʰ i ɲ c a
sakleysi	s aː k l e iː s ɪ
reyna	r e iː n a
ei	ɛː ɪ
lasanja	l a s a n j a
drottning	t r ɔ h t n i ŋ k
kímblað	cʰ i m p l aː ð
gel	c ɛː l
gripur	k r ɪː p ʏ r
hefill	h ɛː v ɪ t l
klár	kʰ l a uː r
lag	l aː ɣ
kvelja	kʰ v ɛ l j a
auðmýking	ø y ð m iː c i ŋ k
áburður	a uː p ʏ r ð ʏ r
elías	ɛː l iː j a s
nauðsynlegur	n ø y ð s ɪ n l ɛː ɣ ʏ r
leit	l e iː t
andvirði	a n t v ɪ r ð ɪ
hafliðína	h a v l ɪː ð iː n a
brenninetla	p r ɛ nː ɪ n ɛ h t l a
ilma	ɪ l m a
hveiti	kʰ v e iː t ɪ
feðgar	f ɛ ð k a r
hreyta	r̥ e iː t a
duttlungafullur	t ʏ h t l u ŋ k a f ʏ t l ʏ r
tefla	tʰ ɛ p l a
harður	h a r ð ʏ r
búnaður	p uː n aː ð ʏ r
sem	s ɛ m
hvor	kʰ v ɔː r
sannfæra	s a nː f a iː r a
pétursborg	pʰ j ɛː t ʏ r̥ s p ɔ r k
gjörla	c œ r t l a
pípetta	pʰ iː p ɛ h t a
illgresi	ɪ t l k r ɛː s ɪ
minjagripur	m ɪ n j a k r ɪː p ʏ r
móberg	m o uː p ɛ r k
hrani	r̥ aː n ɪ
grínisti	k r iː n ɪ s t ɪ
smánykra	s m a uː n ɪː k r a
æpa	a iː p a
gjóstur	c o u s t ʏ r
kraftaverk	kʰ r a f t a v ɛ r̥ k
afbökun	a v p œː k ʏ n
staðhæfing	s t a ð h a iː v i ŋ k
lega	l ɛː ɣ a
reikningur	r e i h k n i ŋ k ʏ r
reka	r ɛː k a
hekla	h ɛ h k l a
sót	s o uː t
gilitrutt	c ɪː l ɪ tʰ r ʏ h t
löngun	l ø y ŋ k ʏ n
tæpur	tʰ a iː p ʏ r
vegur	v ɛː ɣ ʏ r
þessalía	θ ɛ sː a l iː j a
aðalhending	aː ð a l h ɛ n t i ŋ k
villimaður	v ɪ t l ɪ m aː ð ʏ r
baul	p ø yː l
graður	k r aː ð ʏ r
sigmar	s ɪ ɣ m aː r
lúta	l uː t a
viður	v ɪː ð ʏ r
vængur	v a i ŋ k ʏ r
dauður	t ø yː ð ʏ r
gjaldeyrir	c a l t e iː r ɪ r
farangur	f aː r a u ŋ k ʏ r
aðalbygging	aː ð a l p ɪ cː i ŋ k
kjötkveðjuhátíð	cʰ œ t kʰ v ɛ ð j ʏ h a uː tʰ iː ð
stafur	s t aː v ʏ r
grimmur	k r ɪ mː ʏ r
leikfang	l e iː k f a u ŋ k
freyðivín	f r e iː ð ɪ v iː n
andarungi	a n t a r u ɲ c ɪ
lystauki	l ɪ s t ø yː c ɪ
dúkönd	t uː k œ n t
sítróna	s iː tʰ r o uː n a
biðja	p ɪ ð j a
hör	h œː r
steinn	s t e i t n
bókasafnsfræðingur	p o uː k a s a p n s f r a iː ð i ŋ k ʏ r
prís	pʰ r iː s
gljá	k l j a uː
guðbrandína	k v ʏ ð p r a n t iː n a
eyðimörk	e iː ð ɪ m œ r̥ k
kjarr	cʰ a rː
kalifornía	kʰ aː l ɪ f ɔ r n i j a
vídd	v i tː
ísakína	iː s aː k iː n a
skissa	s c ɪ sː a
hvolpur	kʰ v ɔ l̥ p ʏ r
ræðari	r a iː ð a r ɪ
táldraga	t a u l t r aː ɣ a
franska	f r a n s k a
reiði	r e iː ð ɪ
gorta	k ɔ r̥ t a
garg	k a r k
ýra	iː r a
eiður	e iː ð ʏ r
nota	n ɔː t a
fáránlegur	f a uː r a u n l ɛː ɣ ʏ r
breyting	p r e iː t i ŋ k
mat	m aː t
korkur	kʰ ɔ r̥ k ʏ r
slúta	s t l uː t a
blessun	p l ɛ sː ʏ n
galli	k a t l ɪ
ermi	ɛ r m ɪ
reglulegur	r ɛ k l ʏ l ɛː ɣ ʏ r
mana	m aː n a
orðaleikur	ɔ r ð a l e iː k ʏ r
blóðleysi	p l o u ð l e iː s ɪ
prettvísi	pʰ r ɛ h t v iː s ɪ
prestur	pʰ r ɛ s t ʏ r
smóking	s m o uː cʰ i ŋ k
eff	ɛ fː
seiði	s e iː ð ɪ
linka	l i ŋ̊ k a
gnýja	k n iː j a
vöndull	v œ n t ʏ t l
peningamarkaðssjóður	pʰ ɛː n i ŋ k a m a r̥ k a ð s s j o uː ð ʏ r
lögg	l œ kː
framleiðandi	f r a m l e iː ð a n t ɪ
hæfileiki	h a iː v ɪ l e iː c ɪ
krakk	kʰ r a h k
leikhús	l e iː k h uː s
slakur	s t l aː k ʏ r
synjun	s ɪ n j ʏ n
þyrnóttur	θ ɪ r t n o u h t ʏ r
sammiðja	s a m m ɪ ð j a
fylgd	f ɪ l t
öðlast	œ ð l a s t
edik	ɛː t ɪ k
miski	m ɪ s c ɪ
hélumosi	ç ɛː l ʏ m ɔː s ɪ
áhugamál	a uː h ʏː ɣ a m a uː l
eftirför	ɛ f t ɪ r f œː r
forheimskun	f ɔː r h e i m s k ʏ n
eisti	e i s t ɪ
hrygla	r̥ ɪ k l a
sigurdís	s ɪː ɣ ʏ r t iː s
sóun	s o uː ʏ n
miðill	m ɪː ð ɪ t l
netla	n ɛ h t l a
kúpull	kʰ uː p ʏ t l
tál	tʰ a uː l
skott	s k ɔ h t
sópa	s o uː p a
súrmjólk	s u r m j o u l̥ k
frakkneskur	f r a h k n ɛ s k ʏ r
girða	c ɪ r ð a
lyklabarn	l ɪ h k l a p a r t n
loða	l ɔː ð a
aukastafur	ø yː k a s t aː v ʏ r
flibbi	f l ɪ pː ɪ
glyðra	k l ɪ ð r a
pakkhús	pʰ a h k h uː s
rýra	r iː r a
víxl	v i x s t l
semball	s ɛ m p a t l
gissunn	c ɪ sː ʏ nː
sjúga	s j uː a
nauðgari	n ø y ð k aː r ɪ
undanfarinn	ʏ n t a n f aː r ɪ nː
klunnalegur	kʰ l ʏ nː a l ɛː ɣ ʏ r
náttúruval	n a u h t uː r ʏ v aː l
hlekkja	l̥ ɛ h c a
grön	k r œː n
fiskur	f ɪ s k ʏ r
brynja	p r ɪ n j a
polli	pʰ ɔ lː ɪ
óðinsvé	o uː ð ɪ n s v j ɛː
ól	o uː l
þorsteinn	θ ɔ r̥ s t e i t n
depra	t ɛː p r a
kær	cʰ a iː r
kjóll	cʰ o u t l
rangstaða	r a u ŋ k s t aː ð a
felix	f ɛː l ɪ k s
tiltekt	tʰ ɪː l tʰ ɛ x t
límóna	l iː m o uː n a
ríkur	r iː k ʏ r
klepri	kʰ l ɛː p r ɪ
ábyrgur	a uː p ɪ r k ʏ r
laf	l aː v
dútl	t u h t l
trúlegur	t r uː l ɛː ɣ ʏ r
mói	m o uː ɪ
njáll	n j a u t l
silja	s ɪ l j a
pússa	pʰ u sː a
málmur	m a u l m ʏ r
lungnabláæð	l u ŋ k n a p l a uː a iː ð
flöskuskeyti	f l œ s k ʏ s c e iː t ɪ
árstíð	a u r s tʰ iː ð
hlaup	l̥ ø yː p
vandi	v a n t ɪ
vé	v j ɛː
frestun	f r ɛ s t ʏ n
bugða	p ʏ ɣ ð a
þorskur	θ ɔ r̥ s k ʏ r
merkingarþróun	m ɛ r̥ c i ŋ k a r θ r o uː ʏ n
seytla	s e i h t l a
mamma	m a mː a
heildi	h e i l t ɪ
búfé	p uː f j ɛː
heimskingi	h e i m s c i ɲ c ɪ
magnús	m a k n uː s
pyngja	pʰ i ɲ c a
ráð	r a uː ð
krúna	kʰ r u n a
ástþrúður	a u s t θ r uː ð ʏ r
fang	f a u ŋ k
múslimi	m u s t l ɪː m ɪ
tomma	tʰ ɔ mː a
teigur	tʰ e iː ɣ ʏ r
hitna	h ɪ h t n a
yfirdrepsskapur	ɪː v ɪ r t r ɛ p s s k aː p ʏ r
elli	ɛ t l ɛ ~ ɪ n t ʏ r
bóknám	p o uː k n a uː m
efni	ɛ p n ɪ
sirkill	s ɪ r̥ c ɪ t l
jen	j ɛː n
riddari	r ɪ tː a r ɪ
bólga	p o u l k a
lúi	l uː ɪ
kynslóð	cʰ ɪ n s t l o uː ð
pels	pʰ ɛ l s
blásveifgras	p l a uː s v e i v k r aː s
kræla	kʰ r a iː l a
burður	p ʏ r ð ʏ r
þjáður	θ j a uː ð ʏ r
lágarfi	l a uː ɣ a r v ɪ
geispa	c e i s p a
kála	kʰ a uː l a
gos	k ɔː s
uxi	ʏ x s ɪ
verðlaun	v ɛ r ð l ø yː n
barna	p a r t n a
laglína	l a ɣ l iː n a
áhersluatviksorð	a uː h ɛ r̥ s t l ʏ aː t v ɪ k s ɔ r ð
skýli	s c iː l ɪ
svarðmosi	s v a r ð m ɔː s ɪ
ilmur	ɪ l m ʏ r
flytja	f l ɪː t j a
gírstöng	c iː r̥ s t ø y ŋ k
frá	f r a uː
gyðingur	c ɪː ð i ŋ k ʏ r
lagni	l a k n ɪ
rit	r ɪː t
erfðafræði	ɛ r v ð a f r a iː ð ɪ
hula	h ʏː l a
klúr	kʰ l uː r
ferskja	f ɛ r̥ s c a
upptrekktur	ʏ h p tʰ r ɛ x t ʏ r
svíta	s v iː t a
tinda	tʰ ɪ n t a
nákvæmlega	n a uː kʰ v a i m l ɛː ɣ a
sandur	s a n t ʏ r
hvítkál	xʷ iː t kʰ a uː l
branda	p r a n t a
eðja	ɛ ð j a
heiðarleiki	h e iː ð a r l e iː c ɪ
úkraínskur	uː kʰ r a i n s k ʏ r
flóajurt	f l o uː a j ʏ r̥ t
boðberi	p ɔ ð p ɛː r ɪ
tónlist	tʰ o u n l ɪ s t
munnur	m ʏ nː ʏ r
rafsvið	r a v s v ɪː ð
ómögulegur	o uː m œː ɣ ʏ l ɛː ɣ ʏ r
meðlæti	m ɛ ð l a iː t ɪ
ættingi	a i h t i ɲ c ɪ
áreiðanlegur	a uː r e iː ð a n l ɛː ɣ ʏ r
gerjun	c ɛ r j ʏ n
hnegg	n̥ ɛ kː
niðurgangur	n ɪː ð ʏ r k a u ŋ k ʏ r
prentsmiðja	pʰ r ɛ n̥ t s m ɪ ð j a
sekvensa	s ɛː kʰ v ɛ n s a
klefi	kʰ l ɛː v ɪ
velmegun	v ɛ l m ɛː ɣ ʏ n
syrgja	s ɪ r c a
plebbi	pʰ l ɛ pː ɪ
heimalið	h e iː m a l ɪː ð
eggjaskurn	ɛ cː a s k ʏ r t n
miðja	m ɪ ð j a
festi	f ɛ s t ɪ
baun	p ø yː n
hafri	h a v r ɪ
órans	o uː r a n s
lögur	l œː ɣ ʏ r
flækja	f l a iː c a
millipils	m ɪ t l ɪ pʰ ɪ l s
kúld	kʰ u l t
oddur	ɔ tː ʏ r
millimetri	m ɪ lː ɪ m ɛː t r ɪ
kall	kʰ a t l
líkamur	l iː kʰ aː m ʏ r
rita	r ɪː t a
ýja	iː j a
vigfúsína	v ɪ x f uː s iː n a
mötunautur	m œː t ʏ n ø yː t ʏ r
klekkja	kʰ l ɛ h c a
súld	s u l t
tyrkískur	tʰ ɪ r̥ c i s k ʏ r
lávarður	l a uː v a r ð ʏ r
bæt	p a iː t
asía	aː s iː j a
vargur	v a r k ʏ r
kornbreskur	kʰ ɔ r t n p r ɛ s k ʏ r
álaborg	a uː l a p ɔ r k
ræða	r a iː ð a
baula	p ø yː l a
álfur	a u l v ʏ r
sælgæti	s a i l c a iː t ɪ
tangi	tʰ a u ɲ c ɪ
flýtir	f l iː t ɪ r
hálfviti	h a u l v v ɪː t ɪ
stytting	s t ɪ h t i ŋ k
líka	l iː k a
taugakerfi	tʰ ø yː ɣ a cʰ ɛ r v ɪ
kögur	kʰ œː ɣ ʏ r
skýr	s c iː r
dagblað	t a ɣ p l aː ð
ál	a uː l
afkáralegur	a v kʰ a uː r a l ɛː ɣ ʏ r
lágmynd	l a u ɣ m ɪ n t
stressa	s t r ɛ sː a
stífur	s t iː v ʏ r
sæng	s a i ŋ k
grófur	k r o uː v ʏ r
mannvirki	m a nː v ɪ r̥ c ɪ
fergin	f ɛ r c ɪ n
bretland	p r ɛː t l a n t
dráttur	t r a u h t ʏ r
draga	t r aː ɣ a
veill	v e i t l
kalk	kʰ a l̥ k
baugur	p ø yː ɣ ʏ r
grimmd	k r ɪ m t
blæjuber	p l a iː j ʏ p ɛː r
undirlag	ʏ n t ɪ r l aː ɣ
miðeyra	m ɪː ð e iː r a
basl	p a s t l
hjá	ç a uː
frændsemi	f r a i n t s ɛː m ɪ
afríka	aː f r iː k a
hugsun	h ʏ x s ʏ n
skollakambur	s k ɔ t l a kʰ a m p ʏ r
hnefaleikar	n̥ ɛː v a l e iː k a r
serbi	s ɛ r p ɪ
krabbamein	kʰ r a pː a m e iː n
bagall	p aː ɣ a t l
bloggari	p l ɔ kː a r ɪ
háttarökfræði	h a u h t a r œ k f r a iː ð ɪ
munu	m ʏː n ʏ
verður	v ɛ r ð ʏ r
járnbrautarstöð	j a u r t n p r ø yː t a r s t œː ð
skila	s c ɪː l a
tjá	tʰ j a uː
lak	l aː k
vélinda	v j ɛː l ɪ n t a
núna	n uː n a
hik	h ɪː k
stroff	s t r ɔ fː
sifjarsóley	s ɪ v j a r s o uː l e iː
innheimta	ɪ nː h e i m̥ t a
frásögn	f r a uː s œ k n
runnamura	r ʏ nː a m ʏː r a
skora	s k ɔː r a
strítkar	s t r iː t kʰ aː r
sker	s c ɛː r
skýrsla	s c i r̥ s t l a
aldinbori	a l t ɪ n p ɔː r ɪ
markvörður	m a r̥ k v œ r ð ʏ r
handknattleikur	h a n t kʰ n a h t l e iː k ʏ r
þögull	θ œː ɣ ʏ t l
ísbjörn	iː s p j œ r t n
flagahnoðri	f l aː ɣ a n̥ ɔ ð r ɪ
ról	r o uː l
bók	p o uː k
hreinlæti	r̥ e i n l a iː t ɪ
fljót	f l j o uː t
kristjana	k r ɪ s t j aː n a
blóð	p l o uː ð
millinafn	m ɪ t l ɪ n a p n
stífa	s t iː v a
smánetla	s m a uː n ɛ h t l a
óásjálegur	o uː a uː s j a uː l ɛː ɣ ʏ r
steypa	s t e iː p a
hörfræ	h œ r f r a iː
hörðaland	h œ r ð a l a n t
gróði	k r o uː ð ɪ
þoka	θ ɔː k a
pé	pʰ j ɛː
sveinn	s v e i t n
þröngur	θ r ø y ŋ k ʏ r
skauta	s k ø yː t a
hryðjuverk	r̥ ɪ ð j ʏ v ɛ r̥ k
alda	a l t a
flotaforingi	f l ɔː t a f ɔː r i ɲ c ɪ
skutur	s k ʏː t ʏ r
flokka	f l ɔ h k a
rækt	r a i x t
slíta	s t l iː t a
farsæld	f a r̥ s a i l t
hjal	ç aː l
brautargengi	p r ø yː t a r c e i ɲ c ɪ
söngur	s ø y ŋ k ʏ r
inngangur	ɪ nː k a u ŋ k ʏ r
ívar	iː v aː r
fær	f a iː r
hvert	xʷ ɛ r̥ t
beltisstaður	p ɛ l̥ t ɪ s s t aː ð ʏ r
krækla	kʰ r a i h k l a
perla	pʰ ɛ r t l a
tólúen	tʰ o uː l uː ɛː n
biskupskápa	p ɪ s k ʏ p s kʰ a uː p a
skír	s c iː r
engiferöl	e i ɲ c ɪ f ɛː r œː l
toga	tʰ ɔː ɣ a
baggi	p a cː ɪ
barrfinka	p a rː f i ŋ̊ k a
árós	a uː r o uː s
snefill	s t n ɛː v ɪ t l
skarifífill	s k aː r ɪ f iː v ɪ t l
brjálæði	p r j a uː l a iː ð ɪ
hvarfstig	xʷ a r f s t ɪː ɣ
aðferð	a ð f ɛ r ð
október	ɔ x t o uː p ɛː r
hindartré	h ɪ n t a r t r j ɛː
hrókur	r̥ o uː k ʏ r
handahóf	h a n t a h o uː v
þórey	θ o uː r e iː
hálíngresi	h a uː l i n k r ɛː s ɪ
jöklaklukka	j œ h k l a kʰ l ʏ h k a
ramba	r a m p a
fríspark	f r iː s p a r̥ k
stýfa	s t iː v a
lík	l iː k
ágætur	a uː c a iː tʰ ʏ r
ydd	ɪ tː
forsjá	f ɔ r̥ s j a uː
holtasóley	h ɔ l̥ t a s o uː l e iː
fjötra	f j œː t r a
skólaár	s k o uː l a a uː r
hverfi	xʷ ɛ r v ɪ
endastöð	ɛ n t a s t œː ð
kú	kʰ uː
gráðugur	k r a uː ð ʏː ɣ ʏ r
álfheiður	a u l v h e iː ð ʏ r
sía	s iː j a
botna	p ɔ h t n a
blys	p l ɪː s
sippuband	s ɪ h p ʏ p a n t
diskur	t ɪ s k ʏ r
glöggur	k l œ kː ʏ r
setningafræði	s ɛ h t n i ŋ k a f r a iː ð ɪ
dylgja	t ɪ l c a
körfubolti	kʰ œ r v ʏ p ɔ l̥ t ɪ
reykur	r e iː k ʏ r
frísneska	f r iː s n ɛ s k a
samhljómur	s a m l̥ j o uː m ʏ r
bæla	p a iː l a
stjúpmóðir	s t j uː p m o uː ð ɪ r
greiðsla	k r e i ð s t l a
lífsþróttur	l i f s θ r o u h t ʏ r
búrka	p u r̥ k a
skýla	s c iː l a
hefð	h ɛ v ð
ris	r ɪː s
smella	s m ɛ t l a
plata	pʰ l aː t a
grá	k r a uː
belgi	p ɛ l c ɪ
toddi	tʰ ɔ tː ɪ
gas	k aː s
heiðindómur	h e iː ð ɪ n t o uː m ʏ r
bruma	p r ʏː m a
flekkaður	f l ɛ h k a ð ʏ r
laktasi	l a x t aː s ɪ
kampavín	kʰ a m̥ p a v iː n
arabíska	aː r a p i s k a
talenta	tʰ a l ɛ n̥ t a
besefi	p ɛː s ɛː v ɪ
pynda	pʰ ɪ n t a
kóngur	kʰ o u ŋ k ʏ r
umtalsverður	ʏ m tʰ a l s v ɛ r ð ʏ r
rifa	r ɪː v a
fremja	f r ɛ m j a
hornabolti	h ɔ r t n a p ɔ l̥ t ɪ
krýning	kʰ r iː n i ŋ k
töfrasproti	tʰ œ v r a s p r ɔː t ɪ
hjólbörur	ç o uː l p œː r ʏ r
blóðskömm	p l o u ð s k œ mː
feðgin	f ɛ ð c ɪː n
auðmundur	ø y ð m ʏ n t ʏ r
dyr	t ɪː r
hreyfing	r̥ e iː v i ŋ k
reynir	r e iː n ɪ r
innrita	ɪ nː r ɪː t a
skjaldarmerkjafræði	s c a l t aː r m ɛ r̥ c a f r a iː ð ɪ
eystra	e i s t r a
rúmföt	r u m f œː t
hallarvirki	h a t l a r v ɪ r̥ c ɪ
riis	r iː s
kafbátur	kʰ a v p a uː t ʏ r
krókódíll	kʰ r o uː k o u t i t l
je	j ɛː
rauðvingull	r ø y ð v i ŋ k ʏ t l
gjarna	c a r t n a
kvistur	kʰ v ɪ s t ʏ r
matareitrun	m aː t aː r e iː t r ʏ n
þel	θ ɛː l
órólegur	o uː r o uː l ɛː ɣ ʏ r
reiðubúinn	r e iː ð ʏ p uː ɪ nː
fat	f aː t
landnemi	l a n t n ɛː m ɪ
pennahnífur	pʰ ɛ nː a n̥ iː v ʏ r
annars	a nː a r̥ s
alvörulaus	a l v œː r ʏ l ø yː s
grand	k r a n t
skjaldburkni	s c a l t p ʏ r̥ k n ɪ
framhlaðningur	f r a m l̥ a ð n i ŋ k ʏ r
skera	s c ɛː r a
ólöf	o uː l œː v
skapari	s k aː p a r ɪ
ostakaka	ɔ s t a kʰ aː k a
alúðlega	aː l u ð l ɛː ɣ a
hlessa	l̥ ɛ sː a
setja	s ɛː t a
gulna	k ʏ l n a
öryggisflokkur	œː r ɪ cː ɪ s f l ɔ h k ʏ r
vista	v ɪ s t a
neysla	n e i s t l a
afar	aː v a r
grámosi	k r a uː m ɔː s ɪ
skraut	s k r ø yː t
hagsbót	h a x s p o uː t
skurfa	s k ʏ r v a
silfur	s ɪ l v ʏ r
haltur	h a l̥ t ʏ r
gómur	k o uː m ʏ r
tap	tʰ aː p
klakkur	kʰ l a h k ʏ r
elgur	ɛ l k ʏ r
öfga	œ v k a
háðung	h a uː ð u ŋ k
bókstafur	p o uː k s t aː v ʏ r
stirðlegur	s t ɪ r ð l ɛː ɣ ʏ r
krydda	kʰ r ɪ tː a
hádegi	h a uː t e iː j ɪ
hneisa	n̥ e iː s a
kló	kʰ l o uː
leppalúði	l ɛ h p a l uː ð ɪ
reitur	r e iː t ʏ r
barein	p aː r e iː n
risaeðla	r ɪː s a ɛ ð l a
nafnbót	n a p n p o uː t
loka	l ɔː k a
kássa	kʰ a u sː a
skriðdreki	s k r ɪ ð t r ɛː c ɪ
lón	l o uː n
fylli	f ɪ t l ɪ
gjóla	c o uː l a
sokkur	s ɔ h k ʏ r
sérstakur	s j ɛ r̥ s t aː k ʏ r
rata	r aː t a
ljósvaki	l j o uː s v aː c ɪ
hýdrat	ç iː t r aː t
rósemi	r o uː s ɛː m ɪ
skoða	s k ɔː ð a
ljósbjalla	l j o uː s p j a t l a
láland	l a uː l a n t
pepperóní	pʰ ɛ h p ɛ r o uː n iː
vitur	v ɪː t ʏ r
rafmagn	r aː m a k n
stífkrampi	s t i v kʰ r a m̥ p ɪ
igla	ɪ k l a
nyt	n ɪː t
dreymandi	t r e iː m a n t ɪ
víns	v i n s
hjartanykra	ç a r̥ t a n ɪː k r a
trygging	tʰ r ɪ cː i ŋ k
fílsbein	f i l s p e iː n
brjánn	p r j a u t n
ljúga	l j uː a
hvelfdur	kʰ v e l v t ʏ r
munkur	m u ŋ̊ k ʏ r
barín	p aː r iː n
hjólbarði	ç o u l p a r ð ɪ
þingmaður	θ i ŋ k m aː ð ʏ r
hálskirtill	h a u l s c ɪ r t ɪ t l
öngull	ø y ŋ k ʏ t l
þú	θ u
skáldsaga	s k a u l t s aː ɣ a
fitusýra	f ɪː t ʏ s iː r a
öndun	œ n t ʏ n
lýsa	l iː s a
uggur	ʏ kː ʏ r
ítalía	iː tʰ aː l iː j a
skyrpa	s c ɪ r̥ p a
sjónvarp	s j o u n v a r̥ p
kakó	kʰ aː k o uː
fjölliða	f j œ l l ɪː ð a
farseðill	f a r̥ s ɛː ð ɪ t l
skjór	s c o uː r
prúðmennska	pʰ r u ð m ɛ n s k a
hirðir	h ɪ r ð ɪ r
sjáland	s j a uː l a n t
gáfaður	k a uː v a ð ʏ r
linnur	l ɪ nː ʏ r
fuglakjöt	f ʏ k l a cʰ œː t
knattspyrna	kʰ n a h t s p ɪ r t n a
áætlun	a uː a i h t l ʏ n
frilla	f r ɪ t l a
dís	t iː s
smakka	s m a h k a
trekt	tʰ r ɛ x t
skurðaðgerð	s k ʏ r ð a ð c ɛ r ð
forvöð	f ɔ r v œː ð
þarna	θ a r n a
dúfa	t uː v a
trefjasóley	tʰ r ɛ v j a s o uː l e iː
orðrómur	ɔ r ð r o uː m ʏ r
nafnliður	n a p n l ɪː ð ʏ r
kenna	cʰ ɛ nː a
þjóðbraut	θ j o u ð p r ø yː t
blær	p l a i̯ː r
hjúpa	ç uː p a
lóða	l o uː ð a
hjaltested	ç a l̥ t ɛː s t ɛː ð
mýri	m iː r ɪ
goð	k ɔː ð
rúðuborg	r uː ð ʏ p ɔ r k
þekja	θ ɛː c a
garður	k a r ð ʏ r
vofa	v ɔː v a
selja	s ɛ l j a
hvolf	kʰ v ɔ l v
arngunnur	a r t n k ʏ nː ʏ r
fönikía	f œː n ɪ cʰ iː j a
gosi	k ɔː s ɪ
enn	ɛ nː
svarthol	s v a r̥ t h ɔː l
áhrifaríkur	a uː r̥ ɪː v a r iː k ʏ r
atriði	aː t r ɪː ð ɪ
gissurína	c ɪ sː ʏ r iː n a
vindur	v ɪ n t ʏ r
körfuknattleikur	kʰ œ r v ʏ kʰ n a h t l e iː k ʏ r
lögreglukona	l œ ɣ r ɛ k l ʏ k ɔː n a
haglabyssa	h a k l a p ɪ sː a
afkomandi	a v kʰ ɔː m a n t ɪ
eldvarpa	ɛ l t v a r̥ p a
fangaklefi	f a u ŋ k a kʰ l ɛː v ɪ
þrá	θ r a uː
padda	pʰ a tː a
búr	p uː r
næturgali	n a iː t ʏ r k aː l ɪ
væta	v a iː t a
okra	ɔː k r a
útdráttur	uː t t r a u h t ʏ r
kíló	cʰ iː l o uː
lyfjagras	l ɪ v j a k r aː s
undur	ʏ n t ʏ r
kalín	kʰ aː l iː n
geirharður	c e iː r h a r ð ʏ r
kunna	kʰ ʏ nː a
byrkningur	p ɪ r̥ k n i ŋ k ʏ r
rasskinn	r a sː cʰ ɪ nː
bakskaut	p aː k s k ø yː t
saft	s a f t
næsta	n a i s t a
tankur	tʰ a u n̥ k ʏ r
beyging	p e iː j i ŋ k
þarmur	θ a r m ʏ r
gæsahúð	c a iː s a h uː ð
mynstur	m ɪ n s t ʏ r
tákn	tʰ a u h k n
muna	m ʏː n a
tvinni	t v ɪ nː ɪ
vin	v ɪː n
hverfill	kʰ v ɛ r v ɪ t l
meiðsl	m e i ð s t l
krossfiskur	kʰ r ɔ sː f ɪ s k ʏ r
bófi	p o uː v ɪ
löpp	l œ h p
landsvæði	l a n t s v a iː ð ɪ
nía	n iː j a
fiski	f ɪ s c ɪ
bruni	p r ʏː n ɪ
gengill	c e i ɲ c ɪ t l
rigna	r ɪ k n a
dreki	t r ɛː c ɪ
hrotti	r̥ ɔ h t ɪ
vígi	v iː j ɪ
bakstur	p a x s t ʏ r
eggja	ɛ cː a
frauð	f r ø yː ð
alvarlega	a l v a r l ɛː ɣ a
depla	t ɛ h p l a
stýri	s t iː r ɪ
forði	f ɔ r ð ɪ
hænuegg	h a iː n ʏ ɛ kː
fífill	f iː v ɪ t l
skita	s c ɪː t a
flauel	f l ø yː j ɛː l
breytni	p r e i h t n ɪ
meðstjórnandi	m ɛ ð s t j o u r t n a n t ɪ
kirkjugarður	cʰ ɪ r̥ c ʏ k a r ð ʏ r
strákur	s t r a uː k ʏ r
long	l ɔ ŋː
móðir	m o uː ð ɪ r
svartur	s v a r̥ t ʏ r
mæðgin	m a i ð c ɪː n
aðstæður	a ð s t a iː ð ʏ r
stilkur	s t ɪ l̥ k ʏ r
mínus	m iː n ʏ s
þrímynd	θ r iː m ɪ n t
gana	k aː n a
merja	m ɛ r j a
þyrsta	θ ɪ r̥ s t a
myrkvi	m ɪ r̥ k v ɪ
skerða	s c ɛ r ð a
borða	p ɔ r ð a
eyvindína	e iː v ɪ n t iː n a
allsber	a l s p ɛː r
nopi	n ɔː p ɪ
nýting	n iː t i ŋ k
kverkar	kʰ v ɛ r̥ k a r
prentduft	pʰ r ɛ n̥ t t ʏ f t
spergill	s p ɛ r c ɪ t l
heimill	h e iː m ɪ t l
kínverska	cʰ i n v ɛ r̥ s k a
sæða	s a iː ð a
kál	kʰ a uː l
guðmundur	k v ʏ ð m ʏ n t ʏ r
lea	l ɛː a
árangur	a uː r a u ŋ k ʏ r
reyður	r e iː ð ʏ r
garmur	k a r m ʏ r
trega	tʰ r ɛː ɣ a
höggormur	h œ kː ɔ r m ʏ r
beila	p e iː l a
hrímblaðka	r̥ i m p l a ð k a
hólmfríður	h o u l m f r iː ð ʏ r
kaupandi	kʰ ø yː p a n t ɪ
prímus	pʰ r iː m ʏ s
hrossanál	r̥ ɔ sː a n a uː l
hver	kʰ v ʏ ~ œː r
hamborgari	h a m p ɔ r k a r ɪ
tala	tʰ aː l a
munni	m ʏ nː ɪ
haförn	h aː v œ r t n
garðyrkjumaður	k a r ð ɪ r̥ c ʏ m aː ð ʏ r
tuskulegur	tʰ ʏ s k ʏ l ɛː ɣ ʏ r
tögl	tʰ œ k l
krókus	kʰ r o uː k ʏ s
knega	kʰ n ɛː ɣ a
hagfræði	h a x f r a iː ð ɪ
sorti	s ɔ r̥ t ɪ
merkja	m ɛ r̥ c a
laða	l aː ð a
sótthreinsa	s o u h t r̥ e i n s a
óskhyggja	o u s k h ɪ cː a
símonía	s iː m ɔː n iː j a
svaladrykkur	s v aː l a t r ɪ h k ʏ r
hnignun	n̥ ɪ k n ʏ n
baskneska	p a s k n ɛ s k a
tötur	tʰ œː t ʏ r
loftslag	l ɔ f t s l aː ɣ
sæmundína	s a iː m ʏ n t iː n a
sekkur	s ɛ h k ʏ r
landsvala	l a n t s v aː l a
hljóða	l̥ j o uː ð a
heimska	h e i m s k a
skekkja	s c ɛ h c a
ólmur	o u l m ʏ r
öryggisgler	œː r ɪ cː ɪ s k l ɛː r
sinn	s ɪ nː
frjáls	f r j a u l s
knýja	kʰ n iː j a
krít	kʰ r iː t
dagatal	t aː ɣ a tʰ aː l
rúða	r uː ð a
hriki	r̥ ɪː c ɪ
dýrafræði	t iː r a f r a iː ð ɪ
hirða	h ɪ r ð a
öfl	œ p l
frakkar	f r a h k aː r
stafla	s t a p l a
sögusögn	s œː ɣ ʏ s œ k n
atlot	aː t l ɔː t
flóastör	f l o uː a s t œː r
laukur	l ø yː k ʏ r
djörfung	t j œ r v u ŋ k
fjandskapur	f j a n t s k aː p ʏ r
staður	s t aː ð ʏ r
sverta	s v ɛ r̥ t a
flundra	f l ʏ n t r a
búðarþjófur	p uː ð a r θ j o uː v ʏ r
hliðarlína	l̥ ɪː ð a r l iː n a
sýki	s iː c ɪ
frægð	f r a i ɣ ð
bíða	p iː ð a
reyfi	r e iː v ɪ
lausn	l ø y s t n
númer	n uː m ɛː r
taug	tʰ ø yː ɣ
karrí	kʰ a rː iː
ata	aː t a
gervi	c ɛ r v ɪ
angóla	a ŋ k o uː l a
þrugl	θ r ʏ k l
mey	m e iː
sætta	s a i h t a
skaf	s k aː v
björn	p j œ r t n
kitl	cʰ ɪ h t l
innbrot	ɪ nː p r ɔː t
séra	s j ɛː r a
beinn	p e i t n
ríkidæmi	r iː c ɪ t a iː m ɪ
loðna	l ɔ ð n a
kórea	kʰ o uː r ɛː a
rangeygður	r a u ŋ k e i ɣ ð ʏ r
namm	n a mː
hraða	r̥ aː ð a
pex	p ɛ k s
varkárni	v a r̥ kʰ a u r t n ɪ
sykurmoli	s ɪː k ʏ r m ɔː l ɪ
búralegur	p uː r a l ɛː ɣ ʏ r
andfélagslega	a n t f j ɛː l a x s l ɛː ɣ a
appelsínusafi	a h p ɛ l s iː n ʏ s aː v ɪ
munnskol	m ʏ nː s k ɔː l
meðleikur	m ɛ ð l e iː k ʏ r
sennilega	s ɛ nː ɪ l ɛː ɣ a
börur	p œː r ʏ r
straumur	s t r œ yː m ʏ r̥
gegna	c ɛ k n a
hórdómur	h o u r t o uː m ʏ r
rósakál	r o uː s a kʰ a uː l
fúi	f uː ɪ
klæðaskápur	kʰ l a iː ð a s k a uː p ʏ r
klútur	kʰ l uː t ʏ r
þreifa	θ r e iː v a
túlkur	tʰ u l̥ k ʏ r
tæta	tʰ a iː t a
framkoma	f r a m kʰ ɔː m a
fullnusta	f ʏ t l n ʏ s t a
hás	h a uː s
teygjustökk	tʰ e iː j ʏ s t œ h k
erfiða	ɛ r v ɪː ð a
jörundína	j œː r ʏ n t iː n a
tröllaukinn	tʰ r œ t l ø yː c ɪ n
kviðslit	kʰ v ɪ ð s t l ɪː t
finka	f i ŋ̊ k a
tegund	tʰ ɛː ɣ ʏ n t
ríkisfang	r iː c ɪ s f a u ŋ k
svæfi	s v a iː v ɪ
veturliði	v ɛː t ʏ r l ɪː ð ɪ
elfur	ɛ l v ʏ r
mývatn	m iː v aʰ t n
elli	ɛ t l ɪ
dúr	t uː r
hyski	h ɪ s c ɪ
grasasni	k r aː s a s t n ɪ
tvíbaka	tʰ v iː p aː k a
kúga	k uː a
bjarndís	p j a r t n t iː s
blóðnasir	p l o u ð n aː s ɪ r
frakki	f r a h c ɪ
radísa	r aː t iː s a
yfirgefa	ɪː v ɪ r c ɛː v a
villa	v ɪ lː a
dómpápi	t o u m pʰ a uː p ɪ
ljóseind	l j o uː s e i n t
err	ɛ rː
heimur	h e iː m ʏ r
þríhliða	θ r iː l̥ ɪː ð a
jafnt	j a f t
jakuxi	j aː k ʏ x s ɪ
fimleikar	f ɪ m l e iː k a r
hryggð	r̥ ɪ ɣ ð
skeljamura	s c ɛ l j a m ʏː r a
skítur	s c iː t ʏ r
trimma	tʰ r ɪ mː a
neptúnus	n ɛ p tʰ uː n ʏ s
helsingjaeyri	h ɛ l s ɪ ɲ c a e iː r ɪ
syndur	s ɪ n t ʏ r
schram	s k r aː m
brundur	p r ʏ n t ʏ r
kjörfursti	cʰ œ r̥ f ʏ r̥ s t ɪ
hveiti	xʷ e iː t ɪ
vestri	v ɛ s t r ɪ
glaumgosi	k l ø y m k ɔː s ɪ
sigur	s ɪː ɣ ʏ r
védís	v j ɛː t iː s
merking	m ɛ r̥ c i ŋ k
sigmundína	s ɪ ɣ m ʏ n t iː n a
játa	j a uː t a
prímtala	pʰ r i m tʰ aː l a
rúgur	r uː ʏ r
hnúður	n̥ uː ð ʏ r
skelfing	s c ɛ l v i ŋ k
toppur	tʰ ɔ h p ʏ r
me	m ɛː
byrgja	p ɪ r c a
næpa	n a iː p a
ákveðinn	a uː kʰ v ɛː ð ɪ nː
ótrúr	o uː t r uː r
sæbjúga	s a iː p j uː a
andvaka	a n t v aː k a
gagnsemi	k a k n s ɛː m ɪ
mállýska	m a u l l i s k a
bakborði	p aː k p ɔ r ð ɪ
sljór	s l j o uː r
einasta	e iː n a s t a
gjörð	c œ r ð
ananas	aː n aː n a s
samlyndi	s a m l ɪ n t ɪ
góður	k o uː ð ʏ r
kærasta	cʰ a iː r a s t a
lán	l a uː n
mjálm	m j a u l m
tékkneska	tʰ j ɛ h k n ɛ s k a
snilli	s t n ɪ t l ɪ
stríða	s t r iː ð a
júlímánuður	j uː l iː m a uː n ʏ ð ʏ r
skylda	s c ɪ l t a
afsláttur	a f s t l a u h t ʏ r
hrísla	r̥ i s t l a
blæðing	p l a iː ð i ŋ k
segja	s e iː j a
aþena	aː θ ɛː n a
gunnþórunn	k ʏ n θ o uː r ʏ nː
snjallur	s t n j a t l ʏ r
gjaldþrot	c a l t θ r ɔː t
hvolpur	xʷ ɔ l̥ p ʏ r
grannur	k r a nː ʏ r
rýja	r iː j a
aðalheiður	aː ð a l h e iː ð ʏ r
laugardagur	l ø yː ɣ a r t aː ɣ ʏ r
mótun	m o uː t ʏ n
bjargmundur	p j a r k m ʏ n t ʏ r
regndropi	r ɛ k n t r ɔː p ɪ
fresta	f r ɛ s t a
dynur	t ɪː n ʏ r
gigt	c ɪ x t
lágmark	l a u ɣ m a r̥ k
nautakjöt	n ø yː t a cʰ œː t
kvaka	kʰ v aː k a
svik	s v ɪː k
hafmey	h a v m e iː
blóðmör	p l o u ð m œː r
líða	l iː ð a
óska	o u s k a
öfund	œː v ʏ n t
krakki	kʰ r a h c ɪ
alvarlegur	a l v a r l ɛː ɣ ʏ r
víg	v iː ɣ
borgundarhólmur	p ɔ r k ʏ n t a r h o u l m ʏ r
mæðgur	m a i ð k ʏ r
þangað	θ a u ŋ k aː ð
jóskur	j o u s k ʏ r
hófsóley	h o u v s o uː l e iː
lögfræðingur	l œ ɣ f r a iː ð i ŋ k ʏ r
kommúnisti	kʰ ɔ mː uː n ɪ s t ɪ
eygja	e iː j a
herpingur	h ɛ r̥ p i ŋ k ʏ r
píra	pʰ iː r a
gulstör	k ʏ l s t œː r
afbaka	a v p aː k a
jafntefli	j a p n tʰ ɛ p l ɪ
bogna	p ɔ k n a
hugmyndafræði	h ʏ ɣ m ɪ n t a f r a iː ð ɪ
ríkisdalur	r iː c ɪ s t aː l ʏ r
safi	s aː v ɪ
eydís	e iː t iː s
ungi	u ŋ k ɪ
fullyrðing	f ʏ t l ɪ r ð i ŋ k
skaða	s k aː ð a
snær	s n a iː r
arnmundur	a r t n m ʏ n t ʏ r
kalkspat	kʰ a l̥ k s p aː t
gunga	k u ŋ k a
tímarit	tʰ iː m a r ɪː t
paufa	pʰ ø yː v a
skrín	s k r iː n
orki	ɔ r̥ c ɪ
stríðni	s t r i ð n ɪ
postulín	pʰ ɔ s t ʏː l iː n
hlátur	l̥ a uː t ʏ r
lumpa	l ʏ m̥ p a
matarprjónn	m aː t a r pʰ r j o u t n
dramb	t r a m p
dæla	t a iː l a
flygill	f l ɪː j ɪ t l
svið	s v ɪː ð
þið	θ ɪ ð
skór	s k o uː r
hljómplata	l̥ j o u m pʰ l aː t a
mylja	m ɪ l j a
hollur	h ɔ t l ʏ r
herkinn	h ɛ r̥ c ɪ nː
trommari	tʰ r ɔ mː aː r ɪ
pinkill	pʰ i ɲ̊ c ɪ t l
afhending	a f h ɛ n t i ŋ k
nóg	n o uː
inngrip	ɪ nː k r ɪː p
buxnaklauf	p ʏ x s n a k l ø yː v
jana	j aː n a
ymja	ɪ m j a
klukka	kʰ l ʏ h k a
kornhæna	kʰ ɔ r t n h a iː n a
fjallaljón	f j a t l a l j o uː n
krosskónguló	kʰ r ɔ sː k o u ŋ k ʏ l o uː
fjötur	f j œː t ʏ r
franskbrauð	f r a n s k p r ø yː ð
lemmun	l ɛ mː ʏ n
hérmeð	ç ɛ r m ɛː ð
sleggjukast	s t l ɛ cː ʏ kʰ a s t
asetón	aː s ɛː tʰ o uː n
gaul	k ø yː l
sólarljós	s o uː l a r l j o uː s
meinafræði	m e iː n a f r a iː ð ɪ
blygðun	p l ɪ ɣ ð ʏ n
fallegur	f a t l ɛː ɣ ʏ r
jæja	j a iː j a
vasaorðabók	v aː s a ɔ r ð a p o uː k
hörður	h œ r ð ʏ r
látbragð	l a uː t p r a ɣ ð
maríutása	m aː r iː j ʏ tʰ a uː s a
gifting	c ɪ f t i ŋ k
rassa	r a sː a
dabbi	t a pː ɪ
pýþagóras	pʰ iː θ a k o uː r aː s
mölur	m œː l ʏ r
skarfakál	s k a r v a kʰ a uː l
guðfræði	k v ʏ ð f r a iː ð ɪ
spennandi	s p ɛ nː a n t ɪ
tvisvar	tʰ v ɪː s v aː r
geðshræring	c ɛ ð s r̥ a iː r i ŋ k
hljóma	l̥ j o uː m a
sær	s a iː r
millibil	m ɪ t l ɪ p ɪː l
gefa	c ɛː v a
orðatiltæki	ɔ r ð a tʰ ɪ l̥ tʰ a iː c ɪ
bindi	p ɪ n t ɪ
unndís	ʏ nː t iː s
alkul	a l kʰ ʏː l
grið	k r ɪː ð
mitti	m ɪ h t ɪ
messa	m ɛ sː a
megin	m e iː j ɪ n
plægja	pʰ l a iː j a
dúkka	t u h k a
geirfríður	c e i r̥ f r iː ð ʏ r
æskja	a i s c a
ræðinn	r a iː ð ɪ n
svipta	s v ɪ f t a
stjarna	s t j a r t n a
gallabuxur	k a lː a p ʏ x s ʏ r
hoppa	h ɔ h p a
jensína	j ɛ n s iː n a
eþíópía	ɛː θ j o uː pʰ iː j a
gildur	c ɪ l t ʏ r
þjónusta	θ j o uː n ʏ s t a
landafræði	l a n t a f r a iː ð ɪ
hróný	r̥ o uː n iː
fönn	f œ nː
forstofa	f ɔ r̥ s t ɔː v a
allsgáður	a l s k a uː ð ʏ r
óendanleiki	o uː ɛ n t a n l e iː c ɪ
austurríkismaður	ø y s t ʏ r r iː c ɪ s m aː ð ʏ r
aga	aː ɣ a
veðurtungl	v ɛː ð ʏ r tʰ u ŋ l
skíri	s c iː r ɪ
híbýli	h iː p iː l ɪ
gleðilegur	k l ɛː ð ɪ l ɛː ɣ ʏ r
sjöa	s j œː a
lófi	l o uː ɪ
blóðarfi	p l o uː ð a r v ɪ
óhreinindi	o uː r̥ e iː n ɪ n t ɪ
heita	h e iː t a
svefn	s v ɛ p n
bláhrafn	p l a uː r̥ a p n
tími	tʰ iː m ɪ
larfur	l a r v ʏ r
miði	m ɪː ð ɪ
drífa	t r iː v a
atferli	aː t f ɛ r t l ɪ
ók	o uː k
hyskni	h ɪ s k n ɪ
samkoma	s a m kʰ ɔː m a
dama	t aː m a
haga	h aː ɣ a
steikja	s t e iː c a
ástaróbó	a u s t a r o uː p o uː
sæmundur	s a iː m ʏ n t ʏ r
skran	s k r aː n
hvítá	kʰ v iː t a uː
verja	v ɛ r j a
kolla	kʰ ɔ t l a
gætinn	c a iː t ɪ nː
regnhlíf	r ɛ k n l̥ iː v
stál	s t a uː l
sleif	s t l e iː v
æti	a iː t ɪ
tjarnablaðka	tʰ j a r t n a p l a ð k a
njóta	n j o uː t a
hrynjandi	r̥ ɪ n j a n t ɪ
bjakk	p j a h k
fimmti	f ɪ m̥ t ɪ
meðferð	m ɛ ð f ɛ r ð
kennslustund	cʰ ɛ n s t l ʏ s t ʏ n t
hertogadæmi	h ɛ r̥ tʰ ɔː ɣ a t a iː m ɪ
réna	r j ɛː n a
skordýr	s k ɔ r t iː r
jaðarrokk	j aː ð a r r ɔ h k
kokka	kʰ ɔ h k a
undra	ʏ n t r a
gleðikona	k l ɛː ð ɪ kʰ ɔː n a
unglingur	u ŋ l i ŋ k ʏ r
garn	k a r t n
ítrekað	iː tʰ r ɛː k a ð
foringi	f ɔː r i ɲ c ɪ
gola	k ɔː l a
forðafræði	f ɔ r ð a f r a iː ð ɪ
hnífasmíði	n̥ iː v a s m iː ð ɪ
glaður	k l aː ð ʏ r
mjólkurkýr	m j o u l̥ k ʏ r cʰ iː r
bóka	p o uː k a
kjaga	cʰ aː ɣ a
bretti	p r ɛ h t ɪ
plús	pʰ l uː s
jöstur	j œ s t ʏ r
tíu	t iː ʏ
verðmætur	v ɛ r ð m a iː t ʏ r
kontrafagott	kʰ ɔ n̥ t r a f aː k ɔ h t
blífur	p l iː v ʏ r
tamur	tʰ aː m ʏ r
sídd	s i tː
áræða	a uː r a iː ð a
rola	r ɔː l a
æviágrip	a iː v ɪ a uː k r ɪː p
bómull	p o uː m ʏ t l
hrumur	r̥ ʏː m ʏ r
málband	m a u l p a n t
andarnefja	a n t a r n ɛ v j a
maídís	m a iː t iː s
tælenska	tʰ a iː l ɛ n s k a
símon	s iː m ɔː n
rist	r ɪ s t
lofa	l ɔː v a
nagdýr	n a ɣ t iː r
reyta	r e iː t a
karakter	kʰ a r a x t ɛː r
festing	f ɛ s t i ŋ k
slægur	s l a iː ɣ ʏ r
fár	f a uː r
veðja	v ɛ ð j a
járnöld	j a u r t n œ l t
hlýna	l̥ iː n a
háaloft	h a uː a l ɔ f t
man	m a n
sigdís	s ɪ ɣ t iː s
öryggisbrestur	œː r ɪ cː ɪ s b r ɛ s t ʏ r
lá	l a uː
vél	v j ɛː l
kvöldverður	kʰ v œ l t v ɛ r ð ʏ r
melda	m ɛ l t a
panna	pʰ a nː a
geimferð	c e i m f ɛ r ð
argentína	a r k ɛ n tʰ iː n a
blundur	p l ʏ n t ʏ r
fórn	f o u r t n
kærasti	cʰ a iː r a s t ɪ
vika	v ɪː k a
færiband	f a iː r ɪ p a n t
þrýstihópur	θ r i s t ɪ h o uː p ʏ r
ostsneið	ɔ s t s t n e iː ð
bæn	p a iː n
rakafullur	r aː k a f ʏ t l ʏ r
gort	k ɔ r̥ t
hráki	r̥ a uː c ɪ
aðstoðarmaður	a ð s t ɔː ð a r m aː ð ʏ r
holt	h ɔ l̥ t
hór	h o uː r
reykháfur	r e iː k h a uː v ʏ r
barnabarn	p a t n a p a t n
dvelja	t v ɛ l j a
melablóm	m ɛː l a p l o uː m
hanna	h a nː a
álit	a uː l ɪː t
árdís	a u r t iː s
keppinautur	cʰ ɛ h p ɪ n ø yː t ʏ r
bolla	p ɔ lː a
öxl	œ x s t l
hani	h aː n ɪ
sveppur	s v ɛ h p ʏ r
gjamm	c a mː
ostagerð	ɔ s t a c ɛ r ð
alþingi	a l θ i ŋ c ɪ
helmingur	h ɛ l m i ŋ k ʏ r
hjóm	ç o uː m
stór	s t o uː r
foli	f ɔː l ɪ
slútta	s t l u h t a
hráolía	r̥ a uː ɔː l i j a
tár	tʰ a uː r
atvinnumaður	aː t v ɪ nː ʏ m aː ð ʏ r
orf	ɔ r v
frestur	f r ɛ s t ʏ r
löstur	l œ s t ʏ r
hæða	h a iː ð a
albanía	a l p aː n iː j a
spænska	s p a i n s k a
gæs	c a iː s
stát	s t a uː t
barmur	p a r m ʏ r
vígður	v i ɣ ð ʏ r
snar	s t n aː r
hjarta	ç a r̥ t a
lénharður	l j ɛː n h a r ð ʏ r
heimspeki	h e i m s p ɛː c ɪ
þyrnir	θ ɪ r t n ɪ r
djúprista	t j uː p r ɪ s t a
fló	f l o uː
styggja	s t ɪ cː a
bolludagur	p ɔ lː ʏ t aː ɣ ʏ r
pípuhattur	pʰ iː p ʏ h a h t ʏ r
rein	r e iː n
simpill	s ɪ m̥ p ɪ t l
frumvarp	f r ʏ m v a r̥ p
norðmaður	n ɔ r ð m aː ð ʏ r
kyrja	cʰ ɪ r j a
spónn	s p o u t n
fanga	f a u ŋ k a
framsaga	f r a m s aː ɣ a
gler	k l ɛː r
blinda	p l ɪ n t a
þýskaland	θ i s k a l a n t
sprengja	s p r e i ɲ c a
hefna	h ɛ p n a
fylgifiskur	f ɪ l c ɪ f ɪ s k ʏ r
lykkja	l ɪ h c a
clausen	kʰ l a uː s ɛː nː
saur	s ø yː r
krummi	k r̥ ʏ mː ɪ
stilla	s t ɪ t l a
ýta	iː t a
alpahúfa	a l̥ p a h uː v a
einlægni	e i n l a i k n ɪ
thorarensen	tʰ o uː r aː r ɛ n s ɛ nː
högg	h œ kː
hví	kʰ v iː
pálína	pʰ a uː l iː n a
forskaut	f ɔ r̥ s k ø yː t
kör	kʰ œː r
blómsef	p l o u m s ɛː v
sprikla	s p r ɪ h k l a
grænukorn	k r a iː n ʏ kʰ ɔ r t n
vinkill	v i ɲ̊ c ɪ t l
miðaldalatína	m ɪː ð a l t a l aː t iː n a
róm	r o uː m
kofaþorp	kʰ ɔː v a θ ɔ r̥ p
svæla	s v a iː l a
draumleysi	t r ø y m l e iː s ɪ
græta	k r a iː t a
bana	p aː n a
eilífð	e iː l i v ð
frumuveggur	f r ʏː m ʏ v ɛ kː ʏ r
sandkassi	s a n t kʰ a sː ɪ
sleikja	s t l e iː c a
arabía	aː r a p iː j a
sauma	s ø yː m a
feikn	f e i h k n
putta	pʰ ʏ h t a
plokka	pʰ l ɔ h k a
rör	r œː r
vald	v a l t
þrymja	θ r ɪ m j a
alvara	a l v aː r a
svartburkni	s v a r̥ t p ʏ r̥ k n ɪ
sara	s aː r a
hljóðbók	l̥ o u ð p o uː k
deyja	t e iː j a
háll	h a u t l
hinstur	h ɪ n s t ʏ r
brjóstamjólk	p r j o u s t a m j o u l̥ k
farsakenndur	f a r̥ s a cʰ ɛ n t ʏ r
mörður	m œ r ð ʏ r
vist	v ɪ s t
vasaúr	v aː s a uː r
knapi	kʰ n aː p ɪ
fjas	f j aː s
last	l a s t
fjarstýring	f j a r̥ s t iː r i ŋ k
orðasamband	ɔ r ð a s a m p a n t
sumarhnoðri	s ʏː m a r n̥ ɔ ð r ɪ
stöðva	s t œ ð v a
dúkahnífur	t uː k a n̥ iː v ʏ r
þvo	θ v ɔː
finnast	f ɪ nː a s t
efedrín	ɛː f ɛː t r iː n
sveittur	s v e i h t ʏ r
dauðakippur	t ø yː ð a cʰ ɪ h p ʏ r
gullkorn	k ʏ t l kʰ ɔ r t n
biðtími	p ɪ ð tʰ iː m ɪ
konsúll	kʰ ɔ n s u t l
heilbrigður	h e i l p r ɪ ɣ ð ʏ r
klífa	kʰ l iː v a
herkvaðning	h ɛ r̥ kʰ v a ð n i ŋ k
búmaður	p uː m aː ð ʏ r
loftpúði	l ɔ f t pʰ uː ð ɪ
bliki	p l ɪː c ɪ
múr	m uː r
afturfótur	a f t ʏ r f o uː t ʏ r
félag	f j ɛː l aː ɣ
bernharðína	p ɛ r n h a r ð iː n a
fjör	f j œː r
safamikill	s aː v a m ɪː c ɪ t l
ráðning	r a u ð n i ŋ k
frauðplast	f r ø yː ð pʰ l a s t
knörr	kʰ n œ rː
ryðönd	r ɪː ð œ n t
sagnfræði	s a k n f r a iː ð ɪ
hvirfilbylur	kʰ v ɪ r v ɪ l p ɪː l ʏ r
rökhenda	r œː k h ɛ n t a
teygjanleiki	tʰ e iː j a n l e iː c ɪ
klökkna	kʰ l œ h k n a
klósettpappír	kʰ l o uː s ɛ h t pʰ a h p iː r
þátttaka	θ a u h t tʰ aː k a
hefnd	h ɛ m t
mótmæla	m o uː t m a iː l a
gal	k aː l
negri	n ɛ ɣ r ɪ
gaffall	k a fː a t l
pysja	pʰ ɪː s j a
nykra	n ɪː k r a
eða	ɛː ð a
eysill	e iː s ɪ t l
eining	e iː n i ŋ k
hrygna	r̥ ɪ k n a
stuttur	s t ʏ h t ʏ r
grána	k r a uː n a
þrýstiloft	θ r i s t ɪ l ɔ f t
meina	m e iː n a
snarpur	s n a r̥ p ʏ r
útbreiddur	uː t p r e i tː ʏ r
flaka	f l aː k a
himna	h ɪ m n a
minning	m ɪ nː i ŋ k
burst	p ʏ r̥ s t
akkur	a h k ʏ r
sykur	s ɪː k ʏ r
breki	p r ɛː c ɪ
eistneska	e i s t n ɛ s k a
snilli	s t n ɪ lː ɪ
hégómi	ç ɛː k o uː m ɪ
moll	m ɔ lː
gervigreind	c ɛ r v ɪ k r e i n d
skurðarborð	s k ʏ r ð a r p ɔ r ð
verkur	v ɛ r̥ k ʏ r
rís	r iː s
dreif	t r e iː v
vísigreifi	v iː s ɪ k r e iː v ɪ
vöxtur	v œ k s t ʏ r
arinn	aː r ɪ nː
hlutverk	l̥ ʏː t v ɛ r̥ k
rólegur	r o uː l ɛː ɣ ʏ r
flaustur	f l ø y s t ʏ r
spjör	s p j œː r
rofi	r ɔː v ɪ
lundi	l ʏ n t ɪ
stuðull	s t ʏː ð ʏ t l
mátun	m a uː t ʏ n
fyrirlestur	f ɪː r ɪ r l ɛ s t ʏ r
eplamauk	ɛ h p l a m ø yː k
athygli	aː t h ɪ k l ɪ
blýglans	p l iː k l a n s
vöxtur	v œ x s t ʏ r
nálægur	n a uː l a iː ɣ ʏ r
eiginleiki	e iː j ɪ n l e iː c ɪ
dvína	t v iː n a
silfurlitaður	s ɪ l v ʏ r l ɪː t a ð ʏ r
átt	a u h t
kuti	kʰ ʏː t ɪ
kindakjöt	cʰ ɪ n t a cʰ œː t
bora	p ɔː r a
heimsfriður	h e i m s f r ɪː ð ʏ r
klumpur	kʰ l ʏ m̥ p ʏ r
hringa	r̥ i ŋ k a
rok	r ɔː k
pamfíll	pʰ a m f i t l
oktan	ɔ x t aː n
gormur	k ɔ r m ʏ r
úkraína	uː kʰ r aː iː n a
girðing	c ɪ r ð i ŋ k
angan	a u ŋ k a n
gæi	k a iː j ɪ
viðbrögð	v ɪ ð p r œ ɣ ð
skuggi	s k ʏ cː ɪ
steikarhnífur	s t e iː k a r n̥ iː v ʏ r
götun	k œː t ʏ n
heyrnarlaus	h e i r t n a r l ø yː s
þorsti	θ ɔ r̥ s t ɪ
skapvondur	s k aː p v ɔ n t ʏ r
múrhúð	m uː r h uː ð
dalmatía	t a l m a tʰ iː j a
felix	f ɛː l ɪ x s
tipla	tʰ ɪ h p l a
hlíf	l̥ iː v
glas	k l aː s
ból	p o uː l
skánn	s k a u t n
frystiskápur	f r ɪ s t ɪ s k a uː p ʏ r
jesús	j ɛː s uː s
lögga	l œ kː a
kænska	cʰ a i n s k a
tvístra	tʰ v i s t r a
leigubíll	l e iː ɣ ʏ p i t l
sóldís	s o u l t iː s
sökka	s œ h k a
flugbraut	f l ʏ ɣ p r ø yː t
dýrmundur	t i r m ʏ n t ʏ r
rabb	r a pː
greind	k r e i n t
gunnarína	k ʏ nː aː r iː n a
eggjarauða	ɛ cː a r ø yː ð a
fónem	f o uː n ɛː m
maur	m ø yː r
fletta	f l ɛ h t a
leiðsögumaður	l e i ð s œː ɣ ʏ m aː ð ʏ r
föðurland	f œː ð ʏ r l a n t
sitja	s ɪː t j a
strand	s t r a n t
skark	s k a r̥ k
mærð	m a i r ð
fræðimaður	f r a iː ð ɪ m aː ð ʏ r
frekur	f r ɛː k ʏ r
hestur	h ɛ s t ʏ r
þýða	θ iː ð a
æki	a iː c ɪ
rómaborg	r o uː m a p ɔ r k
pedall	pʰ ɛː t a t l
leikur	l e iː k ʏ r
oxíð	ɔ k s iː ð
varða	v a r ð a
bar	p aː r
hverfa	kʰ v ɛ r v a
svona	s v ɔː n a
bjúgstör	p j u ɣ s t œː r
methafi	m ɛː t h aː v ɪ
stuna	s t ʏː n a
barmmerki	p a r m m ɛ r̥ c ɪ
armbandsúr	a r m p a n t s uː r
hjálp	ç a u l̥ p
bik	p ɪː k
þverskurður	θ v ɛ r s k ʏ r ð ʏ r
mótorhjól	m o uː t ɔ r ç o uː l
breiðnefur	p r e i ð n ɛː v ʏ r
bjartsýni	p j a r̥ t s iː n ɪ
aðdróttun	a ð t r o u h t ʏ n
vein	v e iː n
krókódílstár	kʰ r o uː k o u t i l s tʰ a uː r
lýðveldi	l i ð v ɛ l t ɪ
klabb	kʰ l a pː
rithöfundur	r ɪː t h œː v ʏ n t ʏ r
tík	tʰ iː k
sleipa	s t l e iː p a
fyrirlitning	f ɪː r ɪ r l ɪ h t n i ŋ k
værð	v a i r ð
selur	s ɛː l ʏ r
óvild	o uː v ɪ l t
gjóta	c o uː t a
lögfræði	l œ ɣ f r a iː ð ɪ
melanóra	m ɛː l a n o uː r a
háfur	h a uː v ʏ r
bræt	p r a iː t
snyrting	s t n ɪ r̥ t i ŋ k
fjörfiskur	f j œ r f ɪ s k ʏ r
fjallastör	f j a t l a s t œː r
klám	kʰ l a uː m
guðlast	k v ʏ ð l a s t
kollur	kʰ ɔ t l ʏ r
slím	s t l iː m
rassvasi	r a sː v aː s ɪ
handbremsubeygja	h a n t p r ɛ m s ʏ p e iː j a
brandur	p r a n t ʏ r
járningamaður	j a u r t n i ŋ k a m aː ð ʏ r
skækill	s c a iː c ɪ t l
hafna	h a p n a
faðir	f aː ð ɪ r
gjall	c a t l
vikur	v ɪː k ʏ r
grænland	k r a i n l a n t
háþrýstingur	h a uː θ r i s t i ŋ k ʏ r
hrím	r̥ iː m
blekpenni	p l ɛː k pʰ ɛ nː ɪ
nýmjólk	n iː m j o u l̥ k
perlumóðir	pʰ ɛ r t l ʏ m o uː ð ɪ r
lama	l aː m a
app	a h p
lexía	l ɛ k s iː j a
ratsjá	r aː t s j a uː
sníkill	s t n iː c ɪ t l
gautaborg	k ø yː t a p ɔ r k
læknisskoðun	l a i h k n ɪ s s k ɔː ð ʏ n
gé	c ɛː
hræsnistár	r̥ a i s t n ɪ s tʰ a uː r
almætti	a l m a i h t ɪ
england	e i ŋ l a n t
mötun	m œː t ʏ n
einustu	e iː n ʏ s t ʏ
rækta	r a i x t a
ákaflega	a uː kʰ a v l ɛː ɣ a
spila	s p ɪː l a
vígvöllur	v i ɣ v œ t l ʏ r
spjalla	s p j a t l a
hræsni	r̥ a i s t n ɪ
marxisti	m a r̥ k s ɪ s t ɪ
geldingalauf	c ɛ l t i ŋ k a l ø yː v
aðdáun	a ð t a uː ʏ n
otur	ɔː t ʏ r
hjólasæti	ç o uː l a s a iː t ɪ
allteins	a l̥ t e i n s
hélunjóli	ç ɛː l ʏ n j o uː l ɪ
búðarkassi	p uː ð a r kʰ a sː ɪ
böllur	p œ t l ʏ r
ísmoli	iː s m ɔː l ɪ
vera	v ɛː r a
ákefð	a uː c ɛ v ð
blómstra	p l o u m s t r a
líkkista	l iː k cʰ ɪ s t a
klínískur	kʰ l iː n i s k ʏ r
ólga	o u l k a
framlengja	f r a m l e i ɲ c a
stress	s t r ɛ sː
díler	t iː l ɛ r
blaðra	p l a ð r a
kíkir	cʰ iː c ɪ r
vagn	v a k n
kálfur	kʰ a u l v ʏ r
þögn	θ œ k n
bakuggi	p aː k ʏ cː ɪ
stáss	s t a u sː
litningur	l ɪ h t n i ŋ k ʏ r
flasa	f l aː s a
sigra	s ɪ ɣ r a
hásveifgras	h a uː s v e i v k r aː s
fræni	f r a iː n ɪ
smjúga	s m j uː a
liðhlaupi	l ɪ ð l̥ ø yː p ɪ
síbería	s iː p ɛ r iː j a
pantur	pʰ a n̥ t ʏ r
gervill	c ɛ r v ɪ t l
hávella	h a uː v ɛ t l a
dýralæknir	t iː r a l a i h k n ɪ r
sýkn	s i h k n
vegna	v ɛ k n a
aronsvöndur	aː r ɔ n s v œ n t ʏ r
köfnun	kʰ œ p n ʏ n
baðmur	p a ð m ʏ r
húsgagn	h uː s k a k n
hryðja	r̥ ɪ ð j a
feðraveldi	f ɛ ð r a v ɛ l t ɪ
tæla	tʰ a iː l a
ríða	r iː ð a
stinnastör	s t ɪ nː a s t œː r
hindurvitni	h ɪ n t ʏ r v ɪ h t n ɪ
helsingjaborg	h ɛ l s i ɲ c a p ɔ r k
pétti	pʰ j ɛ h t ɪ
hvass	kʰ v a sː
bræði	p r a iː ð ɪ
skurðgröftur	s k ʏ r ð k r œ f t ʏ r
snös	s n œː s
háspil	h a uː s p ɪː l
pempía	pʰ ɛ m̥ p iː j a
kví	kʰ v iː
geitungur	k e iː t u ŋ k ʏ r
mærskur	m a i r̥ s k ʏ r
yðar	ɪː ð a r
smár	s m a uː r
englahorn	e i ŋ l a h ɔ r t n
lúxus	l u x s ʏ s
strigaskór	s t r ɪː ɣ a s k o uː r
skógartoppur	s k o uː a r tʰ ɔ h p ʏ r
dollari	t ɔ lː a r ɪ
kergja	cʰ ɛ r c a
melkorka	m ɛ l kʰ ɔ r̥ k a
lauma	l ø yː m a
rakur	r aː k ʏ r
krjúpa	kʰ r j uː p a
hvor	xʷ ɔː r
stjórnarbylting	s t j o u r t n a r p ɪ l̥ t i ŋ k
orðsending	ɔ r ð s ɛ n t i ŋ k
koddaver	kʰ ɔ tː a v ɛː r
apa	aː p a
æfa	a iː v a
nýnorska	n iː n ɔ r̥ s k a
davíð	t aː v iː ð
hleypa	l̥ e iː p a
veður	v ɛː ð ʏ r
keðja	cʰ ɛ ð j a
blogg	p l ɔ kː
malli	m a lː ɪ
bjarki	p j a r̥ c ɪ
postuli	pʰ ɔ s t ʏː l ɪ
óáreiðanlegur	o uː a uː r e iː ð a n l ɛː ɣ ʏ r
tófa	tʰ o uː a
lauf	l ø yː v
boð	p ɔː ð
belja	p ɛ l j a
andersen	a n t ɛ r s ɛ nː
ber	p ɛː r
hleri	l̥ ɛː r ɪ
umskurður	ʏ m s k ʏ r ð ʏ r
kólna	kʰ o u l n a
glódís	k l o uː t iː s
karkari	kʰ a r̥ k a r ɪ
refsing	r ɛ f s i ŋ k
bór	p o uː r
þúsund	θ uː s ʏ n t
fátækt	f a uː tʰ a i x t
bókfinka	p o uː k f i ŋ̊ k a
tötralegur	tʰ œː t r a l ɛː ɣ ʏ r
greipaldin	k r e iː p a l t ɪ n
svikull	s v ɪː k ʏ t l
búi	p uː ɪ
meðvitaður	m ɛ ð v ɪː t aː ð ʏ r
hóf	h o uː v
húðflúr	h u ð f l uː r
kjammi	cʰ a mː ɪ
geðveikur	c ɛ ð v e iː k ʏ r
pétur	p j ɛː t ʏ r
skapgerð	s k aː p c ɛ r ð
úkraínska	uː kʰ r a i n s k a
íri	iː r ɪ
sútari	s uː t a r ɪ
manneskja	m a nː ɛ s c a
prýði	pʰ r iː ð ɪ
dauðlegur	t ø y ð l ɛː ɣ ʏ r
hádegisverður	h a uː t e iː j ɪ s v ɛ r ð ʏ r
lambagras	l a m p a k r aː s
hálsfesti	h a u l s f ɛ s t ɪ
bleikja	p l e iː c a
húfur	h uː ʏ r
aðgangur	a ð k a u ŋ k ʏ r
gunnur	k ʏ nː ʏ r
amöba	aː m œː p a
fleygur	f l e iː ɣ ʏ r
fé	f j ɛː
kyssilegur	cʰ ɪ sː ɪ l ɛː ɣ ʏ r
þægindi	θ a iː j ɪ n t ɪ
ákveða	a uː kʰ v ɛː ð a
róðukross	r o uː ð ʏ kʰ r ɔ sː
servíetta	s ɛ r v j ɛ h t a
dingl	t i ŋ l
pynta	pʰ ɪ n̥ t a
vonandi	v ɔː n a n t ɪ
nælon	n a iː l ɔː n
emm	ɛ mː
fjölkynngi	f j œ l cʰ i ɲ c ɪ
feyja	f e iː j a
passa	pʰ a sː a
muldur	m ʏ l t ʏ r
byrjun	p ɪ r j ʏ n
beisli	p e i s t l ɪ
þjónustustúlka	θ j o uː n ʏ s t ʏ s t u l̥ k a
lítt	l i h t
vinnumaður	v ɪ nː ʏ m aː ð ʏ r
búningur	p uː n i ŋ k ʏ r
haustlegur	h ø y s t l ɛː ɣ ʏ r
broddgöltur	p r ɔ tː k œ l̥ t ʏ r
flensa	f l ɛ n s a
maís	m aː iː s
georgía	c ɛː ɔ r c iː j a
leysir	l e iː s ɪ r
pynting	pʰ ɪ n̥ t i ŋ k
blók	p l o uː k
gifta	c ɪ f t a
laxerolía	l a x s ɛ r ɔː l i j a
furðuhlutur	f ʏ r ð ʏ l̥ ʏː t ʏ r
pæla	pʰ a iː l a
flatbaka	f l a t p aː k a
bjarmi	p j a r m ɪ
fínn	f i t n
skipun	s c ɪː p ʏ n
orgía	ɔ r c iː j a
heimild	h e iː m ɪ l t
lengja	l e i ɲ c a
bý	p iː
dylgjur	t ɪ l c ʏ r
uppskurður	ʏ h p s k ʏ r ð ʏ r
kinka	cʰ i ŋ̊ k a
fyrstur	f ɪ r̥ s t ʏ r
op	ɔ p
margfaldur	m a r k f a l t ʏ r
flugslóði	f l ʏ x s t l o uː ð ɪ
afturelding	a f t ʏ r ɛ l t i ŋ k
tölvupóstur	tʰ œ l v ʏ pʰ o u s t ʏ r
netfang	n ɛː t f a u ŋ k
fornnorræna	f ɔ r t n n ɔ r r a iː n a
blífa	p l iː v a
sellerí	s ɛ lː ɛː r iː
hlaupa	l̥ ø yː p a
trommuleikari	tʰ r ɔ mː ʏ l e iː k aː r ɪ
barki	p a r̥ c ɪ
frægur	f r a iː ɣ ʏ r
rólega	r o uː l ɛː ɣ a
gúlrotta	k u l r ɔ h t a
maður	m aː ð ʏ r
viðar	v ɪː ð aː r
demantur	t ɛː m a n̥ t ʏ r
saumur	s ø yː m ʏ r
náttmál	n a u h t m a uː l
dalla	t a t l a
greifi	k r e iː v ɪ
kýpur	cʰ iː p ʏ r
afríkanskur	aː f r iː kʰ a n s k ʏ r
reisn	r e i s t n
loforð	l ɔː v ɔ r ð
forneskja	f ɔ r t n ɛ s c a
trésmiðja	tʰ r j ɛː s m ɪ ð j a
opnun	ɔ h p n ʏ n
trésmiður	tʰ r j ɛː s m ɪː ð ʏ r
einelti	e iː n ɛ l̥ t ɪ
hnefaleikari	n̥ ɛː v a l e iː k a r ɪ
ell	ɛ t l
lindi	l ɪ n t ɪ
skynsemi	s c ɪ n s ɛː m ɪ
hrun	r̥ ʏː n
kúfur	kʰ uː v ʏ r
hár	h a uː r
músareyra	m uː s a r e iː r a
rafmagn	r a v m a k n
skyr	s c ɪː r
fallvatn	f a t l v a h t n
hörn	h œ r t n
jaxl	j a x s t l
raki	r aː c ɪ
björt	p j œ r̥ t
tón	tʰ o uː n
eyra	e i r a
plástur	pʰ l a u s t ʏ r
leiða	l e iː ð a
stutt	s t ʏ h t
viðtengingarháttur	v ɪ tʰ e i ɲ c i ŋ k a r h a u h t ʏ r
villa	v ɪ t l a
réttur	r j ɛ h t ʏ r
elding	ɛ l t i ŋ k
virkja	v ɪ r̥ c a
senda	s ɛ n t a
útsýni	uː t s iː n ɪ
brúður	p r uː ð ʏ r
þuríður	θ ʏː r iː ð ʏ r
georgína	c ɛː ɔ r c iː n a
greipa	k r e iː p a
þrennd	θ r ɛ n t
ringulreið	r i ŋ k ʏ l r e iː ð
dauðadómur	t ø yː ð a t o uː m ʏ r
þeba	θ ɛː p a
kuðungur	kʰ ʏː ð u ŋ k ʏ r
hakakross	h aː k a kʰ r ɔ sː
opinberun	ɔː p ɪ n p ɛː r ʏ n
dauði	t ø yː ð ɪ
bjúgaldin	p j uː a l t ɪ n
seyta	s e iː t a
valhöll	v aː l h œ t l̥
seðja	s ɛ ð j a
afbrigðilegur	a v p r ɪ ɣ ð ɪ l ɛː ɣ ʏ r
krá	kʰ r a uː
regnbogi	r ɛ k n p ɔː j ɪ
pollur	pʰ ɔ t l ʏ r
eggfruma	ɛ kː f r ʏː m a
teygjulak	tʰ e iː j ʏ l aː k
mjöll	m j œ t l
jurt	j ʏ r̥ t
ekkill	ɛ h c ɪ t l
smekklegur	s m ɛ h k l ɛː ɣ ʏ r
fjórðapartsnóta	f j o u r ð a pʰ a r̥ t s n o uː t a
vanda	v a n t a
kyrrþeyr	cʰ ɪ r θ e iː r
íhaldssamur	iː h a l t s s aː m ʏ r
frjóhnappur	f r j o uː n̥ a h p ʏ r
snúðugur	s t n uː ð ʏː ʏ r
hindrun	h ɪ n t r ʏ n
kornblóm	kʰ ɔ r t n p l o uː m
gil	c ɪː l
þjóðerni	θ j o uː ð ɛ r t n ɪ
syndga	s ɪ n t k a
handsnyrting	h a n t s t n ɪ r̥ t i ŋ k
horfur	h ɔ r v ʏ r
trúa	tʰ r uː a
nýsnævi	n iː s n a iː v ɪ
trekkja	tʰ r ɛ h c a
jensen	j ɛ n s ɛ nː
vita	v ɪː t a
fellafífill	f ɛ t l a f iː v ɪ t l
óvandaður	o uː v a n t aː ð ʏ r
rabba	r a pː a
rauðgreni	r ø y ð k r ɛː n ɪ
herdís	h ɛ r t iː s
brjóst	p r j o u s t
tigl	tʰ ɪ k l
raf	r aː v
án	a u n ð ɛ s
verðmæti	v ɛ r ð m a iː t ɪ
dólgslegur	t o u l k s l ɛː ɣ ʏ r
kökkur	kʰ œ h k ʏ r
brimill	p r ɪː m ɪ t l
júpíter	j uː p iː tʰ ɛː r
njósnari	n j o u s t n aː r ɪ
erta	ɛ r̥ t a
hitamælir	h ɪː t a m a iː l ɪ r
þáttur	θ a u h t ʏ r
mjölnir	m j œ l n ɪ r
sinna	s ɪ nː a
flónskur	f l o u n s k ʏ r
kapítuli	kʰ aː p i tʰ ʏː l ɪ
sáttur	s a u h t ʏ r
kafna	kʰ a p n a
sturlína	s t ʏ r t l iː n a
höfuðverkur	h œː v ʏ ð v ɛ r̥ k ʏ r
möppudýr	m œ h p ʏ t iː r
erlendína	ɛ r l ɛ n t iː n a
dílaskóf	t iː l a s k o uː v
páldís	p a u l t iː s
buxnavasi	p ʏ x s n a v aː s ɪ
kanadagæs	kʰ aː n a t a c a iː s
kátur	kʰ a uː t ʏ r
hornhraði	h ɔ r t n r̥ aː ð ɪ
meirihluti	m e iː r ɪ l̥ ʏː t ɪ
fórinta	f o uː r ɪ n̥ t a
hola	h ɔː l a
hof	h ɔː v
mars	m a r̥ s
heili	h e iː l ɪ
maurasýra	m ø yː r a s iː r a
pund	pʰ ʏ n t
frumeind	f r ʏː m e i n t
lútur	l uː t ʏ r
fjöldamorð	f j œ l t a m ɔ r ð
brunnur	p r ʏ nː ʏ r
eingetinn	e i n c ɛː t ɪ n
kækur	cʰ a iː k ʏ r
dvergtungljurt	t v ɛ r k tʰ u ŋ l j ʏ r̥ t
kvöl	kʰ v œː l
daggarmark	t a kː a r m a r̥ k
lygna	l ɪ k n a
blakkneskur	p l a h k n ɛ s k ʏ r
hind	h ɪ n t
melóna	m ɛː l o uː n a
hommi	h ɔ mː ɪ
núningur	n uː n i ŋ k ʏ r
málfrelsi	m a u l f r ɛ l s ɪ
galsi	k a l s ɪ
auður	ø yː ð ʏ r
helsingi	h ɛ l s i ɲ c ɪ
asi	aː s ɪ
hirð	h ɪ r ð
ræpa	r a iː p a
gráhvalur	k r a uː kʰ v aː l ʏ r
landakort	l a n t a kʰ ɔ r̥ t
tréblásturshljóðfæri	tʰ r j ɛː p l a u s t ʏ r̥ s l̥ j o u ð f a iː r ɪ
biblía	p ɪ p l iː j a
undirfylking	ʏ n t ɪ r̥ f ɪ l̥ c i ŋ k
karlfugl	kʰ a r t l f ʏ k l
fantur	f a n̥ t ʏ r
varnaður	v a r t n aː ð ʏ r
afvopna	a v v ɔ h p n a
kvartil	kʰ v a r̥ t ɪ l
níelsína	n iː j ɛ l s iː n a
mýmargur	m iː m a r k ʏ r
holtsetaland	h ɔ l̥ t s ɛː t a l a n t
flón	f l o uː n
skurðgrafa	s k ʏ r ð k r aː v a
lungnaslagæð	l u ŋ k n a s t l aː ɣ a iː ð
pappír	pʰ a h p iː r
óhlýðinn	o uː l̥ iː ð ɪ nː
spói	s p o uː ɪ
kyrking	cʰ ɪ r̥ c i ŋ k
fagottleikari	f aː k ɔ h t l e iː k aː r ɪ
lúkk	l u h k
einkalykill	e i ŋ k a l ɪː c ɪ t l
tékkneskur	tʰ j ɛ h k n ɛ s k ʏ r
tittur	tʰ ɪ h t ʏ r
kynni	cʰ ɪ nː ɪ
rakna	r a h k n a
framferði	f r a m f ɛ r ð ɪ
rogaland	r ɔː ɣ a l a n t
aðskilnaðarstefna	a ð s c ɪ l n aː ð a r s t ɛ p n a
snepill	s t n ɛː p ɪ t l
skella	s c ɛ t l a
mestur	m ɛ s t ʏ r
snæland	s n a iː l a n t
kítti	cʰ i h t ɪ
strjúka	s t r j uː k a
dafna	t a p n a
syrta	s ɪ r̥ t a
tárakirtill	tʰ a uː r a kʰ ɪ r̥ t ɪ t l
flámæli	f l a uː m a iː l ɪ
lakkrís	l a h k r iː s
rekkja	r ɛ h c a
fet	f ɛː t
slóra	s t l o uː r a
piss	pʰ ɪ sː
matreiðsla	m aː t r e i ð s t l a
vasapeningar	v aː s a pʰ ɛː n i ŋ k a r
sjaldgæfur	s j a l t c a iː v ʏ r
dragt	t r a x t
gráblika	k r a u p l ɪː k a
bauð	p ø iː ð
togi	tʰ ɔː j ɪ
bálkur	p a u l̥ k ʏ r
víkingur	v iː c i ŋ k ʏ r
dauðadá	t ø yː ð a t a uː
kvak	kʰ v aː k
hryðjuverkamaður	r̥ ɪ ð j ʏ v ɛ r̥ k a m aː ð ʏ r
sólbað	s o u l p aː ð
lykt	l ɪ x t
furðulegur	f ʏ r ð ʏ l ɛː ɣ ʏ r
dóri	t o uː r ɪ
malí	m aː l iː
hækkun	h a i h k ʏ n
þrístrendingur	θ r iː s t r ɛ n t i ŋ k ʏ r
blaðsíða	p l a ð s iː ð a
smergill	s m ɛ r c ɪ t l
gat	k aː t
greiðslukort	k r e i ð s t l ʏ kʰ ɔ r̥ t
strik	s t r ɪː k
svindla	s v ɪ n t l a
hjaltína	ç a l̥ t iː n a
sáð	s a uː ð
gotneskur	k ɔ h t n ɛ s k ʏ r
ferskur	f ɛ r̥ s k ʏ r
krókur	kʰ r o uː k ʏ r
slarksamur	s t l a r̥ k s aː m ʏ r
frostpinni	f r ɔ s t pʰ ɪ nː ɪ
vit	v ɪː t
fræðigrein	f r a iː ð ɪ k r e iː n
aftur	a f t ʏ r
raddblær	r a tː p l a iː r
litaröð	l ɪː t a r œː ð
efnafræði	ɛ p n a f r a iː ð ɪ
flórgoði	f l o u r k ɔː ð ɪ
varpasveifgras	v a r̥ p a s v e i v k r aː s
og	ɔː ɣ
ávísun	a uː v iː s ʏ n
bréfaklemma	p r j ɛː v a kʰ l ɛ mː a
skógarsóley	s k o uː a r s o uː l e iː
túpa	tʰ uː p a
djass	t j a sː
daufur	t ø yː v ʏ r
pardusdýr	pʰ a r t ʏ s t iː r
systkin	s ɪ s t k ɪː n
eind	e i n t
atburður	aː t p ʏ r ð ʏ r
snark	s t n a r̥ k
vitrun	v ɪː t r ʏ n
sýkna	s i h k n a
leggja	l ɛ cː a
mari	m aː r ɪ
mikael	m ɪː kʰ aː ɛː l
sikiley	s ɪː c ɪ l e iː
þrenning	θ r ɛ nː i ŋ k
skartgripur	s k a r̥ t k r ɪː p ʏ r
rindill	r ɪ n t ɪ t l
þýður	θ iː ð ʏ r
skána	s k a uː n a
ævi	a iː v ɪ
blávingull	p l a uː v i ŋ k ʏ t l
snekkja	s n ɛ h c a
umbrot	ʏ m p r ɔː t
leir	l e iː r
fjöruarfi	f j œː r ʏ a r v ɪ
innihalda	ɪ nː ɪ h a l t a
ferhyrndur	f ɛː r h ɪ r n t ʏ r
hegning	h ɛ k n i ŋ k
sagnorð	s a k n ɔ r ð
teinóttur	tʰ e iː n o u h t ʏ r
krossfeldi	kʰ r ɔ sː f ɛ l t ɪ
teygjubyssa	tʰ e iː j ʏ p ɪ sː a
kæta	cʰ a iː t a
einvetni	e i n v ɛ h t n ɪ
köggull	kʰ œ kː ʏ t l
líkur	l iː k ʏ r
peðra	pʰ ɛ ð r a
sjoppa	s j ɔ h p a
sefur	s ɛː v ʏ r
klór	kʰ l o uː r
pissa	pʰ ɪ sː a
púma	pʰ uː m a
þraut	θ r ø yː t
orrusta	oː r ʏ s t a
barnabarn	p a r t n a p a r t n
marteinn	m a r̥ t e i t n
borgarstjóri	p ɔ r k a r s t j o uː r ɪ
nautn	n ø y h t n
stykkja	s t ɪ h c a
bábilja	p a uː p ɪ l j a
gleðispillir	k l ɛː ð ɪ s p ɪ t l ɪ r
vonbrigði	v ɔ n p r ɪ ɣ ð ɪ
ginning	c ɪ nː i ŋ k
marsbúi	m a r̥ s p uː ɪ
bifreið	p ɪ v r e iː ð
arnheiður	a r t n h e iː ð ʏ r
brauðmylsna	p r ø y ð m ɪ l s t n a
jór	j o uː r
karate	kʰ aː r a t ɛː
kisa	cʰ ɪː s a
fræðsla	f r a i ð s t l a
níundi	n iː j ʏ n t ɪ
hrossafluga	r̥ ɔ sː a f l ʏː ɣ a
minna	m ɪ nː a
forjaxl	f ɔː r j a k s t l
roðasteinn	r ɔː ð a s t e i t n
rógur	r o uː ʏ r
deiling	t e iː l i ŋ k
hvítur	kʰ v iː t ʏ r
afklæða	a v kʰ l a iː ð a
íslenska	iː s l ɛ n s k a
ydda	ɪ tː a
tinna	tʰ ɪ nː a
boðskapur	p ɔ ð s k aː p ʏ r
akurstjarna	aː k ʏ r s t j a r t n a
silfraður	s ɪ l v r aː ð ʏ r
sigfús	s ɪ x f uː s
flugdreki	f l ʏ ɣ t r ɛː c ɪ
dáti	t a uː t ɪ
heimta	h e i m̥ t a
mær	m a iː r
frelsisbarátta	f r ɛ l s ɪ s b aː r a u h t a
ljómi	l j o uː m ɪ
vigdís	v ɪ ɣ t iː s
miðmynd	m ɪ ð m ɪ n t
kúrdíska	kʰ u r t i s k a
heimferð	h e i m f ɛ r ð
gandur	k a n t ʏ r
þvættingur	θ v a i h t i ŋ k ʏ r
bjartsýnn	p j a r̥ t s i t n
brúnn	p r u t n
hlekkur	l̥ ɛ h k ʏ r
efla	ɛ p l a
venja	v ɛ n j a
hindra	h ɪ n t r a
moli	m ɔː l ɪ
fjölær	f j œː l a iː r
áslaug	a uː s l ø yː ɣ
faraldur	f aː r a l t ʏ r
vinur	v ɪː n ʏ r
þrílaufungur	θ r iː l ø yː v ʏ ŋ k ʏ r
statistík	s t aː t ɪ s t iː k
stýra	s t iː r a
hálsbindi	h a u l s p ɪ n t ɪ
hótfyndni	h o uː t f ɪ n t n ɪ
tónlistarskóli	tʰ o u n l ɪ s t a r s k o uː l ɪ
rekill	r ɛː c ɪ t l
líking	l iː c i ŋ k
ella	ɛ t l a
opnunartími	ɔ h p n ʏː n aː r tʰ iː m ɪ
fákur	f a uː k ʏ r
míkrófónn	m iː k r o uː f o u t n
spenna	s p ɛ nː a
eiginhandaráritun	e iː j ɪ n h a n t a r a uː r ɪː t ʏ n
frystir	f r ɪ s t ɪ r
sjö	s j ø
spauga	s p ø yː ɣ a
flaggdúkur	f l a kː t uː k ʏ r
forjaxl	f ɔː r j a x s t l
sundgleraugu	s ʏ n t k l ɛː r ø yː ɣ ʏ
skápur	s k a uː p ʏ r
skjaldberi	s c a l t b ɛː r ɪ
skjall	s c a t l
nöf	n œː v
lygn	l ɪ k n
sepi	s ɛː p ɪ
norðurljós	n ɔ r ð ʏ r l j o uː s
ljósmyndavél	l j o uː s m ɪ n t a v j ɛː l
fordrykkur	f ɔ r t r ɪ h k ʏ r
skari	s k aː r ɪ
flóð	f l o uː ð
einmanaleiki	e i n m aː n a l e iː c ɪ
lasinn	l aː s ɪ nː
mýbit	m iː p ɪː t
klisja	kʰ l ɪː s j a
tyrkland	t ɪ r̥ k l a n t
þrunginn	θ r u ɲ c ɪ nː
pera	pʰ ɛː r a
ósannindi	o uː s a nː ɪ n t ɪ
glæpamaður	k l a iː p a m aː ð ʏ r
frat	f r aː t
orkudrykkur	ɔ r̥ k ʏ t r ɪ h k ʏ r
maría	m aː r iː j a
forsætisráðherra	f ɔ r̥ s a iː t ɪ s r a uː ð h ɛ rː a
hóra	h o uː r a
fjallgarður	f j a t l k a r ð ʏ r
gagnagrunnur	k a k n a k r ʏ nː ʏ r
skraddari	s k r a tː a r ɪ
svanur	s v aː n ʏ r
starf	s t a r v
sitjandi	s ɪː t j a n t ɪ
össur	œ sː ʏ r
skítt	s c i h t
eiginnafn	e iː j ɪ n n a p n
haarde	h ɔ r t ɛː
læmingi	l a iː m i ɲ c ɪ
móðurmál	m o uː ð ʏ r m a uː l
afgreiða	a v k r e iː ð a
ráða	r a uː ð a
flík	f l iː k
nám	n a uː m
tannhvalur	tʰ a nː xʷ aː l ʏ r
þvarga	θ v a r k a
íhvolfur	iː kʰ v ɔ l v ʏ r
hallmundur	h a t l m ʏ n t ʏ r
mannasiður	m a nː a s ɪː ð ʏ r
páfugl	pʰ a uː f ʏ k l
jörð	j œ r ð
rúsína	r uː s iː n a
meiða	m e iː ð a
fleki	f l ɛː c ɪ
morð	m ɔ r ð
rjúpa	r j uː p a
leyna	l e iː n a
orðabók	ɔ r ð a p o uː k
tönn	tʰ œ nː
ómur	o uː m ʏ r
orðsifjafræði	ɔ r ð s ɪ v j a f r a iː ð ɪ
mynt	m ɪ n̥ t
mardís	m a r t iː s
kveina	kʰ v e iː n a
greiða	k r e iː ð a
dýpi	t iː p ɪ
bakka	p a h k a
björgmundur	p j œ r k m ʏ n t ʏ r
jöfnun	j œ p n ʏ n
duttlungur	t ʏ h t l u ŋ k ʏ r
benín	p ɛː n iː n
múrbrjótur	m u r p r j o uː t ʏ r
afsökun	a f s œː k ʏ n
herstígvél	h ɛ r̥ s t i ɣ v j ɛː l
regnvatn	r ɛ k n v a h t n
beitilyng	p e iː t ɪ l i ŋ k
innstunga	ɪ n s t u ŋ k a
dynja	t ɪ n j a
gifs	c ɪ f s
friðill	f r ɪː ð ɪ t l
vasaklútur	v aː s a kʰ l uː t ʏ r
veski	v ɛ s c ɪ
heyrn	h e i r t n
romm	r ɔ mː
júði	j uː ð ɪ
samúelína	s aː m uː ɛː l iː n a
sæunn	s a iː j ʏ nː
tollskýrsla	tʰ ɔ t l̥ s c i r̥ s t l a
hnykkja	n̥ ɪ h c a
tagga	tʰ a kː a
finnungur	f ɪ nː u ŋ k ʏ r
mý	m iː
teðja	tʰ ɛ ð j a
mænudeyfing	m a iː n ʏ t e iː v i ŋ k
brak	p r aː k
kjörskrá	cʰ œ r s k r a uː
ný	n iː
fjallakobbi	f j a t l a kʰ ɔ pː ɪ
kalla	kʰ a t l a
verð	v ɛ r ð
annar	a nː a r
þota	θ ɔː t a
nafnháttur	n a p n h a u h t ʏ r
afi	aː v ɪ
manntal	m a nː tʰ aː l
heyra	h e iː r a
mýrasef	m iː r a s ɛː v
mont	m ɔ n̥ t
söngvari	s ø y ŋ k v aː r ɪ
gestur	c ɛ s t ʏ r
þráðsef	θ r a u ð s ɛː v
pára	pʰ a uː r a
bragðskyn	p r a ɣ ð s c ɪː n
svæfa	s v a iː v a
dynkur	t i ŋ̊ k ʏ r
kínaskák	cʰ iː n a s k a uː k
kjörgengur	cʰ œ r c e i ŋ k ʏ r
hjálpa	ç a u l̥ p a
tuldur	tʰ ʏ l t ʏ r
smalamaður	s m aː l a m aː ð ʏ r
aðild	aː ð ɪ l t
hamingja	h aː m i ɲ c a
múskat	m u s k aː t
kippur	cʰ ɪ h p ʏ r
líkskurður	l iː k s k ʏ r ð ʏ r
bylta	p ɪ l̥ t a
birta	p ɪ r̥ t a
flesk	f l ɛ s k
hervör	h ɛ r v œː r
rægja	r a iː j a
banna	p a nː a
hann	h a nː
minnkun	m i ŋ̊ k ʏ n
griffill	k r ɪ fː ɪ t l
velgengni	v ɛ l c e i ŋ k n ɪ
stig	s t ɪː ɣ
tuldra	tʰ ʏ l t r a
mengun	m e i ŋ k ʏ n
prósenta	pʰ r o uː s ɛ n̥ t a
bráðna	p r a u ð n a
hængur	h a i ŋ k ʏ r
kinnalitur	cʰ ɪ nː a l ɪː t ʏ r
gerði	c ɛ r ð ɪ
brjóstvasi	p r j o u s t v aː s ɪ
kynstur	cʰ ɪ n s t ʏ r
gröf	k r œː v
deila	t e iː l a
blöndal	p l œ n t aː l
kláði	kʰ l a uː ð ɪ
litháen	l ɪː t h a uː ɛː n
ljúfra	l j u v r a
matreiðslubók	m aː t r e i ð s t l ʏ p o uː k
stef	s t ɛː v
geirmundur	c e i r m ʏ n t ʏ r
mengjafræði	m e i ɲ c a f r a iː ð ɪ
fróður	f r o uː ð ʏ r
fjölmiðlasaga	f j œ l m ɪ ð l a s aː ɣ a
grímkell	k r i m cʰ ɛ t l
fjórði	f j o u r ð ɪ
hvel	kʰ v ɛː l
dá	t a uː
fús	f uː s
ægir	a iː j ɪ r
styrkja	s t ɪ r̥ c a
lykja	l ɪː c a
brestur	p r ɛ s t ʏ r
eyrnapinni	e i r t n a pʰ ɪ nː ɪ
sperðileitrun	s p ɛ r ð ɪ l e iː t r ʏ n
aðdáandi	a ð t a uː a n t ɪ
frímerkjasafnari	f r iː m ɛ r̥ c a s a p n aː r ɪ
bali	p aː l ɪ
grund	k r ʏ n t
kokhlust	kʰ ɔː k l̥ ʏ s t
út	uː t
fjarstýra	f j a r̥ s t iː r a
borðtennis	p ɔ r ð tʰ ɛ nː ɪ s
norn	n ɔ r t n
ferill	f ɛː r ɪ t l
aspas	a s p a s
ganamaður	k aː n a m aː ð ʏ r
óafturkræfur	o uː a f t ʏ r kʰ r a iː v ʏ r
lenda	l ɛ n t a
móðurbróðir	m o uː ð ʏ r p r o uː ð ɪ r
lúterskur	l uː tʰ ɛ r̥ s k ʏ r
tölusetja	tʰ œː l ʏ s ɛː t j a
dæld	t a i l t
hnappaborð	n̥ a h p a p ɔ r ð
hönnun	h œ nː ʏ n
kjalta	cʰ a l̥ t a
bandstrik	p a n t s t r ɪː k
ráðherra	r a uː ð h ɛ rː a
helluhnoðri	h ɛ t l ʏ n̥ ɔ ð r ɪ
hjól	ç o uː l
kerra	cʰ ɛ rː a
adamsepli	aː d a m s ɛ h p l ɪ
áfall	a uː f a t l
léreft	l j ɛː r ɛ f t
regnskógur	r ɛ k n s k o uː ʏ r
sorg	s ɔ r k
baskamál	p a s k a m a uː l
kröggur	kʰ r œ kː ʏ r
sorta	s ɔ r̥ t a
hýr	ç iː r
gjalda	c a l t a
rák	r a uː k
indriði	ɪ n t r ɪː ð ɪ
íverufall	iː v ɛː r ʏ f a t l
hót	h o uː t
kóróna	kʰ o uː r o uː n a
kaffi	kʰ a fː ɪ
stjörnuspá	s t j œ r t n ʏ s p a uː
ey	e iː
korsíka	kʰ ɔ r̥ s iː k a
torfa	tʰ ɔ r v a
myrða	m ɪ r ð a
nálarauga	n a uː l a r ø yː ɣ a
fregn	f r ɛ k n
lettland	l ɛ h t l a n t
kynngi	cʰ i ɲ c ɪ
slúður	s t l uː ð ʏ r
íkorni	iː kʰ ɔ r t n ɪ
fley	f l e iː
framleiða	f r a m l e iː ð a
tröll	tʰ r œ t l
kommúna	kʰ ɔ mː uː n a
tríóla	tʰ r iː j o uː l a
gullmura	k ʏ t l m ʏː r a
hrafnkell	r̥ a p n cʰ ɛ t l
legbólga	l ɛ ɣ p o u l k a
steðji	s t ɛ ð j ɪ
smyrill	s m ɪː r ɪ t l
fís	f iː s
buga	p ʏː ɣ a
hálfnóta	h a u l v n o uː t a
hálfsystir	h a u l v s ɪ s t ɪ r
sigþrúður	s ɪ x θ r uː ð ʏ r
mongólska	m ɔ ŋ k o u l s k a
kvað	kʰ v aː ð
hrókera	r̥ o uː k ɛː r a
drýgja	t r iː j a
dilkur	t ɪ l̥ k ʏ r
nýtt	n i h t
lettneskur	l ɛ h t n ɛ s k ʏ r
nielsen	n i l s ɛ nː
upplýsing	ʏ h p l iː s i ŋ k
okkur	ɔ h k ʏ r
mosagróinn	m ɔː s a k r o uː ɪ nː
verkaskipting	v ɛ r̥ k a s c ɪ f t i ŋ k
bak	p aː k
milli	m ɪ t l ɪ
afmælisgjöf	a v m a iː l ɪ s c œː v
forstjóri	f ɔ r̥ s t j o uː r ɪ
hækill	h a i cː ɪ t l
klettafrú	kʰ l ɛ h t a f r uː
mysa	m ɪː s a
töng	tʰ ø y ŋ k
bardagi	p a r t aː j ɪ
gletta	k l ɛ h t a
stari	s t aː r ɪ
teygja	tʰ e iː j a
jóhann	j o uː h a nː
durgslegur	t ʏ r k s l ɛː ɣ ʏ r
hnífur	n̥ iː v ʏ r
sjón	s j o uː n
hróarskelda	r̥ o uː a r̥ s cʰ ɛ l t a
sund	s ʏ n t
hús	h uː s
hvatning	xʷ a h t n i ŋ k
töfra	tʰ œ v r a
sifjaspell	s ɪ v j a s p ɛ t l
lottó	l ɔ h t o uː
heilla	h e i t l a
botnlangaskurður	p ɔ h t n l a u ŋ k a s k ʏ r ð ʏ r
hróp	r̥ o uː p
dofi	t ɔː v ɪ
brautryðjandi	p r ø yː t r ɪ ð j a n t ɪ
þvottur	θ v ɔ h t ʏ r
skaplyndi	s k aː p l ɪ n t ɪ
samkvæmt	s a m k ʱ v a i m̥ t
stóriburkni	s t o uː r ɪ p ʏ r̥ k n ɪ
gígja	c iː j a
aðgerðaáætlun	a ð c ɛ r ð aː u a i t l ʏ n
hagnaður	h a k n a ð ʏ r
lýsingarháttur	l iː s i ŋ k a r h a u h t ʏ r
herðar	h ɛ r ð a r
héla	ç ɛː l a
kex	cʰ ɛ x s
kappi	kʰ a h p ɪ
hver	kʰ v ɛː r
markaður	m a r̥ k a ð ʏ r
par	pʰ aː r
ofbeldi	ɔ v p ɛ l t ɪ
lund	l ʏ n t
málsgrein	m a u l s k r e iː n
aur	ø yː r
deita	t e iː t a
fjölveri	f j œ l v ɛː r ɪ
heimboð	h e i m p ɔː ð
beiða	p e iː ð a
lind	l ɪ n t
tjald	tʰ j a l t
yfirráð	ɪː v ɪ r r a uː ð
byggð	p ɪ ɣ ð
banki	p a u ɲ̊ c ɪ
snurða	s t n ʏ r ð a
prag	pʰ r aː ɣ
kistill	cʰ ɪ s t ɪ t l
náttúra	n a u h t uː r a
heild	h e i l t
fíkinn	f iː c ɪ nː
títt	tʰ i h t
valdimaría	v a l t ɪ m aː r iː j a
fjall	f j a t l
kyrkingur	cʰ ɪ r̥ c i ŋ k ʏ r
ax	a x s
stóðgarður	s t o u ð k a r ð ʏ r
skeina	s c e iː n a
hnetusmjör	n̥ ɛː t ʏ s m j œː r
páll	pʰ a u t l
persneska	pʰ ɛ r̥ s n ɛ s k a
oj	ɔ iː
farði	f a r ð ɪ
mikill	m ɪː c ɪ t l
vax	v a k s
latur	l aː t ʏ r
soffía	s ɔ fː iː j a
saurblað	s ø y r p l aː ð
óhapp	o uː h a h p
rússneska	r u sː n ɛ s k a
föðurlandsvinur	f œː ð ʏ r l a n s v ɪː n ʏ r
óreglulegur	o uː r ɛ k l ʏ l ɛː ɣ ʏ r
stýrikerfi	s t iː r ɪ cʰ ɛ r v ɪ
leg	l ɛː ɣ
dæma	t a iː m a
hnoðri	n̥ ɔ ð r ɪ
söl	s œː l
hroki	r̥ ɔː c ɪ
kyrkja	cʰ ɪ r̥ c a
kasta	kʰ a s t a
slóvakía	s t l o uː v a cʰ iː j a
hallur	h a t l ʏ r
fagurblár	f aː ɣ ʏ r p l a uː r
lífdagar	l i v t aː ɣ a r
einbirni	e i n p ɪ r t n ɪ
eistalyppa	e i s t a l ɪ h p a
jarðfræði	j a r ð f r a iː ð ɪ
loðvíðir	l ɔ ð v iː ð ɪ r
panta	pʰ a n̥ t a
andvari	a n t v aː r ɪ
hrekja	r̥ ɛː c a
þess	θ ɛ sː
segulljós	s ɛː ɣ ʏ l l j o uː s
stappa	s t a h p a
frú	f r uː
dugnaður	t ʏ ɣ n aː ð ʏ r
handrit	h a n t r ɪː t
köllun	kʰ œ t l ʏ n
farmiði	f a r m ɪː ð ɪ
kelfing	cʰ ɛ l v i ŋ k
söngkona	s ø y ŋ k kʰ ɔː n a
bið	p ɪː ð
benda	p ɛ n t a
karbónat	kʰ a r p o uː n aː t
nærvera	n a i r v ɛː r a
smásjá	s m a uː s j a uː
tónleikar	tʰ o u n l e iː k a r
montinn	m ɔ n̥ t ɪ nː
snerra	s n ɛ rː a
iðn	ɪ ð n
steindór	s t e i n t o uː r
gashylki	k aː s h ɪ l̥ c ɪ
orsaka	ɔ r̥ s aː k a
auðveldlega	ø y ð v ɛ l t l ɛː ɣ a
sínus	s iː n ʏ s
klettur	kʰ l ɛ h t ʏ r
álma	a u l m a
þola	θ ɔː l a
alls	a l s
þor	θ ɔː r
nokkur	n ɔ h k ʏ r
undanfari	ʏ n t a n f aː r ɪ
forseti	f ɔ r̥ s ɛː t ɪ
kæpa	cʰ a iː p a
áhersla	a uː h ɛ r̥ s t l a
krossmaðra	kʰ r ɔ sː m a ð r a
nátthrafn	n a u h t r̥ a p n
vök	v œː k
vöðvi	v œ ð v ɪ
gráhegri	k r a uː h ɛ ɣ r ɪ
langreyður	l a u ŋ k r e iː ð ʏ r
hirðuleysi	h ɪ r ð ʏ l e iː s ɪ
as	aː s
egna	ɛ k n a
næði	n a iː ð ɪ
járna	j a u t n a
aðsókn	a ð s o u h k n
glæta	k l a iː t a
settaug	s ɛː t tʰ ø yː ɣ
efnaskipti	ɛ p n a s c ɪ f t ɪ
ásjálegur	a uː s j a uː l ɛː ɣ ʏ r
bjórvömb	p j o u r v œ m p
kvíða	kʰ v iː ð a
ábendingarfornafn	a uː p ɛ n t i ŋ k a r f ɔ r n a p n
baga	p aː ɣ a
broddfura	p r ɔ tː f ʏː r a
níð	n iː ð
tvímynd	tʰ v iː m ɪ n t
ofursti	ɔː f ʏ r̥ s t ɪ
írland	i r l a n t
amma	a mː a
hnúfubakur	n̥ uː v ʏ p aː k ʏ r
hrúður	r̥ uː ð ʏ r
mysuostur	m ɪː s ʏ ɔ s t ʏ r
sullur	s ʏ t l ʏ r
tafl	tʰ a p l
vakna	v a h k n a
bolla	p ɔ t l a
forsetning	f ɔ r̥ s ɛ h t n i ŋ k
hrjósa	r̥ j o uː s a
grín	k r iː n
njálgur	n j a u l k ʏ r
eftirminnilegur	ɛ f t ɪ r m ɪ nː ɪ l ɛː ɣ ʏ r
kragi	kʰ r a iː j ɪ
vænir	v a iː n ɪ r
renta	r ɛ n̥ t a
flenna	f l ɛ nː a
saltkjöt	s a l̥ t cʰ œː t
kirjálaland	cʰ ɪ r j a uː l a l a n t
kommi	kʰ ɔ mː ɪ
júlí	j uː l iː
grunnskóli	k r ʏ nː s k o uː l ɪ
ákafur	a uː k aː v ʏ r
nytsamur	n ɪː t s aː m ʏ r
þjöl	θ j œː l
brúskur	p r u s k ʏ r
megna	m ɛ k n a
fróðný	f r o u ð n iː
rót	r o uː t
frymi	f r ɪː m ɪ
butur	p ʏː t ʏ r
skömm	s k œ mː
flagasef	f l aː ɣ a s ɛː v
runnur	r ʏ nː ʏ r
nafar	n aː v a r
kyssa	cʰ ɪ sː a
hrái	r̥ a uː ɪ
grár	k r a uː r
gepill	c ɛː p ɪ t l
sin	s ɪː n
þyrstur	θ ɪ r̥ s t ʏ r
heimsálfa	h e i m s a u l v a
fimbulvetur	f ɪ m p ʏ l v ɛː t ʏ r
fés	f j ɛː s
roða	r ɔː ð a
hundrað	h ʏ n t r aː ð
afturbatapíka	a f tʰ ʏ r p aː tʰ a pʰ iː kʰ a
nauðsyn	n ø y ð s ɪː n
kína	cʰ iː n a
lotugræðgi	l ɔː t ʏ k r a i ð c ɪ
skipaskurður	s c ɪː p a s k ʏ r ð ʏ r
sigg	s ɪ kː
hóruhús	h o uː r ʏ h uː s
sál	s a uː l
tá	tʰ a uː
fyl	f ɪː l
guðspjall	k v ʏ ð s p j a t l
göng	k ø y ŋ k
vigt	v ɪ x t
rauf	r ø yː v
eigra	e i ɣ r a
frumulíffæri	f r ʏː m ʏ l i f f a iː r ɪ
hákarl	h aː k a r t l
lundir	l ʏ n t ɪ r
svengja	s v e i ɲ c a
hræðilega	r̥ a iː ð ɪ l ɛː ɣ a
ægja	a iː j a
uml	ʏ m l
breidd	p r e i tː
færni	f a i r t n ɪ
botnfall	p ɔ h t n f a t l
þrymskviða	θ r ɪ m s kʰ v ɪː ð a
veikur	v e iː k ʏ r
burkni	p ʏ r̥ k n ɪ
gretta	k r ɛ h t a
framsöguháttur	f r a m s œː ɣ ʏ h a u h t ʏ r
héri	ç ɛː r ɪ
ósíris	o uː s iː r ɪ s
kuldi	kʰ ʏ l t ɪ
urt	ʏ r̥ t
portúgalska	p ɔ r̥ t uː k a l s k a
brennisóley	p r ɛ nː ɪ s o uː l e iː
hjörtur	ç œ r̥ t ʏ r
hlutgrúpa	l̥ ʏː t k r uː p a
brauðrist	p r ø y ð r ɪ s t
meðlimur	m ɛ ð l ɪː m ʏ r
ákavíti	a uː k a v iː t ɪ
rugl	r ʏ k l
krydd	kʰ r ɪ tː
evklíð	ɛ v kʰ l iː ð
konungshöll	kʰ ɔː n u ŋ k s h œ t l
fastanefnd	f a s t a n ɛ m t
stjórnmál	s t j o u r t n m a uː l
ský	s c iː
bel	p ɛː l
augnlok	ø y k n l ɔː k
loppa	l ɔ h p a
metanól	m ɛː tʰ aː n o uː l
hjartastillir	ç a r̥ t a s t ɪ t l ɪ r
hraustur	r̥ ø y s t ʏ r
eyðsla	e i ð s t l a
láfi	l a uː v ɪ
ferðaáætlun	f ɛ r ð a a uː a i h t l ʏ n
klarínett	kʰ l aː r iː n ɛ h t
kelta	cʰ ɛ l̥ t a
túndra	tʰ u n t r a
hes	h ɛː s
smjatt	s m j a h t
knipla	kʰ n ɪ h p l a
torg	tʰ ɔ r k
nál	n a uː l
þristur	θ r ɪ s t ʏ r
röskur	r œ s k ʏ r
kynsjúkdómur	cʰ ɪ n s j uː k t o uː m ʏ r
armur	a r m ʏ r
signa	s ɪ k n a
meðstjórnendur	m ɛ ð s t j o u r t n ɛ n t ʏ r
lítri	l iː t r ɪ
græja	k r a iː j a
landi	l a n t ɪ
bragliður	p r a ɣ l ɪː ð ʏ r
aldrei	a l t r e iː
marr	m a rː
íkornabygg	iː kʰ ɔ r t n a p ɪ kː
ráðríkur	r a u ð r iː k ʏ r
lægja	l a iː j a
floti	f l ɔː t ɪ
keisaraviður	cʰ e iː s aː r a v ɪː ð ʏ r
jafnaðarstefna	j a p n aː ð a r s t ɛ p n a
strangur	s t r a u ŋ k ʏ r
tíkarsonur	tʰ iː k a r s ɔː n ʏ r
ástríður	a u s t r iː ð ʏ r
vefur	v ɛː v ʏ r
breiddargráða	p r e i tː a r k r a uː ð a
umla	ʏ m l a
mæði	m a iː ð ɪ
miltisbrandur	m ɪ l̥ t ɪ s p r a n t ʏ r
háttur	h a u h t ʏ r
vík	v iː k
vax	v a x s
óvinátta	o uː v ɪː n a u h t a
viðeigandi	v ɪː ð e iː ɣ a n t ɪ
maskari	m a s k aː r i
frost	f r ɔ s t
briem	p r iː m
húðsjúkdómafræðingur	h uː ð s j u k t o uː m a f r a iː ð i ŋ k ʏ r
skokka	s k ɔ h k a
kóða	kʰ o uː ð a
klórópren	kʰ l o uː r o uː pʰ r ɛː n
stjórnmálamaður	s t j o u r t n m a uː l a m aː ð ʏ r
þrúður	θ r uː ð ʏ r
hníga	n̥ iː ɣ a
hersegóvína	h ɛ r̥ s ɛː k o uː v iː n a
líma	l iː m a
gap	k aː p
völva	v œ l v a
brátt	p r a u h t
hóta	h o uː t a
grúpa	k r uː p a
húfa	h uː v a
magnea	m a k n ɛː a
ansi	a n s ɪ
lekur	l ɛː k ʏ r
heimaverkefni	h e iː m a v ɛ r̥ k ɛ p n ɪ
lóa	l o uː a
knús	kʰ n uː s
fjölbýlishús	f j œ l p iː l ɪ s h uː s
tréspíri	tʰ r j ɛː s p iː r ɪ
streyma	s t r e iː m a
herri	h ɛ rː ɪ
flæmska	f l a i m s k a
spæta	s p a iː t a
framvinda	f r a m v ɪ n t a
rándýr	r a u n t iː r
fylgdarmaður	f ɪ l t a r m aː ð ʏ r
kreppa	kʰ r ɛ h p a
vetur	v ɛː t ʏ r
klof	kʰ l ɔː v
snákur	s t n a uː k ʏ r
ögn	œ k n
segð	s ɛ ɣ ð
hjala	ç aː l a
svindl	s v ɪ n t l
kynleysi	cʰ ɪ n l e iː s ɪ
körfuknattleiksþjálfari	kʰ œ r v ʏ kʰ n a h t l e i k s θ j a u l v a r ɪ
kolkrabbi	kʰ ɔ l kʰ r a pː ɪ
unnur	ʏ nː ʏ r
kjarni	cʰ a r t n ɪ
sifjar	s ɪ v j a r
flæði	f l a iː ð ɪ
agn	a k n
kara	kʰ aː r a
megn	m ɛ k n
blóðmura	p l o u ð m ʏː r a
nót	n o uː t
kollhnís	kʰ ɔ t l n̥ iː s
vifta	v ɪ f t a
þorna	θ ɔ r t n a
hnútafræði	n̥ uː t a f r a iː ð ɪ
slasa	s t l aː s a
svali	s v aː l ɪ
peyi	pʰ e iː j ɪ
hálfleikur	h a u l v l e iː k ʏ r
illmælgi	ɪ t l m a i l c ɪ
lín	l iː n
hnísa	n̥ iː s a
hestaleiga	h ɛ s t a l e iː ɣ a
sýnishorn	s iː n ɪ s h ɔ t n
steinbrjótur	s t e i n p r j o uː t ʏ r
keisari	cʰ e iː s aː r ɪ
bónus	p o uː n ʏ s
kvikmyndahús	kʰ v ɪː k m ɪ n t a h uː s
leikmynd	l e iː k m ɪ n t
tjara	tʰ j aː r a
froskdýr	f r ɔ s k t iː r
skaft	s k a f t
pissuskál	pʰ ɪ sː ʏ s k a uː l
pexa	pʰ ɛ x s a
jarðskjálftafræði	j a r ð s c a u l̥ t a f r a iː ð ɪ
útlit	uː t l ɪː t
durtur	t ʏ r̥ t ʏ r
klunni	kʰ l ʏ nː ɪ
snóker	s t n o uː k ɛ r
stökkva	s t œ h k v a
mjólkurferna	m j o u l̥ k ʏ r f ɛ r t n a
naður	n aː ð ʏ r
afli	a p l ɪ
óbeinn	o uː p e i t n
uppsalir	ʏ h p s aː l ɪ r
nærmynd	n a i r m ɪ n t
lágur	l a uː r
sólhattur	s o u l h a h t ʏ r
kast	kʰ a s t
kærulaus	cʰ a iː r ʏ l ø yː s
barónett	p aː r o uː n ɛ h t
goðafræði	k ɔː ð a f r a iː ð ɪ
sverðfiskur	s v ɛ r ð f ɪ s k ʏ r
hetta	h ɛ h t a
elí	ɛː l iː
bóla	p o uː l a
hrollur	r̥ ɔ t l ʏ r
regla	r ɛ k l a
samþykkja	s a m θ ɪ h c a
grýla	k r iː l a
tattóvera	tʰ aʰ t o u v ɛ r a
gráði	k r a uː ð ɪ
varkár	v a r̥ kʰ a uː r
blóm	p l o uː m
húsnæði	h uː s n a iː ð ɪ
hylja	h ɪ l j a
stóla	s t o uː l a
klekja	kʰ l ɛː c a
marka	m a r̥ k a
túli	tʰ uː l ɪ
frjó	f r j o uː
klængur	kʰ l a i ŋ k ʏ r
trissa	tʰ r ɪ sː a
menga	m e i ŋ k a
fölur	f œː l ʏ r
hökutoppur	h œː k ʏ tʰ ɔ h p ʏ r
brons	p r ɔ n s
línulega	l iː n ʏ l ɛː ɣ a
jakuxi	j aː k ʏ k s ɪ
fjón	f j o uː n
útlenskur	uː t l ɛ n s k ʏ r
persónulega	pʰ ɛ r̥ s o uː n ʏ l ɛː ɣ a
stirðna	s t ɪ r t n a
motta	m ɔ h t a
sandali	s a n t a l ɪ
myndband	m ɪ n t p a n t
sigurðsson	s ɪː ɣ ʏ r ð s s ɔː n
hröngl	r̥ ø y ŋ l
tyrðill	tʰ ɪ r ð ɪ t l
hækka	h a i h k a
hreinsunareldur	r̥ e i n s ʏː n aː r ɛ l t ʏ r
ánamaðkur	a uː n a m a θ k ʏ r
vaff	v a fː
fönix	f œː n ɪ x s
fræ	f r a iː
dauðhreinsa	d ø y ð r̥ e i n s a
enskur	ɛ n s k ʏ r
nytsemi	n ɪː t s ɛː m ɪ
lækur	l a iː k ʏ r
félagi	f j ɛː l aː j ɪ
þvag	θ v aː ɣ
þeir	θ e iː r
ræfill	r a iː v ɪ t l
mannvirðing	m a nː v ɪ r ð i ŋ k
karp	kʰ a r̥ p
miltu	m ɪ l̥ t ʏ
hugur	h ʏː ɣ ʏ r
afrískur	aː f r i s k ʏ r
lauga	l ø yː ɣ a
týndur	tʰ i n t ʏ r
rjúka	r j uː k a
vana	v aː n a
læða	l a iː ð a
barð	p a r ð
egglos	ɛ kː l ɔː s
vafur	v aː v ʏ r
schiöth	s c œ h t
bolli	p ɔ t l ɪ
már	m a uː r
tvíhliða	tʰ v iː l̥ ɪː ð a
dagur	t aː ɣ ʏ r
leiðsla	l e i ð s t l a
ávalur	a uː v aː l ʏ r
askur	a s k ʏ r
gulmaðra	k ʏ l m a ð r a
gullfiskur	k ʏ t l f ɪ s k ʏ r
lirfa	l ɪ r v a
sæta	s a iː t a
glæða	k l a iː ð a
strætisvagn	s t r a iː t ɪ s v a k n
pasta	pʰ a s t a
eista	e i s t a
blágreni	p l a uː k r ɛː n ɪ
túnvingull	tʰ u n v i ŋ k ʏ t l
kóf	kʰ o uː v
pendúll	pʰ ɛ n t ʏ t l
ákafi	a uː kʰ aː v ɪ
frísneskur	f r iː s n ɛ s k ʏ r
mosi	m ɔː s ɪ
menntaskóli	m ɛ n̥ t a s k o uː l ɪ
flugstjóri	f l ʏ x s t j o uː r ɪ
smokkar	s m ɔ h k a r
hrufla	r̥ ʏ p l a
vagga	v a kː a
firð	f ɪ r ð
hlýðni	l̥ i ð n ɪ
grey	k r e iː
gáta	k a uː t a
svandís	s v a n t iː s
þorgeir	θ ɔ r k e iː r
sónatína	s o uː n a tʰ iː n a
storma	s t ɔ r m a
lampi	l a m̥ p ɪ
melgresi	m ɛ l k r ɛː s ɪ
tötrar	tʰ œː t r a r
litúrgískur	l ɪː tʰ u r c i s k ʏ r
teista	tʰ e i s t a
búð	p uː ð
stjórnleysi	s t j o u r t n l e iː s ɪ
morgunhani	m ɔ r k ʏ n h aː n ɪ
finni	f ɪ nː ɪ
æta	a iː t a
sendill	s ɛ n t ɪ t l
svigna	s v ɪ k n a
grunnli	k r ʏ nː l ɪ
labba	l a pː a
beittur	p e i h t ʏ r
erfiði	ɛ r v ɪː ð ɪ
hálmstrá	h a u l m s t r a uː
spil	s p ɪː l
geiri	c e iː r ɪ
anúbis	aː n uː p ɪ s
látún	l a uː t uː n
miða	m ɪː ð a
náhvalur	n a uː kʰ v aː l ʏ r
hnífasmiður	n̥ iː v a s m ɪː ð ʏ r
rauðrófa	r ø y ð r o uː v a
vélfræði	v j ɛ l f r a iː ð ɪ
gnægð	k n a i ɣ ð
trunta	t r ʏ n̥ t a
lestun	l ɛ s t ʏ n
hungur	h u ŋ k ʏ r
lamb	l a m p
fiðla	f ɪ ð l a
bróm	p r o uː m
lensa	l ɛ n s a
hreindýramosi	r̥ e i n t iː r a m ɔː s ɪ
stöð	s t œː ð
kjökra	cʰ œː k r a
gatari	k aː t aː r ɪ
flengur	f l e i ŋ k ʏ r
kaldur	kʰ a l t ʏ r
ágjarn	a uː c a r t n
sæll	s a i t l̥
máfur	m a uː v ʏ r
lerki	l ɛ r̥ c ɪ
spergilkál	s p ɛ r c ɪ l kʰ a uː l
kynnir	cʰ ɪ nː ɪ r
klápur	kʰ l a uː p ʏ r
urð	ʏ r ð
fleygja	f l e iː j a
gulur	k ʏː l ʏ r
krafa	kʰ r aː v a
tíðka	tʰ i θ k a
bárður	p a u r ð ʏ r
þyngd	θ i ŋ t
hanskahólf	h a n s k a h o u l v
ólífa	o uː l iː v a
nammi	n a mː ɪ
væla	v a iː l a
sef	s ɛː v
afrit	a v r ɪː t
sjáumst	s j aː u ʏ m̥ s t
fýldur	f i l t ʏ r
skyggn	s c ɪ k n
frábærlega	f r a uː p a i r l ɛː ɣ a
gneggja	k n ɛ cː a
djóka	t j o uː k a
pönk	pʰ ø y ŋ̊ k
græða	k r a iː ð a
skruma	s k r ʏː m a
grefill	k r ɛː v ɪ t l
kol	kʰ ɔː l
orfa	ɔ r v a
kynkvísl	cʰ ɪː n kʰ v i s t l
il	ɪː l
slark	s t l a r̥ k
droplaug	t r ɔː p l ø yː ɣ
springa	s p r i ŋ k a
andrés	a n t r j ɛː s
þrettán	θ r ɛ h t a uː n
dökkur	t œ h k ʏ r
skammkrækill	s k a mː kʰ r a iː c ɪ t l
kuldalegur	kʰ ʏ l t a l ɛː ɣ ʏ r
gaukur	k ø yː k ʏ r
hollenskur	h ɔ l l ɛ n s k ʏ r
samheitaorðabók	s a m h e iː t a ɔ r ð a p o uː k
grjón	k r j o uː n
geisli	c e i s t l ɪ
erla	ɛ r t l a
gotland	k ɔː t l a n t
bang	p a u ŋ k
mannréttindi	m a nː r j ɛ h t ɪ n t ɪ
gráspör	k r a uː s p œː r
dregill	t r e iː j ɪ t l
aldeilis	a l t e iː l ɪ s
tvívetni	tʰ v iː v ɛ h t n ɪ
sigfúsína	s ɪ x f uː s iː n a
kröfuganga	kʰ r œː v ʏ k a u ŋ k a
skurðgoð	s k ʏ r ð k ɔː d
særa	s a iː r a
ferhyrningur	f ɛ r h ɪ r t n i ŋ k ʏ r
þys	θ ɪː s
skjár	s c a uː r
fimma	f ɪ mː a
bátsferð	p a u t s f ɛ r ð
gítar	c iː tʰ aː r
krækja	kʰ r a iː c a
skóglaus	s k o u ɣ l ø yː s
ingimundur	i ɲ c ɪ m ʏ n t ʏ r
danska	t a n s k a
kyrtill	cʰ ɪ r̥ t ɪ t l
dúkur	t uː k ʏ r
nekt	n ɛ x t
pína	pʰ iː n a
afturhaldsstefna	a f t ʏ r h a l t s s t ɛ p n a
gredda	k r ɛ tː a
árstími	a u r s tʰ iː m ɪ
klipping	kʰ l ɪ h p i ŋ k
andaglas	a n t a k l aː s
lögmaður	l œ ɣ m aː ð ʏ r
gella	c ɛ lː a
rif	r ɪː v
ykkar	ɪ h k ɐ r
bland	p l a n t
engi	e i ɲ c ɪ
sameind	s aː m e i n t
lánsþýðing	l a u n s θ iː ð i ŋ k
húm	h uː m
jarðsprengja	j a r ð s p r e i ɲ c a
hálendi	h a uː l ɛ n t ɪ
ferstrendingur	f ɛ r̥ s t r ɛ n t i ŋ k ʏ r
kvap	kʰ v aː p
svalur	s v aː l ʏ r
handbolti	h a n t p ɔ l̥ t ɪ
hegna	h ɛ k n a
svæfill	s v a iː v ɪ t l
harpa	h a r̥ p a
hýena	h iː ɛ n a
cís	s iː s
indæll	ɪ n t a i t l
styrkleiki	s t ɪ r̥ k l e iː c ɪ
fjóla	f j o uː l a
smjör	s m j œː r
tryggur	tʰ r ɪ kː ʏ r
hryssingslegur	r̥ ɪ sː i ŋ k s l ɛː ɣ ʏ r
hjólhýsi	ç o u l h iː s ɪ
rakvél	r aː k v j ɛː l
hlað	l̥ aː ð
uppspretta	ʏ h p s p r ɛ h t a
etja	ɛː t j a
blóðormur	p l o uː ð ɔ r m ʏ r
aðalsetning	aː ð a l s ɛ h t n i ŋ k
fæðing	f a iː ð i ŋ k
blaðamaður	p l aː ð a m aː ð ʏ r
tilgangsfall	tʰ ɪ l k a u ŋ k s f a t l
rætur	r a iː t ʏ r
bílstjóri	p i l s t j o uː r ɪ
klípa	kʰ l iː p a
föl	f œː l
erfiðisvinna	ɛ r v ɪː ð ɪ s v ɪ nː a
vís	v iː s
skuldari	s k ʏ l t aː r ɪ
fas	f aː s
glundra	k l ʏ n t r a
þarna	θ a r t n a
náða	n a uː ð a
skjóla	s c o uː l a
asna	a s t n a
briskirtill	p r ɪː s cʰ ɪ r̥ t ɪ t l
lið	l ɪː ð
öryggisgirðing	œː r ɪ cː ɪ s c ɪ r ð i ŋ k
forritunarmál	f ɔ rː ɪː t ʏ n a r m a uː l
bros	p r ɔː s
fylja	f ɪ l j a
jarðsaga	j a r ð s aː ɣ a
nefnd	n ɛ m t
kústur	kʰ u s t ʏ r
fjalldrapi	f j a t l t r aː p ɪ
alnet	a l n ɛː t
forinta	f ɔː r ɪ n̥ t a
stjórn	s t j o u r t n
búlgaría	p u l k a r iː j a
storkur	s t ɔ r̥ k ʏ r
piparúði	pʰ ɪː p a r uː ð ɪ
málbein	m a u l p e iː n
svo	s v ɔː
múhameð	m uː h a m ɛː ð
mýrdalur	m i r t aː l ʏ r
kvars	kʰ v a r̥ s
spíra	s p iː r a
diskótek	t ɪ s k o uː tʰ ɛː k
frón	f r o uː n
logn	l ɔ k n
kafald	kʰ aː v a l t
plast	pʰ l a s t
rómur	r o uː m ʏ r
sítrónusafi	s iː tʰ r o uː n ʏ s aː v ɪ
blævængur	p l a iː v a i ŋ k ʏ r
útbreiðsla	uː t p r e i ð s t l a
notkun	n ɔ h t k ʏ n
blæösp	p l a iː œ s p
júlíus	j uː l iː j ʏ s
hvolfa	kʰ v ɔ l v a
agalegur	aː ɣ a l ɛ ɣ ʏ r
hólmur	h o u l m ʏ r
jarma	j a r m a
skær	s c a iː r
sonur	s ɔː n ʏ r
ekla	ɛ h k l a
sjóður	s j o uː ð ʏ r
ráðabrugg	r a uː ð a p r ʏ kː
kilja	cʰ ɪ l j a
malmquist	m a l m kʰ v ɪ s t
hvítá	xʷ iː t a uː
smekkur	s m ɛ h k ʏ r
leggur	l ɛ kː ʏ r
fengur	f e i ŋ k ʏ r
gramm	k r a mː
budda	p ʏ tː a
hvítlauksgeiri	kʰ v iː t l ø y k s c e iː r ɪ
klappa	k l a h p a
lensutungljurt	l ɛ n s ʏ tʰ u ŋ l j ʏ r̥ t
sögn	s œ k n
nökkvi	n œ h k v ɪ
heilsa	h e i l s a
öld	œ l t
guðjónína	k v ʏ ð j o uː n iː n a
hokkí	h ɔ h c iː
rotinn	r ɔː t ɪ nː
flekklaus	f l ɛ h k l ø yː s
áskrift	a uː s k r ɪ f t
sigmundur	s ɪ ɣ m ʏ n t ʏ r
menntun	m ɛ n̥ t ʏ n
legunautur	l ɛː ɣ ʏ n ø yː t ʏ r
fjarski	f j a r̥ s c ɪ
þátíð	θ a uː tʰ iː ð
aðdráttur	a ð t r a u h t ʏ r
komma	kʰ ɔ mː a
langur	l a u ŋ k ʏ r
barnamosi	p a r t n a m ɔː s ɪ
bil	p ɪː l
demba	t ɛ m p a
haraldína	h aː r a l t iː n a
kafari	kʰ aː v a r ɪ
tíðni	tʰ i ð n ɪ
tarfur	tʰ a r v ʏ r
lífga	l i v k a
klaki	kʰ l aː c ɪ
hrap	r̥ aː p
matskeið	m aː t s c e iː ð
tvíær	tʰ v iː a iː r
skemmd	s c ɛ m t
bötnun	p œ h t n ʏ n
hróðný	r̥ o u ð n iː
hálmur	h a u l m ʏ r
postullegur	pʰ ɔ s t ʏ l l ɛː ɣ ʏ r
karlkyn	kʰ a r t l̥ cʰ ɪː n
músvákur	m uː s v a uː k ʏ r
þrengja	θ r e i ɲ c a
hamingjusamur	h aː m i ɲ c ʏ s aː m ʏ r
lestarstjóri	l ɛ s t a r s t j o uː r ɪ
hvörf	kʰ v œ r v
laginn	l a iː j ɪ nː
njóli	n j o uː l ɪ
finnskur	f ɪ n s k ʏ r
marxismi	m a r̥ k s ɪ s m ɪ
grænmeti	k r a i n m ɛː t ɪ
vasahnífur	v aː s a n̥ iː v ʏ r
ljótur	l j o uː t ʏ r
endur	ɛ n t ʏ r
dæmi	t a iː m ɪ
dökkhæra	t œ h k h a iː r a
dóni	t o uː n ɪ
þorláksmessa	θ ɔ r l a u k s m ɛ sː a
fæll	f a i t l
brúsi	p r u s ɪ
fífa	f iː v a
sofa	s ɔː v a
tanta	tʰ a n̥ t a
miðasala	m ɪː ð a s aː l a
skriðnablóm	s k r ɪ ð n a p l o uː m
hvítvín	xʷ iː t v iː n
sleikur	s t l e iː k ʏ r
frysta	f r ɪ s t a
kaka	kʰ aː k a
kajak	kʰ a iː j aː k
meinbugur	m e i n p ʏː ɣ ʏ r
arnþrúður	a r t n θ r uː ð ʏ r
sumar	s ʏː m aː r
sori	s ɔː r ɪ
víóla	v iː j o uː l a
embætti	ɛ m p a i h t ɪ
stjórnborði	s t j o u r t n p ɔ r ð ɪ
brandugla	p r a n t ʏ k l a
fella	f ɛ t l a
jósebína	j o uː s ɛː p iː n a
byssustingur	p ɪ sː ʏ s t i ŋ k ʏ r
hrafndís	r̥ a p n t iː s
baldur	p a l t ʏ r
vafra	v a v r a
hausta	h ø y s t a
trúður	tʰ r uː ð ʏ r
gras	k r aː s
ljúka	l j uː k a
raul	r ø yː l
kráka	kʰ r a uː k a
almennur	a l m ɛ nː ʏ r
sveifla	s v e i p l a
stækja	s t a iː c a
einhjól	e i n ç o uː l
öreindafræði	œː r e i n t a f r a iː ð ɪ
dáð	t a uː ð
nafnorð	n a p n ɔ r ð
hlunkur	l̥ u ŋ̊ k ʏ r
skjóta	s c o uː t a
núpur	n uː p ʏ r
sætur	s a iː t ʏ r
vegasalt	v ɛː ɣ a s a l̥ t
té	tʰ j ɛː
klara	kʰ l aː r a
þræta	θ r a iː t a
steinefni	s t e iː n ɛ p n ɪ
víðfrægur	v i ð f r a iː ɣ ʏ r
vélbúnaður	v j ɛ l p uː n aː ð ʏ r
hrista	r̥ ɪ s t a
spítta	s p i h t a
eigandi	e iː ɣ a n t ɪ
vindugur	v ɪ n t ʏː ɣ ʏ r
les	l ɛː s
siglutoppur	s ɪ k l ʏ tʰ ɔ h p ʏ r
árósar	a uː r o uː s a r
gíbraltar	c iː p r a l̥ t aː r
samkennd	s a m cʰ ɛ n t
skynugur	s c ɪː n ʏː ɣ ʏ r
skurður	s k ʏ r ð ʏ r
votlendi	v ɔː t l ɛ n d ɪ
trefill	tʰ r ɛː v ɪ t l
drómedari	t r o uː m ɛː t aː r ɪ
buski	p ʏ s c ɪ
káfa	kʰ a uː v a
logri	l ɔ ɣ r ɪ
eignarfall	e i k n a r f a t l
magur	m aː ɣ ʏ r
smíð	s m iː ð
endurreisnarstefna	ɛ n t ʏ r r e i s t n a r s t ɛ p n a
langnykra	l a u ŋ k n ɪː k r a
ljá	l j a uː
rígur	r iː ɣ ʏ r
múli	m uː l ɪ
skandall	s k a n t a t l
kverk	kʰ v ɛ r̥ k
tvíburi	tʰ v iː p ʏː r ɪ
orma	ɔ r m a
geðlæknir	c ɛ ð l a i h k n ɪ r
skytta	s c ɪ h t a
fúinn	f uː ɪ nː
viðskiptavinur	v ɪ ð s k ɪ f t a v ɪː n ʏ r
staukur	s t ø yː k ʏ r
þverflauta	θ v ɛ r̥ f l ø yː t a
hraðahindrun	r̥ aː ð a h ɪ n t r ʏ n
æsa	a iː s a
sálmabók	s a u l m a p o uː k
tófugras	tʰ o uː v ʏ k r aː s
járnbraut	j a u r t n p r ø yː t
hnigna	n̥ ɪ k n a
gelta	c ɛ l̥ t a
sagnfræðingur	s a k n f r a iː ð i ŋ k ʏ r
verndari	v ɛ r n t aː r ɪ
múkki	m u h c ɪ
binda	p ɪ n t a
fjólmundur	f j o u l m ʏ n t ʏ r
tíðahvörf	tʰ iː ð a xʷ œ r v
engill	e i ɲ c ɪ t l
langamma	l a u ŋ k a mː a
guðmunda	k v ʏ ð m ʏ n t a
kókoshneta	k o uː k ɔ s n̥ ɛː t a
afburður	a v p ʏ r ð ʏ r
hvaða	xʷ aː ð a
líta	l iː t a
veiða	v e iː ð a
kæliskápur	cʰ a iː l ɪ s k aː p ʏ r
þerna	θ ɛ r t n a
lesandabréf	l ɛː s a n t a p r j ɛː v
lýsingarorð	l iː s i ŋ k aː r ɔ r ð
tætingur	tʰ a iː t i ŋ k ʏ r
franskur	f r a n s k ʏ r
rykkilín	r ɪ h c ɪ l iː n
gunndís	k ʏ nː t iː s
tvinna	t v ɪ nː a
glufa	k l ʏː v a
veiklun	v e i h k l ʏ n
peysa	pʰ e iː s a
hnútur	n̥ uː t ʏ r
fylling	f ɪ t l i ŋ k
fóðrun	f o u ð r ʏ n
kristjánssandur	kʰ r ɪ s t j a u n s s a n t ʏ r
nautahakk	n ø yː t a h a h k
bismút	p ɪ s m uː t
telpa	tʰ ɛ l̥ p a
baðmullarsvunta	p a ð m ʏ t l a r s v ʏ n̥ t a
auli	ø yː l ɪ
guðbjörg	k v ʏ ð p j œ r k
íslenskur	iː s l ɛ n s k ʏ r
þykkja	θ ɪ h c a
geisa	c e iː s a
verma	v ɛ r m a
hera	h ɛː r a
skapa	s k aː p a
sjóli	s j o uː l ɪ
ljósastör	l j o uː s a s t œː r
evrópa	ɛ v r o uː p a
sjóher	s j o uː h ɛː r
gala	k aː l a
teikn	tʰ e i h k n
atarna	a tʰ a r t n a
haki	h aː c ɪ
mjónefur	m j o uː n ɛː v ʏ r
þorlákur	θ ɔ r l a uː k ʏ r
hvarmur	xʷ a r m ʏ r
jiddíska	j ɪ tː i s k a
mykja	m ɪː c a
skel	s c ɛː l
lóðleit	l o u ð l e iː t
áhugi	a uː h ʏ j ɪ
öryggi	œː r ɪ cː ɪ
djamm	t j a mː
hálfbróðir	h a u l v p r o uː ð ɪ r
eldast	ɛ l t a s t
skadda	s k a tː a
pollagalli	pʰ ɔ t l a k a lː ɪ
misræmi	m ɪː s r a iː m ɪ
aðalbraut	aː ð a l p r ø yː t
gisting	c ɪ s t i ŋ k
hornabolti	h ɔ t n a p ɔ l̥ t ɪ
stansa	s t a n s a
tölva	tʰ œ l v a
þankastrik	θ a u ŋ̊ k a s t r ɪː k
vel	v ɛː l
gráðostur	k r a uː ð ɔ s t ʏ r
hana	h aː n a
skotvopn	s k ɔː t v ɔ h p n
óþægindi	o uː θ a iː j ɪ n t ɪ
mund	m ʏ n t
krol	kʰ r ɔː l
rymja	r ɪ m j a
gerð	c ɛ r ð
kollekta	kʰ ɔ lː ɛ x t a
þrífa	θ r iː v a
fortíðarþrá	f ɔ r̥ tʰ iː ð a r θ r a uː
aðsjáll	a ð s j a u t l
spað	s p aː ð
ormur	ɔ r m ʏ r
geislabaugur	c e i s t l a p ø yː ɣ ʏ r
oföndun	ɔː v œ n t ʏ n
botnlangi	p ɔ h t n l a u ŋ c ɪ
nestisbox	n ɛ s t ɪ s p ɔ x s
beddi	p ɛ tː ɪ
upp	ʏ h p
aðalmundur	aː ð a l m ʏ n t ʏ r
framkvæmdastjóri	f r a m kʰ v a i m t a s t j o uː r ɪ
gráðubogi	k r a uː ð ʏ p ɔː j ɪ
biðlari	p ɪ ð l aː r ɪ
ljónslappi	l j o u n s t l a h p ɪ
tré	tʰ r j ɛː
tjákn	tʰ j a u h k n
halli	h a t l ɪ
hrasa	r̥ aː s a
kefja	c ɛ v j a
markgreifi	m a r̥ k k r e iː v ɪ
brautarstöð	p r ø yː t a r s t œː ð
própan	pʰ r o uː pʰ a n
slokkna	s t l ɔ h k n a
korpönd	kʰ ɔ r̥ p œ n t
gljúfur	k l j uː v ʏ r
leigja	l e iː j a
ásmundur	a uː s m ʏ n t ʏ r
hellir	h ɛ t l ɪ r
róteind	r o uː t e i n t
breiða	p r e iː ð a
fífl	f i p l
fnykur	f n ɪː k ʏ r
mórauður	m o uː r ø yː ð ʏ r
einstaklingur	e i n s t a k l i ŋ k ʏ r
láglendi	l a u ɣ l ɛ n t ɪ
heiðdís	h e i ð t iː s
lessa	l ɛ sː a
predikari	pʰ r ɛː t ɪ k a r ɪ
fyrirgera	f ɪː r ɪ r c ɛː r a
tékki	tʰ j ɛ h c ɪ
mæna	m a iː n a
vol	v ɔː l
erfiður	ɛ r v ɪː ð ʏ r
hliðarvasi	l̥ ɪː ð a r v aː s ɪ
jóakim	j o uː a cʰ ɪ m
úr	uː r
klóelfting	kʰ l o uː ɛ l̥ʷ t i ŋ k
ólafssúra	o uː l a f s s uː r a
dílaskarfur	t iː l a s k a r v ʏ r
heit	h e iː t
teikning	tʰ e i h k n i ŋ k
marglytta	m a r k l ɪ h t a
núll	n u lː
bræla	p r a iː l a
loftþrýstingur	l ɔ f t θ r i s t i ŋ k ʏ r
genf	k ɛ n f
fylgi	f ɪ l c ɪ
dýpt	t i f t
buxur	p ʏ x s ʏ r
peningur	pʰ ɛː n i ŋ k ʏ r
tómur	tʰ o uː m ʏ r
fullkomlega	f ʏ t l̥ kʰ ɔ m l ɛː ɣ a
grípa	k r iː p a
ég	j ɛ ɣ
afturbeyging	a f t ʏ r p e iː j i ŋ k
benedikt	p ɛː n ɛː t ɪ x t
trúarjátning	tʰ r uː a r j a u h t n i ŋ k
einrækta	e i n r a i x t a
börkur	p œ r̥ k ʏ r
tenging	tʰ e i ɲ c i ŋ k
lukka	l ʏ h k a
körfuvíðir	kʰ œ r v ʏ v iː ð ɪ r
kjólföt	kʰ j o u l f œː t
foss	f ɔ sː
drjóli	t r j o uː l ɪ
verkefni	v ɛ r̥ k ɛ p n ɪ
sifji	s ɪ v j ɪ
bulla	p ʏ t l a
snupra	s n ʏː p r a
helluhraun	h ɛ t l ʏ r̥ ø yː n
innyfli	ɪ nː ɪ p l ɪ
stjarneðlisfræði	s t j a r t n ɛ ð l ɪ s f r a iː ð ɪ
brottvísun	p r ɔ h t v iː s ʏ n
atvikssaga	aː t v ɪ x s s aː ɣ a
körfuboltaþjálfari	kʰ œ r v ʏ p ɔ l̥ t a θ j a u l v a r ɪ
kurteisi	kʰ ʏ r̥ t e iː s ɪ
dreyra	t r e iː r a
grunnsævi	k r ʏ nː s a iː v ɪ
brúðgumi	p r u ð k ʏː m ɪ
þeta	θ ɛː t a
aðalskrifstofa	aː ð a l s k r i f s t ɔː v a
flaggskip	f l a kː s c ɪː p
dýptarleit	t i f t a r l e iː t
predika	pʰ r ɛː t ɪː k a
nyrðra	n ɪ r ð r a
venda	v ɛ n t a
bókasafn	p o uː k a s a p n
ostefni	ɔ s t ɛ p n ɪ
fýra	f iː r a
þó	θ o uː
þórfríður	θ o u r̥ f r iː ð ʏ r
rófubein	r o uː v ʏ p e iː n
eggjastokkur	ɛ cː a s t ɔ h k ʏ r
hjalli	ç a t l ɪ
hress	r̥ ɛ sː
silki	s ɪ l̥ c ɪ
sölt	s œ l̥ t
kæti	cʰ a iː t ɪ
kreista	kʰ r e i s t a
auðnutittlingur	ø y ð n ʏ tʰ ɪ h t l i ŋ k ʏ r
brynjólfur	p r ɪ n j o u l v ʏ r
neðanjarðarbraut	n ɛː ð a n j a r ð a r p r ø yː t
hippi	h ɪ h p ɪ
rafeind	r aː v e i n t
þagna	θ a k n a
flygilhorn	f l ɪ j ɪ l h ɔ r t n
rúmur	r uː m ʏ r
ástfríður	a u s t f r iː ð ʏ r
jóhanna	j o uː h a nː a
pílári	pʰ iː l a uː r ɪ
strigi	s t r ɪː j ɪ
hneisulegur	n̥ e iː s ʏ l ɛː ɣ ʏ r
lifur	l ɪː v ʏ r
trippi	tʰ r ɪ h p ɪ
feldur	f ɛ l t ʏ r
sjófugl	s j o uː f ʏ k l
barkakýli	p a r̥ k a cʰ iː l ɪ
forstöðumaður	f ɔ r̥ s t œ ð ʏ m aː ð ʏ r
skrá	s k r a uː
klóra	kʰ l o uː r a
sofi	s ɔː v ɪ
mýramaðra	m iː r a m a ð r a
sjöundi	s j œː ʏ n t ɪ
jarðúlfur	j a r ð u l v ʏ r
vídalín	v iː t a l iː n
rekja	r ɛː c a
lóð	l o uː ð
akarn	aː kʰ a r t n
haukur	h ø yː k ʏ r
ex	ɛ k s
bruggun	p r ʏ kː ʏ n
sandfok	s a n t f ɔː k
dymbildagavika	t ɪ m p ɪ l t aː ɣ a v ɪː k a
ex	ɛ x s
goshver	k ɔː s kʰ v ɛː r
hermundur	h ɛ r m ʏ n t ʏ r
hreiður	r̥ e iː ð ʏ r
heimsókn	h e i m s o u h k n
slarka	s t l a r̥ k a
saltur	s a l̥ t ʏ r
rúmfræði	r u m f r a iː ð ɪ
hrekkjalómur	r̥ ɛ h c a l o uː m ʏ r
hrútspungur	r̥ u t s pʰ u ŋ k ʏ r
serbneskur	s ɛ r p n ɛ s k ʏ r
regn	r ɛ k n
líffræðingur	l i f f r a iː ð i ŋ k ʏ r
bera	p ɛː r a
aðaláhugamál	aː ð aː l a uː h ʏː ɣ a m a uː l
fjölga	f j œ l k a
kúbein	kʰ uː p e iː n
hnúi	n̥ uː ɪ
hamstur	h a m s t ʏ r
afdrep	a v t r ɛː p
kenjar	cʰ ɛ n j a r
aðfella	a ð f ɛ t l a
þrugla	θ r ʏ k l a
ingólfur	i ŋ k o u l v ʏ r
borg	p ɔ r k
frakkland	f r a h k l a n t
suðurljós	s ʏː ð ʏ r l j o uː s
barti	p a r̥ t ɪ
flug	f l ʏː ɣ
svar	s v aː r
mútta	m uʰ t a
andstæður	a n t s t a i ð ʏ r
fénaður	f j ɛː n aː ð ʏ r
klaustur	kʰ l ø y s t ʏ r
reykvískur	r e iː k v i s k ʏ r
brekkusnigill	p r ɛ h k ʏ s t n ɪː j ɪ t l
skiljanlegur	s c ɪ l j a n l ɛː ɣ ʏ r
ekki	ɛ h c ɪ
máni	m a uː n ɪ
daðla	t a ð l a
þorgerður	θ ɔ r c ɛ r ð ʏ r
hvert	kʰ v ɛ r̥ t
stelling	s t ɛ t l i ŋ k
hlýr	l̥ iː r
stakur	s t aː k ʏ r
þórhallur	θ o uː r h a t l ʏ r
þrýsta	θ r i s t a
dagbók	t a ɣ p o uː k
örk	œ r̥ k
brum	p r ʏː m
járnbrautarlest	j a u r t n p r ø yː t a r l ɛ s t
glópagull	k l o uː p a k ʏ t l
ferningur	f ɛ r t n i ŋ k ʏ r
dreyrasýki	t r e iː r a s iː c ɪ
hebreska	h ɛː p r ɛ s k a
melding	m ɛ l t i ŋ k
aristóteles	aː r ɪ s t o uː tʰ ɛː l ɛː s
fýsn	f i s t n
mjólkursýra	m j o u l̥ k ʏ r s iː r a
hófskegg	h o u v s c ɛ kː
kjökur	cʰ œː k ʏ r
dé	t j ɛː
sporður	s p ɔ r ð ʏ r
siga	s ɪː ɣ a
humar	h ʏː m a r
ódýr	o uː t iː r
húðsjúkdómafræði	h uː ð s j u k t o uː m a f r a iː ð ɪ
dökkna	t œ h k n a
bleyða	p l e iː ð a
kviður	kʰ v ɪː ð ʏ r
meiddur	m e i tː ʏ r
boðorð	p ɔː ð ɔ r ð
baka	p aː k a
fræfill	f r a iː v ɪ t l
sæma	s a iː m a
téténía	tʰ j ɛ tʰ j ɛː n iː j a
handaband	h a n t a p a n t
milljónamæringur	m ɪ l j o uː n a m a iː r i ŋ k ʏ r
tryggja	tʰ r ɪ cː a
kveisa	kʰ v e iː s a
afganistan	a v k aː n ɪ s t aː n
lífvera	l i v v ɛː r a
bankaútibú	p a u ŋ̊ k a uː t ɪ p uː
eyjólfína	e iː j o u l v iː n a
kringumstæður	kʰ r i ŋ k ʏ m s t a iː ð ʏ r
enda	ɛ n t a
kúluvarp	kʰ uː l ʏ v a r̥ p
bókastoð	p o uː k a s t ɔː ð
sjálf	s j a u l v
dindill	t ɪ n t ɪ t l
kveða	kʰ v ɛː ð a
germynd	c ɛ r m ɪ n t
bjuggu	p j ʏ ɣ ʏ
mikið	m ɪː c ɪ ð
heigull	h e iː ɣ ʏ t l
blístra	p l i s t r a
hæfni	h a i p n ɪ
nátíð	n a uː tʰ iː ð
óvína	o uː v iː n a
strekkja	s t r ɛ h c a
áll	a u t l
þamba	θ a m p a
orðskviður	ɔ r ð s kʰ v ɪː ð ʏ r
skíðhvalur	s c i ð xʷ aː l ʏ r
sýnishorn	s iː n ɪ s h ɔ r t n
sköddun	s k œ tː ʏ n
sívalur	s iː v aː l ʏ r
kennari	cʰ ɛ nː aː r ɪ
smásaga	s m a uː s aː ɣ a
réttlæti	r j ɛ h t l a iː t ɪ
kólfur	kʰ o u l v ʏ r
þiggja	θ ɪ cː a
drykkur	t r ɪ h k ʏ r
einkavæðing	e i ŋ k a v a iː ð i ŋ k
sofna	s ɔ p n a
erlendur	ɛ t l ɛ ~ ɪ n t ʏ r
útskolun	uː t s k ɔː l ʏ n
prinsipissa	pʰ r ɪ n s ɪ pʰ ɪ sː a
bernhöft	p ɛ r n h œ f t
ógnarúlfur	o u k n a r u l v ʏ r
niðjatal	n ɪ ð j a tʰ aː l
auðæfi	ø yː ð a iː v ɪ
ark	a r̥ k
þykkni	θ ɪ h k n ɪ
aðalskáli	aː ð a l s k a uː l ɪ
kirkja	cʰ ɪ r̥ c a
dreggjar	t r ɛ cː a r
lára	l a uː r a
samræmi	s a m r a iː m ɪ
kyndugur	cʰ ɪ n t ʏː ɣ ʏ r
þurr	θ ʏ rː
afkvæmi	a v kʰ v a iː m ɪ
hálmgresi	h a u l m k r ɛː s ɪ
lotsveifgras	l ɔː t s v e i v k r aː s
brauð	p r ø yː ð
spritt	s p r ɪ h t
kirkjuendir	cʰ ɪ r̥ k j ʏ ɛ n t ɪ r
tækling	tʰ a i h k l i ŋ k
ógna	o u k n a
þórduna	θ o u r t ʏː n a
þanki	θ a u ɲ̊ c ɪ
gremja	k r ɛ m j a
landbúnaður	l a n t p uː n aː ð ʏ r
einræði	e i n r a iː ð ɪ
logi	l ɔ iː j ɪ
hnallur	n̥ a t l ʏ r
ölgerð	œ l c ɛ r ð
vallelfting	v a t l ɛ l̥ʷ t i ŋ k
móðursystir	m o uː ð ʏ r s ɪ s t ɪ r
armenska	a r m ɛ n s k a
þórólfur	θ o uː r o u l v ʏ r
hæll	h a i t l
nirfill	n ɪ r v ɪ t l
sagnbót	s a k n p o uː t
æs	a iː s
afríkufíll	aː f r iː k ʏ f i t l
rétta	r j ɛ h t a
hattur	h aʰ t ʏ r
fes	f ɛː s
sauðnaut	s ø y ð n ø yː t
far	f aː r
bylgjulengd	p ɪ l c ʏ l e i ŋ k t
api	aː p ɪ
el	ɛː l
tilkynning	tʰ ɪ l cʰ ɪ nː i ŋ k
faggi	f a cː ɪ
böðull	p œː ð ʏ t l
krossför	kʰ r ɔ sː f œː r
tryggvi	tʰ r ɪ k v ɪ
fúx	f u x s
klúðra	kʰ l u ð r a
kísill	cʰ iː s ɪ t l
tiltaka	tʰ ɪː l tʰ aː k a
unnusti	ʏ nː ʏ s t ɪ
blásýra	p l a uː s iː r a
gerður	c ɛ r ð ʏ r
álka	a u l̥ k a
malbik	m a l p ɪː k
húka	h uː k a
hengja	h e i ɲ c a
gull	k ʏ t l
endurskoðandi	ɛ n t ʏ r s k ɔː ð a n t ɪ
hendni	h ɛ n t n ɪ
tattú	tʰ a h t uː
rykfalla	r ɪː k f a t l a
þjark	θ j a r̥ k
afmæli	a m m a iː l ɪ
eggjárn	ɛ kː j a u r t n
eyðilegging	e iː ð ɪ l ɛ cː i ŋ k
tvenna	tʰ v ɛ nː a
skynja	s c ɪ n j a
oddviti	ɔ tː v ɪ t ɪ
jarðlag	j a r ð l aː ɣ
nárú	n a uː r uː
merki	m ɛ r̥ c ɪ
ef	ɛː v
bólstraský	p o u l s t r a s c iː
dunkur	t u ŋ̊ k ʏ r
lykta	l ɪ x t a
mala	m aː l a
eyjaálfa	e iː j a a u l v a
töluorð	tʰ œː l ʏ ɔ r ð
sexa	s ɛ x s a
kunnátta	kʰ ʏ nː a u h t a
stökkull	s t œ h k ʏ t l
bannfæring	p a nː f a iː r i ŋ k
ferming	f ɛ r m i ŋ k
guðdís	k v ʏ ð t iː s
æstur	a i s t ʏ r
bosnía	p ɔ s t n iː j a
skíma	s c iː m a
þeytingur	θ e iː t i ŋ k ʏ r
mótbára	m o uː t p a uː r a
lesblindur	l ɛː s p l ɪ n t ʏ r
dýrabúð	t iː r a p uː ð
ráðgjafi	r a u ð c aː v ɪ
miðjumaður	m ɪ ð j ʏ m aː ð ʏ r
náðhús	n a u ð h uː s
stormur	s t ɔ r m ʏ r
skurðlæknir	s k ʏ r ð l a i h k n ɪ r
hneppi	n̥ ɛ h p ɪ
tegrun	tʰ ɛ ɣ r ʏ n
matur	m aː t ʏ r
svitna	s v ɪ h t n a
freyja	f r e iː j a
dreifing	t r e iː v i ŋ k
býsn	p i s t n
anna	a nː a
abbadís	a pː a t iː s
hemja	h ɛ m j a
hveitiklíð	xʷ e iː t ɪ kʰ l iː ð
mokka	m ɔ h k a
pungur	pʰ u ŋ k ʏ r
stofnun	s t ɔ p n ʏ n
tugur	tʰ ʏː ɣ ʏ r
þumlungur	θ ʏ m l u ŋ k ʏ r
blálilja	p l a uː l ɪ l j a
handarkriki	h a n t a r kʰ r ɪː c ɪ
jakob	j aː kʰ ɔː p
skál	s k a uː l
fappa	f a h p a
ásdís	a uː s t iː s
rjátla	r j a u h t l a
sýkja	s iː c a
uppblástur	ʏ h p p l a u s t ʏ r
fjöldi	f j œ l t ɪ
týsfjóla	tʰ iː s f j o uː l a
keppni	cʰ ɛ h p n ɪ
sýrena	s iː r ɛː n a
horvatn	h ɔ r v a h t n
skreyta	s k r e iː t a
graslendi	k r aː s l ɛ n t ɪ
frelsishetja	f r ɛ l s ɪ s h ɛː t j a
naut	n ø yː t
ögmundína	œ ɣ m ʏ n t iː n a
múta	m uː t a
helgur	h ɛ l k ʏ r
tófa	tʰ o uː v a
sjúss	s j u sː
lífsgleði	l i f s k l ɛː ð ɪ
snurðulaus	s t n ʏ r ð ʏ l ø yː s
votur	v ɔː t ʏ r
maki	m aː c ɪ
sólmyrkvi	s o u l m ɪ r̥ k v ɪ
strjálingur	s t r j a uː l i ŋ k ʏ r
skaði	s k aː ð ɪ
lægð	l a i ɣ ð
látæði	l a uː t a iː ð ɪ
brjóstbein	p r j o u s t p e iː n
saffran	s a fː r a n
andfélagslegur	a n t f j ɛː l a x s l ɛː ɣ ʏ r
þríhyrnuburkni	θ r iː h ɪ r t n ʏ p ʏ r̥ k n ɪ
gegnvirkur	c ɛ k n v ɪ r̥ k ʏ r
ís	iː s
vasi	v aː s ɪ
heimavinna	h e iː m a v ɪ nː a
ójafna	o uː j a p n a
spekja	s p ɛː c a
hörpuskel	h œ r̥ p ʏ s c ɛː l
tóm	tʰ o uː m
geipa	c e iː p a
deyða	t e iː ð a
nepja	n ɛː p j a
kjarnakorn	cʰ a r t n a kʰ ɔ r t n
piparsveinn	pʰ ɪː p a r s v e i t n
akur	aː kʰ ʏ r
mylsna	m ɪ l s t n a
hanki	h a u ɲ̊ c ɪ
fax	f a k s
vestari	v ɛ s t aː r ɪ
platína	pʰ l aː tʰ iː n a
vínberjalögur	v i n p ɛ r j a l œː ɣ ʏ r
snækrækill	s n a iː kʰ r a iː c ɪ t l
þræll	θ r a i t l
rass	r a sː
gróf	k r o uː v
aðalakkeri	aː ð a l a h k ɛː r ɪ
fitfugl	f ɪ t f ʏ k l
hóffífill	h o u v f iː v ɪ t l
hengi	h e i ɲ c ɪ
hjálmur	ç a u l m ʏ r
stofna	s t ɔ p n a
árekstur	a uː r ɛ x s t ʏ r
stundum	s t ʏ n t ʏ m
mega	m e iː ɣ a
stækka	s t a i h k a
liðamót	l ɪː ð a m o uː t
ljósberi	l j o uː s p ɛː r ɪ
augljós	ø y ɣ l j o uː s
prakkari	pʰ r a h k aː r ɪ
fæða	f a iː ð a
safn	s a p n
sjá	s j a uː
milljón	m ɪ l j o uː n
lauftré	l ø y v t r j ɛː
garðaprjón	k a r ð a pʰ r j o uː n
snjótittlingur	s n j o uː tʰ ɪ h t l i ŋ k ʏ r
kenning	cʰ ɛ nː i ŋ k
nýsilfur	n iː s ɪ l v ʏ r
kúlulega	kʰ uː l ʏ l ɛː ɣ a
deildarfall	t e i l t a r f a t l
byssa	p ɪ sː a
lærdómur	l a i r t o uː m ʏ r
sögumaður	s œː ɣ ʏ m aː ð ʏ r
heiðagæs	h e iː ð a c a iː s
draumsóley	t r ø y m s o uː l e iː
varpi	v a r̥ p ɪ
stífna	s t i p n a
komutími	kʰ ɔː m ʏ tʰ iː m ɪ
hildimundur	h ɪ l t ɪ m ʏ n t ʏ r
styrkur	s t ɪ r̥ k ʏ r
hlýri	l̥ iː r ɪ
net	n ɛː t
sprettur	s p r ɛ h t ʏ r
klapp	kʰ l a h p
stofnfélagi	s t ɔ p n f j ɛː l aː j ɪ
hnökri	n̥ œː k r ɪ
tryggð	tʰ r ɪ ɣ ð
gluggatjald	k l ʏ kː a tʰ j a l t
gjaldkeri	c a l t cʰ ɛː r ɪ
strandsauðlaukur	s t r a n t s ø y ð l ø yː k ʏ r
veigra	v e i ɣ r a
krónprins	kʰ r o u n pʰ r ɪ n s
geil	c e iː l
blika	p l ɪː k a
rafgeymir	r a v c e iː m ɪ r
blanda	p l a n t a
meitill	m e iː t ɪ t l
eiturlyf	e iː t ʏ r l ɪː v
morgunkorn	m ɔ r k ʏ n kʰ ɔ r t n
brydda	p r ɪ tː a
tívar	tʰ iː v a r
vináttuleikur	v ɪː n a u h t ʏ l e iː k ʏ r
tölvuleikur	tʰ œ l v ʏ l e iː k ʏ r
ólafína	o uː l aː v iː n a
hraun	r̥ ø yː n
íspinni	iː s pʰ ɪ nː ɪ
hæsi	h a iː s ɪ
digur	t ɪː ɣ ʏ r
leifar	l e iː v a r
tuska	tʰ ʏ s k a
hámundur	h a uː m ʏ n t ʏ r
jódís	j o uː t iː s
hefja	h ɛ v j a
blý	p l iː
virða	v ɪ r ð a
undarlega	ʏ n t a r l ɛː ɣ a
púrtvín	pʰ u r̥ t v iː n
þegja	θ e iː j a
markspyrna	m a r̥ k s p ɪ r t n a
aðferðafræði	a ð f ɛ r ð a f r a iː ð ɪ
gauti	k ø yː t ɪ
aumingi	ø yː m i ɲ c ɪ
eistland	e i s t l a n t
beltisdýr	p ɛ l̥ t ɪ s t iː r
holdvotur	h ɔ l t v ɔː t ʏ r
mínúta	m iː n uː t a
rosti	r ɔ s t ɪ
málning	m a u l n i ŋ k
gjósa	c o uː s a
hauskúpa	h ø yː s kʰ uː p a
mistilteinn	m ɪ s t ɪ l tʰ e i t n
flæmskur	f l a i m s k ʏ r
dufl	t ʏ p l
duld	t ʏ l t
lotukerfi	l ɔː t ʏ cʰ ɛ r v ɪ
gluggakarmur	k l ʏ kː a kʰ a r m ʏ r
ljóðlist	l j o u ð l ɪ s t
sjöfn	s j œ p n
æla	a iː l a
þunglamalegur	θ u ŋ k l aː m a l ɛː ɣ ʏ r
miðstig	m ɪ ð s t ɪː ɣ
heiti	h e iː t ɪ
kúnni	kʰ u nː ɪ
framræsla	f r a m r a i s t l a
felling	f ɛ t l i ŋ k
niðurlægjandi	n ɪː ð ʏ r l a iː j a n t ɪ
hafur	h aː v ʏ r
kæsa	cʰ a iː s a
fortíð	f ɔ r̥ tʰ iː ð
ellefu	ɛ t l ɛ v ʏ
reður	r ɛː ð ʏ r
flikki	f l ɪ h c ɪ
drjúgur	t r j uː ʏ r
hnussa	n̥ ʏ sː a
fölvi	f œ l v ɪ
heill	h e i t l
berja	p ɛ r j a
hlaði	l̥ aː ð ɪ
drangi	t r a u ɲ c ɪ
dægurlag	t a iː ɣ ʏ r l aː ɣ
fjarverufall	f j a r v ɛː r ʏ f a t l
korpa	kʰ ɔ r̥ p a
beygingardæmi	p e iː j i ŋ k a r t a iː m ɪ
bringubein	p r i ŋ k ʏ p e iː n
brú	p r uː
bikar	p ɪː k a r
þrisvar	θ r ɪː s v aː r
hugsun	h ʏ k s ʏ n
samfundur	s a m f ʏ n t ʏ r
olsen	o u l s ɛ nː
eta	ɛː t a
munnvatn	m ʏ nː v a h t n
blautur	p l ø yː t ʏ r
goti	k ɔː t ɪ
kantur	kʰ a n̥ t ʏ r
níska	n i s k a
laski	l a s c ɪ
svívirða	s v iː v ɪ r ð a
massi	m a sː ɪ
bekkjarfélagi	p ɛ h c a r f j ɛː l aː j ɪ
herra	h ɛ rː a
bátur	p a uː t ʏ r
scheving	s c ɛː v i ŋ
látbragðsleikur	l a uː t p r a ɣ ð s l e iː k ʏ r
skæni	s c a iː n ɪ
bót	p o uː t
stríð	s t r iː ð
hátign	h a uː tʰ ɪ k n
lunderni	l ʏ n t ɛ r t n ɪ
sexa	s ɛ k s a
biðukolla	p ɪː ð ʏ kʰ ɔ t l a
partí	pʰ a r̥ t i
hnúðkál	n̥ u ð kʰ a uː l
fulltrúi	f ʏ t l̥ tʰ r uː ɪ
pöntun	pʰ œ n̥ t ʏ n
panda	pʰ a n t a
lyfta	l ɪ f t a
hýsill	h iː s ɪ t l
þrasa	θ r aː s a
gaur	k ø yː r
tæki	tʰ a iː c ɪ
lystarstol	l ɪ s t a r s t ɔː l
her	h ɛː r
roðna	r ɔ ð n a
ísrael	iː s r aː ɛː l
slarkfær	s t l a r̥ k f a iː r
snjall	s t n j a t l
eplabaka	ɛ h p l a p aː k a
nýta	n iː t a
hótel	h o uː t ɛ l
merkúr	m ɛ r̥ kʰ uː r
skíða	s c iː ð a
es	ɛː s
hlemmur	l̥ ɛ mː ʏ r
pokabjörn	pʰ ɔː k a p j œ r t n
hyrnd	h ɪ r n t
fenómen	f ɛː n o uː m ɛː n
lækjasef	l a iː c a s ɛː v
ertni	ɛ r̥ t n ɪ
ull	ʏ lː
legkaka	l ɛ ɣ kʰ aː k a
nói	n o uː ɪ
geð	c ɛː ð
snilld	s t n ɪ l t
móðga	m o u ð k a
óttast	o u h t a s t
spöng	s p ø y ŋ k
mári	m a uː r ɪ
velta	v ɛ l̥ t a
ediksýra	ɛː t ɪ k s iː r a
félagshyggja	f j ɛː l a x s h ɪ cː a
stampur	s t a m̥ p ʏ r
mýrastör	m iː r a s t œː r
kenjóttur	cʰ ɛ n j o u h t ʏ r
hrís	r̥ iː s
víma	v iː m a
dvöl	t v œː l
mosaburkni	m ɔː s a p ʏ r̥ k n ɪ
skeið	s c e iː ð
lest	l ɛ s t
skunkur	s k u ŋ̊ k ʏ r
sýn	s iː n
vetni	v ɛ h t n ɪ
kvöld	kʰ v œ l t
ferjumaður	f ɛ r j ʏ m aː ð ʏ r
yfirlit	ɪː v ɪ r l ɪː t
garðyrkja	k a r ð ɪ r̥ c a
vögguvísa	v œ kː ʏ v iː s a
kaffibrauð	kʰ a fː ɪ p r ø yː ð
leyfi	l e iː v ɪ
mesópótamía	m ɛː s o uː pʰ o uː t a m iː j a
varta	v a r̥ t a
rápa	r a uː p a
fótur	f o uː t ʏ r
tapa	tʰ aː p a
leynd	l e i n t
kviða	kʰ v ɪː ð a
dugleysi	t ʏ ɣ l e iː s ɪ
vasatölva	v aː s a tʰ œ l v a
gangráður	k a u ŋ k r a uː ð ʏ r
nema	n ɛː m a
loki	l ɔː c ɪ
bassi	p a sː ɪ
mýrelfting	m iː r ɛ l̥ʷ t i ŋ k
gisti	c ɪ s t ɪ
gallalaus	k a t l a l ø yː s
uxi	ʏ k s ɪ
hræll	r̥ a i t l
skorpa	s k ɔ r̥ p a
hylla	h ɪ t l a
já	j a uː
geimskip	c e i m s c ɪː p
hreinsun	r̥ e i n s ʏ n
skriðuhnoðri	s k r ɪː ð ʏ n̥ ɔ ð r ɪ
stulta	s t ʏ l̥ t a
minn	m ɪ nː
greifingi	k r e iː v i ɲ c ɪ
áhöfn	a uː h œ p n
öryggisráð	œː r ɪ cː ɪ s r a uː ð
höfuðbúnaður	h œː v ʏ ð p uː n aː ð ʏ r
fjöltyngdur	f j œ l tʰ i ŋ t ʏ r
listmálari	l ɪ s t m a uː l a r ɪ
björgvin	p j œ r k v ɪ n
smali	s m aː l ɪ
stjarfi	s t j a r v ɪ
þari	θ aː r ɪ
nágranni	n a uː k r a nː ɪ
servíetta	s ɛ r v iː j ɛ h t a
kvíga	kʰ v iː ɣ a
tía	tʰ iː j a
slys	s t l ɪː s
umferð	ʏ m f ɛ r ð
sag	s aː ɣ
traktor	tʰ r a x t ɔ r
dans	t a n s
hlaðborð	l̥ a ð p ɔ r ð
reiðufé	r e iː ð ʏ f j ɛː
samþykkt	s a m θ ɪ x t
kristinn	kʰ r ɪ s t ɪ nː
sirkon	s ɪ r̥ k ɔː n
vaskur	v a s k ʏ r
útgáfa	uː t k a uː v a
nauða	n ø yː ð a
títra	tʰ iː t r a
stæði	s t a iː ð ɪ
veikleiki	v e iː k l e iː c ɪ
mannorð	m a nː ɔ r ð
farmur	f a r m ʏ r
kvabb	kʰ v a pː
tæma	tʰ a iː m a
hreindís	r̥ e i n t iː s
hnykkur	n̥ ɪ h k ʏ r
álftalaukur	a u l̥ t a l ø yː k ʏ r
skak	s k aː k
var	v aː r
jafna	j a p n a
sótt	s o u h t
litarefni	l ɪː t a r ɛ p n ɪ
bær	p a iː r
fiðrildi	f ɪ ð r ɪ l t ɪ
golf	k ɔ l v
hvalstöð	kʰ v a l s t œː ð
ró	r o uː
hefla	h ɛ p l a
síróp	s iː r o uː p
bæsa	p a iː s a
ritari	r ɪː t a r ɪ
leysibóla	l e iː s ɪ p o uː l a
gelda	c ɛ l t a
þolfall	θ ɔ l f a t l
útskýra	uː t s c iː r a
þing	θ i ŋ k
innræting	ɪ nː r a iː t i ŋ k
kræklingur	kʰ r a i h k l i ŋ k ʏ r
kanna	kʰ a nː a
smiðja	s m ɪ ð j a
skjól	s c o uː l
kvika	kʰ v ɪː k a
spánarkerfill	s p a uː n a r cʰ ɛ r v ɪ t l
sjóari	s j o uː aː r ɪ
glyrna	k l ɪ r t n a
jötunn	j œː tʰ ʏ nː
flórída	f l o uː r i t a
ending	ɛ n t i ŋ k
búretta	p uː r ɛ h t a
andri	a n t r ɪ
sjóveiki	s j o uː v e iː c ɪ
eplatré	ɛ h p l a t r j ɛː
ölkelduvatn	œ l cʰ ɛ l t ʏ v a h t n
sólon	s o uː l ɔ n
hávaðamaður	h a uː v aː ð a m aː ð ʏ r
ábóti	a uː p o uː t ɪ
smyrsl	s m ɪ r̥ s t l
mattur	m a h t ʏ r
hedda	h ɛ tː a
kvaran	kʰ v aː r a n
breti	p r ɛː t ɪ
míga	m iː ɣ a
ofan	ɔː v a n
frelsingi	f r ɛ l s i ɲ c ɪ
stefnuljós	s t ɛ p n ʏ l j o uː s
heildun	h e i l t ʏ n
vegir	v eː j i r
vernda	v ɛ r n t a
hálfnótuþögn	h a u l v n o uː t ʏ θ œ k n
notandi	n ɔː t a n t ɪ
afmæli	a v m a iː l ɪ
grænkál	k r a i n kʰ a uː l
klökkur	kʰ l œ h k ʏ r
snotur	s t n ɔː t ʏ r
þaðan	θ aː ð a n
tág	tʰ a uː
árni	a u r t n ɪ
tríósónata	tʰ r iː j o uː s o uː n aː t a
nýyrðasmíð	n iː ɪ r ð a s m iː ð
poka	pʰ ɔː k a
ritill	r ɪː t ɪ t l
heilaþvottur	h e iː l a θ v ɔ h t ʏ r
burnirót	p ʏ r t n ɪ r o uː t
einbjörg	e i n p j œ r k
náttúrulegur	n a u h t uː r ʏ l ɛ ɣ ʏ r
díli	t iː l ɪ
bráður	p r a uː ð ʏ r
innflytjandi	ɪ nː f l ɪː t j a n t ɪ
undrun	ʏ n t r ʏ n
bíldrusla	p i l t r ʏ s t l a
nýfæddur	n iː f a i tː ʏ r
ufsi	ʏ f s ɪ
nemi	n ɛː m ɪ
skurðstofa	s k ʏ r ð s t ɔː v a
diskó	t ɪ s k o uː
hattari	h a h t aː r ɪ
hnéskel	n̥ j ɛː s c ɛː l
organisti	ɔ r k a n ɪ s t ɪ
finnbogi	f ɪ n p ɔ j ɪ
ljón	l j o uː n
gedda	k ɛ tː a
smala	s m aː l a
fall	f a t l
stjórna	s t j o u r t n a
vínber	v i n p ɛː r
staðaratviksorð	s t aː ð a r aː t v ɪ k s ɔ r ð
þýðing	θ iː ð i ŋ k
verndun	v ɛ r n t ʏ n
frétt	f r j ɛ h t
stígur	s t iː ɣ ʏ r
slarkfenginn	s t l a r̥ k f e i ŋ k ɪ nː
liggja	l ɪ cː a
nothæfur	n ɔː t h a iː v ʏ r
dúkkuhús	t u h k ʏ h uː s
pönnukaka	pʰ œ nː ʏ kʰ aː k a
þágufall	θ a uː ʏ f a t l
sverfa	s v ɛ r v a
þeytari	θ e iː t a r ɪ
herfugl	h ɛː r f ʏ k l
armband	a r m p a n t
gá	k a uː
sekt	s ɛ x t
mjólka	m j o u l̥ k a
augntönn	ø y k n tʰ œ nː
kennaratyggjó	cʰ ɛ nː aː r a tʰ ɪ cː o uː
jarðsvín	j a r ð s v iː n
hreysi	r̥ e iː s ɪ
gró	k r o uː
hegri	h ɛ ɣ r ɪ
ýla	iː l a
orða	ɔ r ð a
veiðimaður	v e iː ð ɪ m aː ð ʏ r
for	f ɔː r
kvísl	kʰ v i s t l
kópur	kʰ o uː p ʏ r
geimfar	c e i m f aː r
gála	k a uː l a
ölva	œ l v a
gagnrýni	k a k n r iː n ɪ
blómkál	p l o u m kʰ a uː l
kinn	cʰ ɪ nː
mynda	m ɪ n t a
steinunn	s t e iː n ʏ nː
kennarasleikja	cʰ ɛ nː a r a s t l e iː c a
gagga	k a kː a
nös	n œː s
plógur	pʰ l o uː ʏ r
brennsla	p r ɛ n s t l a
jarðarber	j a r ð a r p ɛː r
fjallafinka	f j a t l a f i ŋ̊ k a
svínakjöt	s v iː n a cʰ œː t
hrekkja	r̥ ɛ h c a
boltaíþrótt	p ɔ l̥ t a iː θ r o u h t
margrét	m a r k r j ɛː t
byggja	p ɪ cː a
framkvæmd	f r a m kʰ v a i m t
þrældómur	θ r a i l t o uː m ʏ r
menning	m ɛ nː i ŋ k
hinn	h ɪ nː
umdæmi	ʏ m t a iː m ɪ
eðlilegur	ɛ ð l ɪ l ɛː ɣ ʏ r
sulta	s ʏ l̥ t a
kantmaður	kʰ a n̥ t m aː ð ʏ r
aðaltré	aː ð a l tʰ r j ɛː
hjalt	ç a l̥ t
petrína	p ɛː t r iː n a
fyrirgangur	f ɪː r ɪ r k a u ŋ k ʏ r
þukla	θ ʏ h k l a
tækisfall	t a iː k ɪ s f a t l
falur	f aː l ʏ r
kambur	kʰ a m p ʏ r
gervigras	c ɛ r v ɪ k r aː s
hnésbót	n̥ j ɛː s p o uː t
blunda	p l ʏ n t a
einstefnugata	e i n s t ɛ p n ʏ k aː t a
krossfari	kʰ r ɔ sː f aː r ɪ
risna	r ɪ s t n a
spýja	s p iː j a
dý	t iː
skelkur	s c ɛ l̥ k ʏ r
vetrarbraut	v ɛː t r a r p r ø yː t
tignarlegur	tʰ ɪ k n a r l ɛː ɣ ʏ r
korr	kʰ ɔ rː
eyland	e iː l a n t
húð	h uː ð
skála	s k a uː l a
kaffihús	kʰ a fː ɪ h uː s
notkun	n ɔː t k ʏ n
kok	kʰ ɔː k
saltsýra	s a l̥ t s iː r a
málmblanda	m a u l m p l a n t a
blússa	p l u sː a
misjafn	m ɪː s j a p n
alexander	aː l ɛ k s a n t ɛː r
bjóða	p j o uː ð a
tæra	tʰ a iː r a
aron	aː r ɔː n
steri	s t ɛː r ɪ
óreiða	o uː r e iː ð a
sortulyng	s ɔ r̥ t ʏ l i ŋ k
tær	tʰ a iː r
skolli	s k ɔ t l ɪ
kössóttur	kʰ œ sː o u h t ʏ r
saxland	s a x s l a n t
flass	f l a sː
buxnadragt	p ʏ x s n a t r a x t
gildi	c ɪ l t ɪ
stirfinn	s t ɪ r v ɪ nː
mögur	m œː ɣ ʏ r
synja	s ɪ n j a
úrferðarfall	u r̥ f ɛ r ð a r f a t l
bilun	p ɪː l ʏ n
pardus	pʰ a r t ʏ s
bryðja	p r ɪ ð j a
spá	s p a uː
fótasár	f o uː t a s a uː r
smurostur	s m ʏː r ɔ s t ʏ r
stell	s t ɛ t l
visk	v ɪ s k
gera	c ɛː r a
léttvatn	l j ɛ h t v a h t n
regnþykkni	r ɛ k n θ ɪ h k n ɪ
flærð	f l a i r ð
þannig	θ a nː ɪ ɣ
glitfífill	k l ɪː t f iː v ɪ t l
fjöldamorðingi	f j œ l t a m ɔ r ð i ŋ c ɪ
stimpill	s t ɪ m̥ p ɪ t l
járn	j a u t n
ruggustóll	r ʏ kː ʏ s t o u t l
leðja	l ɛ ð j a
veggur	v ɛ kː ʏ r
gumi	k ʏː m ɪ
hlymja	l̥ ɪ m j a
helvíti	h ɛ l v iː t ɪ
enginn	e i ŋ c ɪ nː
kýr	cʰ iː r
tíð	tʰ iː ð
aðalból	aː ð a l p o uː l
ket	cʰ ɛː t
rengla	r e i ŋ l a
nefnari	n ɛ p n aː r ɪ
tafla	tʰ a p l a
lauslæti	l ø yː s l a iː t ɪ
síld	s i l t
uppspuni	ʏ h p s p ʏː n ɪ
þrítyngdur	θ r iː tʰ i ŋ t ʏ r
heimskautsnótt	h e i m s k ø y t s n o u h t
lárus	l a uː r ʏ s
jarlsfrú	j a r t l s f r uː
gæruskinn	c a iː r ʏ s c ɪ nː
auka	ø yː k a
japanska	j aː pʰ a n s k a
vafagepill	v aː v a c ɛː p ɪ t l
hnoða	n̥ ɔː ð a
gáfa	k a uː v a
röskun	r œ s k ʏ n
hvítur	xʷ iː t ʏ r
sonardóttir	s ɔː n a r t o u h t ɪ r
dagsetning	t a x s ɛ h t n i ŋ k
bursta	p ʏ r̥ s t a
bakpoki	p aː k pʰ ɔː c ɪ
saltaður	s a l̥ t aː ð ʏ r
björk	p j œ r̥ k
rím	r iː m
flyksa	f l ɪ k s a
firring	f ɪ rː i ŋ k
elri	ɛ l r ɪ
axlabönd	a x s t l a p œ n t
klókur	kʰ l o uː k ʏ r
langa	l a u ŋ k a
eitilfruma	e iː t ɪ l f r ʏː m a
feykja	f e iː c a
járnsmiður	j a u r t n s m ɪː ð ʏ r
skíta	s c iː t a
hveitikím	kʰ v e iː t ɪ kʰ iː m
tágamura	tʰ a uː ɣ a m ʏː r a
óaðlaðandi	o uː a ð l aː ð a n t ɪ
samhengi	s a m h e i ɲ c ɪ
stórhertogi	s t o uː r h ɛ r̥ tʰ ɔ j ɪ
linditré	l ɪ n t ɪ tʰ r j ɛː
lífhimna	l i v h ɪ m n a
hefndarþorsti	h ɛ m t a r θ ɔ r̥ s t ɪ
valtýr	v a l tʰ iː r
hringur	r̥ i ŋ k ʏ r
kasheitur	k aː s h e iː t ʏ r
löggjafarvald	l œ ɣ c aː v a r v a l t
meistari	m e i s t aː r ɪ
borðtölva	p ɔ r ð tʰ œ l v a
ökutæki	œː k ʏ tʰ a iː c ɪ
ax	a k s
systursonur	s ɪ s t ʏ r̥ s ɔː n ʏ r
áróður	a uː r o uː ð ʏ r
bæra	p a iː r a
kápa	kʰ a uː p a
safír	s aː f iː r
spánverji	s p a u n v ɛ r j ɪ
hætta	h a i h t a
fyðill	f ɪː ð ɪ t l
vilja	v ɪ l j a
vinátta	v ɪː n a u h t a
fylgirit	f ɪ l c ɪ r ɪː t
þylja	θ ɪ l j a
bæta	p a iː t a
turn	tʰ ʏ r t n
indland	ɪ n t l a n t
fótleggur	f o uː t l ɛ kː ʏ r
þorvarðína	θ ɔ r v a r ð iː n a
sardinía	s a r t ɪ n iː j a
staur	s t ø yː r
friðmundur	f r ɪ ð m ʏ n t ʏ r
titrari	tʰ ɪː t r a r ɪ
kvaðratrót	kʰ v a ð r aː t r o uː t
úrvinnsla	u r v ɪ n s t l a
framrúða	f r a m r uː ð a
erítreskur	ɛː r iː tʰ r ɛ s k ʏ r
mannfræði	m a nː f r a iː ð ɪ
skammur	s k a mː ʏ r
garðasól	k a r ð a s o uː l
efna	ɛ p n a
heppni	h ɛ h p n ɪ
fljóð	f l j o uː ð
tregur	tʰ r ɛː ɣ ʏ r
sýnn	s i t n
hjálparsögn	ç a u l̥ p a r s œ k n
þumbari	θ ʏ m p a r ɪ
samfélag	s a m f j ɛː l aː ɣ
alvitur	a l v ɪː t ʏ r
hornafræði	h ɔ r t n a f r a iː ð ɪ
nafna	n a p n a
viðskeyti	v ɪ ð s c e iː t ɪ
ljóðskáld	l j o u ð s k a u l t
kaðall	kʰ aː ð a t l
stytta	s t ɪ h t a
neitun	n e iː t ʏ n
gljúfra	k l̥ j u v r a
hlið	l̥ ɪː ð
opna	ɔ h p n a
lungnakrabbamein	l u ŋ k n a kʰ r a pː a m e iː n
tigna	tʰ ɪ k n a
ánægður	a uː n a i ɣ ð ʏ r
þybbinn	θ ɪ pː ɪ nː
grassnákur	k r aː s s n a uː k ʏ r
sýking	s iː c i ŋ k
forlát	f ɔ r l a uː t
kæfa	cʰ a iː v a
eldiviður	ɛ l t ɪ v ɪː ð ʏ r
eingöngu	e i n k ø y ŋ k ʏ
leví	l ɛː v iː
eðla	ɛ ð l a
gimsteinn	c ɪ m s t e i t n
hefti	h ɛ f t ɪ
fluga	f l ʏː ɣ a
gætni	c a i h t n ɪ
balsamedik	p a l s aː m ɛː t i k
rokkur	r ɔ h k ʏ r
hjördís	ç œ r t iː s
okkar	ɔ h k ɐ r
metorð	m ɛː t ɔ r ð
egg	ɛ kː
selma	s ɛ l m a
duggönd	t ʏ kː œ n t
gustuk	k ʏ s t ʏ k
umkringja	ʏ m kʰ r i ɲ c a
ísis	iː s ɪ s
héðan	ç ɛː ð a n
rangla	r a u ŋ l a
rögnvaldína	r œ k n v a l t iː n a
jörgensen	j œ r k ɛ n s ɛː nː
reikistjarna	r e iː c ɪ s t j a r t n a
vætla	v a i h t l a
fréttastofa	f r j ɛ h t a s t ɔː v a
velkomandaminni	v ɛ l kʰ ɔː m a n t a m ɪ nː ɪ
lóga	l o uː a
skyssa	s c ɪ sː a
hrísgrjónavín	r̥ iː s k r j o uː n a v iː n
hólmganga	h o u l m k a u ŋ k a
sápa	s a uː p a
hreyfa	r̥ e iː v a
dádýr	t a uː t iː r
orðtak	ɔ r ð tʰ aː k
ergja	ɛ r c a
örgjörvi	œ r c œ r v ɪ
fælast	f a iː l a s t
spænskur	s p a i n s k ʏ r
smæra	s m a iː r a
jarðskjálfti	j a r ð s c a u l̥ t ɪ
fræði	f r a iː ð ɪ
næla	n a iː l a
drjúpa	t r j uː p a
borði	b ɔ r ð ɪ
sverrína	s v ɛ rː iː n a
kanill	kʰ aː n ɪ t l
þar	θ aː r
júgur	j uː ʏ r
eldpipar	ɛ l t p ɪː p a r
páskavika	pʰ a u s k a v ɪː k a
föggur	f œ kː ʏ r
grynna	k r ɪ nː a
umsókn	ʏ m s o u h k n
alin	aː l ɪ n
aðalkirkja	aː ð a l cʰ ɪ r̥ c a
hamla	h a m l a
ferilskrá	f ɛː r ɪ l s k r a uː
buna	p ʏː n a
skrúðganga	s k r u ð k a u ŋ k a
móða	m o uː ð a
hvatning	kʰ v a h t n i ŋ k
punda	pʰ ʏ n t a
kjölfar	cʰ œ l f aː r
ríkja	r iː c a
buxnavasi	p ʏ k s n a v aː s ɪ
jósefína	j o uː s ɛː f iː n a
skjóða	s c o uː ð a
erfa	ɛ r v a
lærleggur	l a i r l ɛ kː ʏ r
sýkill	s iː c ɪ t l
styrja	s t ɪ r j a
eipa	e iː p a
reipi	r e iː p ɪ
ríkisborgari	r iː c ɪ s p ɔ r k a r ɪ
sekta	s ɛ x t a
hegðun	h ɛ ɣ ð ʏ n
anddyri	a n t t ɪː r ɪ
mold	m ɔ l t
geislamaðra	c e i s t l a m a ð r a
þurrka	θ ʏ r̥ k a
vanalega	v aː n a l ɛː ɣ a
soð	s ɔː ð
legging	l ɛ cː i ŋ k
granatepli	k r aː n aː t ɛ h p l ɪ
hvelatengsl	xʷ ɛː l a tʰ e i ŋ s t l
bókaútgáfa	p o uː k a uː t k a uː v a
salt	s a l̥ t
tara	tʰ aː r a
feluleikur	f ɛː l ʏ l e iː k ʏ r
harma	h a r m a
tísta	tʰ i s t a
sinnuma	s ɪ nː ʏ m a
mosalyng	m ɔː s a l i ŋ k
bílaleiga	p iː l a l e iː ɣ a
árna	a u r t n a
öskur	œ s k ʏ r
systir	s ɪ s t ɪ r
evklíðskur	ɛ v kʰ l i ð s k ʏ r
arður	a r ð ʏ r
fölna	f œ l n a
dólgur	t o u l k ʏ r
rýr	r iː r
fjórðungur	f j o u r ð u ŋ k ʏ r
jaxl	j a k s t l
brók	p r o uː k
niðji	n ɪ ð j ɪ
fjarvera	f j a r v ɛː r a
glerungur	k l ɛː r u ŋ k ʏ r
hrópa	r̥ o uː p a
aðaltenging	aː ð a l tʰ e i ɲ c i ŋ k
kringja	kʰ r i ɲ c a
stjórnvölur	s t j o u r t n v œː l ʏ r
greypa	k r e iː p a
gervigígur	c ɛ r v ɪ c iː ɣ ʏ r
soldill	s ɔ l t ɪ t l
könguló	kʰ ø y ŋ k ʏ l o uː
vafsúra	v a v s uː r a
hagl	h a k l
grameðla	k r aː m ɛ ð l a
margföldun	m a r k f œ l t ʏ n
mylla	m ɪ lː a
vasaþjófur	v aː s a θ j o uː v ʏ r
aðalatriði	aː ð a l aː t r ɪː ð ɪ
djarfur	t j a r v ʏ r
bogi	p ɔː j ɪ
mæri	m a iː r ɪ
ruddalegur	r ʏ tː a l ɛː ɣ ʏ r
sérhljóð	s j ɛː r l̥ j o uː ð
villtur	v ɪ l̥ t ʏ r
gubba	k ʏ pː a
frónskur	f r o u n s k ʏ r
spinna	s p ɪ nː a
kjúka	cʰ uː k a
bylja	p ɪ l j a
álft	a u l f t
önd	œ n t
fita	f ɪː t a
hrafn	r̥ a p n
amerískur	aː m ɛː r i s k ʏ r
hárgreiðsla	h a u r k r e i ð s t l a
aþeningur	aː θ ɛː n i ŋ k ʏ r
hátterni	h a u h t ɛ r t n ɪ
brottfall	p r ɔ h t f a t l
öryggisbelti	œː r ɪ cː ɪ s p ɛ l̥ t ɪ
köngull	kʰ ø y ŋ k ʏ t l
sporðdreki	s p ɔ r ð t r ɛː c ɪ
söðull	s œː ð ʏ t l
málvísindi	m a u l v iː s ɪ n t ɪ
hunangsfluga	h ʏː n a u ŋ k s f l ʏː ɣ a
folald	f ɔː l a l t
prakt	pʰ r a x t
forskeyti	f ɔ r̥ s c e iː t ɪ
argur	a r k ʏ r
kvikur	kʰ v ɪː k ʏ r
filma	f ɪ l m a
talsmaður	tʰ a l s m aː ð ʏ r
við	v ɪ ð
haus	h ø yː s
föndur	f œ n t ʏ r
hægðatregða	h a i ɣ ð a tʰ r ɛ ɣ ð a
gísl	c i s t l
asni	a s t n ɪ
sveppafræði	s v ɛ h p a f r a iː ð ɪ
liþín	l ɪː θ iː n
barón	p aː r o uː n
lunti	l ʏ n̥ t ɪ
ofbirta	ɔ v p ɪ r̥ t a
sif	s ɪː v
mótetta	m o uː tʰ ɛ h t a
stía	s t iː j a
bavíani	p aː v iː aː n ɪ
kúka	kʰ uː k a
höfn	h œ p n
almennilegur	a l m ɛ nː ɪ l ɛː ɣ ʏ r
án	a u n
grunnur	k r ʏ nː ʏ r
fógeti	f o uː c ɛː t ɪ
herramaður	h ɛ rː a m aː ð ʏ r
þúfa	θ uː v a
angi	a u ɲ c ɪ
fjallafura	f j a t l a f ʏː r a
bylting	p ɪ l̥ t i ŋ k
hvalaskoðun	kʰ v aː l a s k ɔː ð ʏ n
skilningur	s c ɪ l n i ŋ k ʏ r
hérna	ç ɛ r t n a
frænka	f r a i n k a
hneigja	n̥ e iː j a
held	h ɛ l t
erkiengill	ɛ r̥ c ɪ e i ɲ c ɪ t l
magi	m aː j ɪ
spurnarfornafn	s p ʏ r t n a r f ɔ r n a p n
máltækni	m a u l t a i h k n ɪ
sími	s iː m ɪ
tætla	tʰ a i h t l a
skriðlíngresi	s k r ɪ ð l i n k r ɛː s ɪ
okfruma	ɔː k f r ʏː m a
endurræsa	ɛ n t ʏ r r a iː s a
tregi	tʰ r e iː j ɪ
lugt	l ʏ x t
skilja	s c ɪ l j a
pipar	pʰ ɪː p a r
kjarkmikill	cʰ a r̥ k m ɪː c ɪ t l
fitna	f ɪ h t n a
hjakka	ç a h k a
tyrkneska	tʰ ɪ r̥ k n ɛ s k a
nýlega	n iː l ɛː ɣ a
friggjargras	f r ɪ cː a r k r aː s
teskeið	tʰ ɛː s k e iː ð
aðgát	a ð k a uː t
ásýnd	a uː s i n t
samhaldssamur	s a m h a l t s s aː m ʏ r
tal	tʰ aː l
hnellinn	n̥ ɛ lː ɪ nː
hrjóta	r̥ j o uː t a
hluttekning	l̥ ʏː t t ɛ h k n i ŋ k
hrímtittlingur	r̥ i m tʰ ɪ h t l i ŋ k ʏ r
snerta	s n ɛ r̥ t a
jóð	j o uː ð
gyðja	c ɪ ð j a
gúrkutíð	k u r̥ k ʏ tʰ iː ð
þrenningarmaðra	θ r ɛ nː i ŋ k a r m a ð r a
reynsla	r e i n s t l a
fundur	f ʏ n t ʏ r
norska	n ɔ r̥ s k a
láki	l a uː c ɪ
kristþyrnir	kʰ r ɪ s t θ ɪ r t n ɪ r
kyrrð	cʰ ɪ r ð
indverskur	ɪ n t v ɛ r̥ s k ʏ r
janúar	j aː n uː aː r
stoppa	s t ɔ h p a
hæra	h a iː r a
skárri	s k a u rː ɪ
bíta	p iː t a
munur	m ʏː n ʏ r
dónalega	t o uː n a l ɛː ɣ a
þóroddur	θ o uː r ɔ tː ʏ r
grunnendurlífgun	k r ʏ nː ɛ n t ʏ r l i v k ʏ n
nef	n ɛː v
bylur	p ɪː l ʏ r
þjóð	θ j o uː ð
dvali	t v aː l ɪ
alvöruleysi	a l v œː r ʏ l e iː s ɪ
nývirki	n iː v ɪ r̥ c ɪ
ferskjutré	f ɛ r̥ s c ʏ t r j ɛː
lýðnet	l i ð n ɛː t
hræra	r̥ a iː r a
glær	k l a iː r
frýgískur	f r iː c i s k ʏ r
flónska	f l o u n s k a
leysingi	l e iː s i ɲ c ɪ
blossi	p l ɔ sː ɪ
garðar	k a r ð a r
vodka	v ɔ t kʰ a
össuría	œ sː ʏ r iː j a
beikon	p e iː kʰ ɔ n
sjampó	s j a m̥ p o uː
ósannur	o uː s a nː ʏ r
borgari	p ɔ r k aː r ɪ
hrynja	r̥ ɪ n j a
vanilla	v aː n ɪ lː a
tossi	tʰ ɔ sː ɪ
grágæs	k r a uː c a iː s
tollur	tʰ ɔ t l ʏ r
ker	cʰ ɛː r
dagrenning	t a ɣ r ɛ nː i ŋ k
hártogun	h a u r̥ tʰ ɔː ɣ ʏ n
aragrúi	aː r a k r uː ɪ
handrið	h a n t r ɪː ð
sjár	s j a uː r
vín	v iː n
þröstur	θ r œ s t ʏ r
kári	kʰ a uː r ɪ
hugsjónamaður	h ʏ x s j o uː n a m aː ð ʏ r
tása	tʰ a uː s a
sjálfsfróun	s j a u l v s f r o uː ʏ n
kennslubók	cʰ ɛ n s t l ʏ p o uː k
rúrik	r uː r ɪ k
skógur	s k o uː ʏ r
kafli	kʰ a p l ɪ
gráta	k r a uː t a
ávarpsfall	a uː v a r̥ p s f a t l
hirðulaus	h ɪ r ð ʏ l ø yː s
metta	m ɛ h t a
skæri	s c a iː r ɪ
niðurskurður	n ɪː ð ʏ r s k ʏ r ð ʏ r
meddi	m ɛ tː ɪ
stína	s t iː n a
hanski	h a n s c ɪ
flæða	f l a iː ð a
númera	n uː m ɛː r a
aukasetning	ø yː k a s ɛ h t n i ŋ k
mæla	m a iː l a
stæra	s t a iː r a
basi	p aː s ɪ
vansi	v a n s ɪ
fuglafræði	f ʏ k l a f r a iː ð ɪ
berklar	p ɛ r̥ k l a r
sandstormur	s a n t s t ɔ r m ʏ r
blöðruselur	p l œ ð r ʏ s ɛː l ʏ r
efnahvarf	ɛ p n a kʰ v a r v
einsemd	e i n s ɛ m t
albanska	a l p a n s k a
baugfingur	p ø y x f i ŋ k ʏ r
barnæska	p a r t n a i s k a
afmælisdagur	a v m a iː l ɪ s t aː ɣ ʏ r
biðvarsla	p ɪ ð v a r s t l a
dreypa	t r e iː p a
hangikjöt	h a u ŋ c ɪ cʰ œː t
frændhygli	f r a i n t h ɪ k l ɪ
mildur	m ɪ l t ʏ r
ártíð	a uː r tʰ iː ð
saga	s aː ɣ a
prettur	pʰ r ɛ h t ʏ r
hindber	h ɪ n t p ɛː r
aukaspyrna	ø yː k a s p ɪ r t n a
testósterón	tʰ ɛ s t o uː s t ɛː r o uː n
banka	p a u ŋ̊ k a
áheyrn	a uː h e i r t n̥
unndór	ʏ n t o uː r
sækja	s a iː c a
mauka	m ø yː k a
holland	h ɔ l l a n t
virkur	v ɪ r̥ k ʏ r
gistihús	c ɪ s t ɪ h uː s
heimsmet	h e i m s m ɛː t
garðrækt	k a r ð r a i x t
silungur	s ɪː l u ŋ k ʏ r
ofvæni	ɔ v v a iː n ɪ
esóp	ɛː s o uː p
strangi	s t r a u ɲ c ɪ
grobba	k r ɔ pː a
minnisspil	m ɪ nː ɪ s s p ɪː l
vepja	v ɛː p j a
sís	s iː s
kussari	kʰ ʏ sː a r ɪ
astat	a s t aː t
klukkutími	kʰ l ʏ h k ʏ tʰ iː m ɪ
smokks	s m ɔ h k s
heiður	h e iː ð ʏ r
kökukefli	kʰ œː k ʏ cʰ ɛ p l ɪ
safna	s a p n a
fýla	f iː l a
hlýja	l̥ iː j a
helvískur	h ɛ l v i s k ʏ r
vitni	v ɪ h t n ɪ
línarfi	l iː n a r v ɪ
afbrot	a v p r ɔː t
hverfi	kʰ v ɛ r v ɪ
kragh	kʰ r aː ɣ
noregur	n ɔː r ɛː ɣ ʏ r
raftur	r a f t ʏ r
skeri	s c ɛː r ɪ
rani	r aː n ɪ
apalhraun	aː p a l r̥ ø yː n
fjarlægja	f j a r l a iː j a
görn	k œ r t n
vafi	v aː v ɪ
bremsa	p r ɛ m s a
bunga	p u ŋ k a
kelfa	cʰ ɛ l v a
naflagras	n a p l a k r aː s
ryksuga	r ɪ k s ʏː ɣ a
rustikus	r ʏ s t ɪ kʰ ʏ s
fela	f ɛː l a
einvaldur	e i n v a l t ʏ r
bitur	p ɪː t ʏ r
hvað	kʰ v aː ð
biskupsdæmi	p ɪ s k ʏ p s t a iː m ɪ
eiturlyfjasali	e iː t ʏ r l ɪ v j a s aː l ɪ
suddi	s ʏ tː ɪ
belgjastör	p ɛ l c a s t œː r
nasismi	n aː s ɪ s m ɪ
kastali	kʰ a s t aː l ɪ
rölt	r œ l̥ t
leifa	l e iː v a
ræðismannsbústaður	r a iː ð ɪ s m a n s p uː s t aː ð ʏ r
húsdýr	h uː s t iː r
miskunna	m ɪ s k ʏ nː a
pöbb	pʰ œ pː
víti	v iː t ɪ
útland	uː t l a n t
lifa	l ɪː v a
veila	v e iː l a
léttúð	l j ɛ h t uː ð
bílaflutningabíll	p iː l a f l ʏ h t n i ŋ k a p i t l
sykra	s ɪː k r a
núa	n uː a
dósent	t o uː s ɛ n t
loðfíll	l ɔ ð f i t l
krem	kʰ r ɛː m
þjófnaður	θ j o u p n aː ð ʏ r
matseðill	m aː t s ɛː ð ɪ t l
leysa	l e iː s a
pakki	pʰ a h c ɪ
síra	s iː r a
plóma	pʰ l o uː m a
arfi	a r v ɪ
hakk	h a h k
hjúkrunarkona	ç uː k r ʏ n a r kʰ ɔː n a
klarínetta	kʰ l aː r iː n ɛ h t a
mikki	m ɪ h c ɪ
eggleg	ɛ kː l ɛː ɣ
snemma	s n ɛ mː a
kös	kʰ œː s
dill	t ɪ lː
nágrenni	n a uː k r ɛ nː ɪ
hvorugkyn	xʷ ɔː r ʏ ɣ cʰ ɪː n
bilbugur	p ɪ l p ʏː ɣ ʏ r
marxískur	m a r̥ k s i s k ʏ r
tætari	tʰ a iː t aː r ɪ
óratóría	o uː r a tʰ o uː r iː j a
grúbba	k r u pː a
blóðappelsína	p l o uː ð a h pʰ ɛ l s i n a
tröllkona	tʰ r œ t l kʰ ɔː n a
horaður	h ɔː r a ð ʏ r
þorvaldína	θ ɔ r v a l t iː n a
lífrænn	l i v r a i t n
fúll	f u t l
stél	s t j ɛː l
fornafn	f ɔ r n a p n
greip	k r e iː p
þol	θ ɔː l
mynd	m ɪ n t
frímannía	f r iː m a nː iː j a
skemmta	s c ɛ m̥ t a
súr	s uː r
getnaður	c ɛ h t n aː ð ʏ r
brasilía	p r aː s ɪ l iː j a
bugur	p ʏː ɣ ʏ r
hnot	n̥ ɔː t
melur	m ɛː l ʏ r
dvergur	t v ɛ r k ʏ r
skjaldbaka	s c a l t p aː k a
einkenni	e i n cʰ ɛ nː ɪ
mætur	m a iː t ʏ r
hjörð	ç œ r ð
betlari	p ɛ h t l aː r ɪ
eldstæði	ɛ l t s t a iː ð ɪ
ekki	ɪ cː ɪ
vindmylla	v ɪ n t m ɪ lː a
lífljómun	l i v l j o uː m ʏ n
hjón	ç o uː n
dýrkun	t i r̥ k ʏ n
hlésey	l̥ j ɛː s e iː
samanburður	s aː m a n p ʏ r ð ʏ r
indriðína	ɪ n t r ɪː ð iː n a
afskráning	a f s k r a uː n i ŋ k
króna	kʰ r o u n a
upphaf	ʏ h p h aː v
formáli	f ɔ r m a uː l ɪ
andeind	a n t e i n t
kiðlingur	cʰ ɪ ð l i ŋ k ʏ r
kúpa	kʰ uː p a
paxblað	pʰ a x s p l aː ð
sléttur	s t l j ɛ h t ʏ r
hefta	h ɛ f t a
einasti	e iː n a s t ɪ
valmynd	v a l m ɪ n t
benediktína	p ɛː n ɛː t ɪ x t iː n a
erlendur	ɛ r l ɛ n t ʏ r
fjós	f j o uː s
bagi	p aː j ɪ
lömun	l œː m ʏ n
handavinna	h a n t a v ɪ nː a
slóvenía	s t l o uː v ɛː n iː j a
lygari	l ɪː ɣ aː r ɪ
hægð	h a i ɣ ð
hómófóbía	h o uː m o uː f o uː p iː j a
einar	e iː n a r
hugleysingi	h ʏ ɣ l e iː s i ɲ c ɪ
fangelsa	f a u ŋ c ɛ l s a
dagmál	t a ɣ m a uː l
samkynhneigð	s a m cʰ ɪ n n̥ e i ɣ ð
íhald	iː h a l t
þynna	θ ɪ nː a
snjóa	s n j o uː a
kanarífugl	kʰ aː n a r iː f ʏ k l
athöfn	aː t h œ p n
gæludýr	c a iː l ʏ t iː r
máltíð	m a u l tʰ iː ð
leikkona	l e iː k kʰ ɔː n a
tvístirni	tʰ v iː s t ɪ r t n ɪ
freri	f r ɛː r ɪ
met	m ɛː t
frjóþráður	f r j o uː θ r a uː ð ʏ r
nagladekk	n a k l a t ɛ h k
jarðarför	j a r ð a r f œː r
fjölkvæni	f j œ l kʰ v a iː n ɪ
fuglahræða	f ʏ k l a r̥ a iː ð a
sléttlendi	s t l j ɛ h t l ɛ n t ɪ
höfundur	h œː v ʏ n t ʏ r
né	n j ɛː
viftureim	v ɪ f t ʏ r e iː m
tiltekinn	tʰ ɪː l tʰ ɛː c ɪ nː
ætla	a i h t l a
fimmtudagur	f ɪ m̥ː tʰ ʏ t aː ɣ ʏ r
úti	uː t ɪ
íslam	iː s t l aː m
herðatré	h ɛ r ð a t r j ɛː
skorsteinn	s k ɔ r̥ s t e i t n
giska	c ɪ s k a
smá	s m a uː
sónötuform	s o uː n œː t ʏ f ɔ r m
styðja	s t ɪ ð j a
krónprinsessa	kʰ r o u n p r ɪ n s ɛ sː a
internet	ɪ n̥ t ɛ r n ɛː t
galdramaður	k a l t r a m aː ð ʏ r
mólýbden	m o uː l i p t ɛː n
djúp	t j uː p
þykkur	θ ɪ h k ʏ r
dótturdóttir	t o u h t ʏ r t o u h t ɪ r
mosasteinbrjótur	m ɔː s a s t e i n p r j o uː t ʏ r
kvoða	kʰ v ɔː ð a
kaldhæðni	kʰ a l t h a i ð n ɪ
þiðna	θ ɪ ð n a
þyrping	θ ɪ r̥ p i ŋ k
töluverður	tʰ œː l ʏ v ɛ r ð ʏ r
hobbiti	h ɔ pː ɪː t ɪ
stoða	s t ɔː ð a
perú	pʰ ɛː r uː
örlítill	œ r l iː t ɪ t l
eftirmáli	ɛ f t ɪ r m a uː l ɪ
slatti	s t l a h t ɪ
hvar	xʷ aː r
treysta	tʰ r e i s t a
gát	k a uː t
vafri	v a v r ɪ
hvati	kʰ v aː t ɪ
námsbraut	n a u m s p r ø yː t
sporvagn	s p ɔ r v a k n
sláttarstöðvun	s t l a u h t a r s t œ ð v ʏ n
blástur	p l a u s t ʏ r
blik	p l ɪː k
dreyma	t r e iː m a
plana	pʰ l aː n a
guðvaldína	k v ʏ ð v a l t iː n a
kontrabassi	kʰ ɔ n̥ t r a p a sː ɪ
guðspjallamaður	k v ʏ ð s p j a t l a m aː ð ʏ r
aðfaranótt	a ð f aː r a n o u h t
gráelri	k r a uː ɛ l r ɪ
ræll	r a i t l
þverra	θ v ɛ rː a
síða	s iː ð a
teningur	tʰ ɛː n i ŋ k ʏ r
rás	r a uː s
keppa	cʰ ɛ h p a
múrhúða	m uː r h uː ð a
sívalningur	s iː v a l n i ŋ k ʏ r
eyða	e iː ð a
grunur	k r ʏː n ʏ r
kolvetni	kʰ ɔ l v ɛ h t n ɪ
konráðína	kʰ ɔ n r a uː ð iː n a
beð	p ɛː ð
þukl	θ ʏ h k l
einkum	e i n̥ k ʏ m
nafnfræði	n a p n f r a iː ð ɪ
markúsartorg	m a r̥ k uː s a r tʰ ɔ r k
mark	m a r̥ k
heiladingull	h e iː l a t i ŋ k ʏ t l
sárasótt	s a uː r a s o u h t
spánska	s p a u n s k a
peð	pʰ ɛː ð
geirfugl	c e i r f ʏ k l
skeiðklukka	s c e i ð kʰ l ʏ h k a
klaufi	kʰ l ø yː v ɪ
jeppi	j ɛ h p ɪ
tauta	tʰ ø yː t a
hlér	l̥ j ɛː r
rúnar	r uː n aː r
orð	ɔ r ð
nostalgía	n ɔ s t a l c i j a
ásókn	a uː s o u h k n
langbarðaland	l a u ŋ k p a r ð a l a n t
strita	s t r ɪː t a
lagður	l a ɣ ð ʏ r
hórus	h o uː r ʏ s
portúgali	pʰ ɔ r̥ t u k aː l ɪ
valhnappur	v a l n̥ a h p ʏ r
arabískur	aː r a p i s k ʏ r
morthens	m ɔ r̥ t ɛ n s
saddur	s a tː ʏ r
bygg	p ɪ kː
akkeri	a h k ɛː r ɪ
