пэшын	p a ʃ ə n
загъорэ	z aː ʁʷ a r a
хьакӏэ	ħ aː t͡ʃ a
игъу	j ə ʁʷ a
зэщын	z a ɕ ə n
чӏыопс	t͡ʃ ə w a p s
зэгочын	z a ɡʷ a t͡ʃ ə n
мэбыбын	m a b ə b ə n
нэкӏы	n a t͡ʃ ʼ ə
ныбэ	n ə b a
къэбы	q a b ə
бжьыныуц	b ʑ ə n ə w t s
ушхъухьан	w ə ʃ χʷ ħ aː n
абэуйэй	a b a w j a j
мэстын	m a s t ə n
тхы	t x ə
жьыгъэбыу	ʑ ə ʁ a b ə w
опсэу	w a p s a w
гъэхъон	ʁ a χʷ a n
цӏы	t͡s ʼ ə
тхэхьын	t x a ħ ə n
мэкӏодын	m a kʷ ʼ a d ə n
дыухьэ	d ə w ħ a
енэсӏын	j a n a s ʼ ə n
тифэхьын	t i f a ħ ə n
бжыдзэгъалӏэ	b ʒ ə d͡z a ʁ aː ɬˤ ʼ a
кӏэлэхъу	t͡ʃ ʼ a ɮ a χʷ
хъохъу	ɡʷ ə ʃʷ ʼ aː ʁʷ a
мэбзэин	m a b z a j ə n
тегъэкӏэн	t a j ʁ a t͡ʃ ʼ a n
шхъогъон	ʃ χʷ a ʁʷ a n
къокъон	qʷ a qʷ a n
гъэкьэрэгъун	ʁ a k a r a ʁʷ ə n
ипашъхьэ	j ə p aː ʂ ħ a
ышъхьагъ	ə ʂ ħ aː ʁ
зэхэутын	z a x a w t ə n
мышкӏу	m ə ʃ kʷ
мыжъуакӏэ	m ə ʐʷ aː t͡ʃ a
чъэкӏыгъэ	t͡ʂ a t͡ʃ ʼ ə ʁ a
гъэчэн	ʁ a t͡ʃ a n
мэцӏэшъутэн	m a t͡s ʼ a ʃʷ t a n
жэкӏагъу	ʒ a t͡ʃ aː ʁʷ
гъэсэкӏэн	ʁ a s a t͡ʃ ʼ a n
кӏэджэн	t͡ʃ ʼ a d͡ʒ a n
тӏупщын	tʷ ʼ ə p ɕ ə n
жэдэон	ʒ a d a w a n
бжьэхъон	b ʑ a χʷ a n
унагъобзэ	w ə n aː ʁʷ a b z a
плэлэжъ	p lˠ a lˠ a ʐ
куцэ	kʷ ə t͡s a
чэфы	t͡ʃ a f ə
къэщэгъу	q a ɕ a ʁʷ
ӏукӏьыбзэ	ʔʷ ə kʲ ʼ ə b z a
ахъщапс	aː χ ʃ aː p s
шӏэпэн	ə ʃ ʼ a p a n
гъэлӏэн	ʁ a ɬ ʼ a n
лъэрычъ	ɬ a r ə t͡ʂ
ӏофшӏэгъу	ʔʷ a f ʃ ʼ a ʁʷ
ӏэмал	ʔ a m aː l
щыӏэцӏэ	ɕ ə ʔ a t͡s ʼ a
унагъоцӏэ	w n aː ʁʷ a t͡s ʼ a
хабзэ	x aː b z a
янэхь	j aː n a ħ
унагъо	w n aː ʁʷ a
зыб	z ə b
ришъун	r j ə ʃʷ ə n
фэсакъын	f a s aː q ə n
дэхьан	d a ħ aː n
гъусэн	ʁʷ ə s a n
тедэжьын	t a j d a ʑ ə n
жэкӏьапэ	ʒ a kʲ ʼ aː p a
джау	d͡ʒ aː w
кӏэлъыон	t͡ʃ ʼ a ɬ ə w ə n
нэшӏошӏу	n a ʃʷ ʼ a ʃʷ ʼ
нэгъэцӏыу	n a ʁ a t͡s ʼ ə w
жьыкъэщэуз	ʑ ə q a ɕ a w z
тегъэпытахьын	t a j ʁ a p ə t aː ħ aː n
ешъухъогъон	j a ʃʷ ə χʷ a ʁʷ a n
пчъэшъхьаӏу	p t͡ʂ a ʂ ħ aː ʔ ²
мэулэлэн	m a w ə l a l a n
уэр	w a r
кхъулъфыгъэ	q͡χʷ ə ɬ f ə ʁ a
дыуэр	d ə w a r
абэгъоплъ	aː b a ʁʷ a p ɬ
къопс	qʷ a p s
нэз	n a z ə
блэкӏьын	b l a kʲ ʼ ə n
хэлъын	x a ɬ ə n
ӏонтагъ	ʔʷ a n t aː ʁ
къыхэущыкӏын	q ə x a w ɕ ə t͡ʃ ʼ ə n
чэщтао	t͡ʃ a ɕ t aː w a
щышӏын	ɕ ə ʃ ə n
тхьэгуащэ	t ħ a ɡʷ aː ɕ a
гоон	ɡʷ a w a n
укӏэпхъэн	w t͡ʃ ʼ a p χ a n
елэн	j a l a n
амэрмэ	aː m a r m a
пкъы	p q ə
шъхьатепӏэ	ʂ ħ aː t e p ʼ a
пцӏын	p t͡s ʼ ə n
ӏушъо	ʔʷ ə ʃʷ a
нэугъэупӏэпӏэгъу	n a w ʁ a w p ʼ a p ʼ a ʁʷ
кӏьэнлъэ	kʲ ʼ a n ɬ a
джэгу	d͡ʒ a ɡʷ
чӏэӏотыкӏын	t͡ʂ ʼ a ʔʷ a t ə t͡ʃ ʼ ə n
хьэшъобыдз	ħ a ʂʷ a b ə d͡z
егъэсэн	j a ʁ a s a n
жъотхъу	ʐʷ a t χʷ
енэу	j a n a w
блэнэукъ	b l a n a w q
лӏэужыгъо	ɬ ʼ a w ʒ ə ʁʷ a
бысым	b ə s ə m
хьэубыт	ħ a w b ə t
псэун	p s a w ə n
нахьиу	n aː ħ j ə w
теупӏэпӏэн	t a j w p ʼ a p ʼ a n
ӏелъын	ʔ a j ɬ ə n
чэгый	t͡ʃ a ɣ ə j
абакъэ	aː b aː q a
хъугъэ	χʷ ə ʁ a
чэ	t͡ʃ a
щызымэ	ɕ ə z ə m a
лые	ɮ ə j a
сапэ	s aː p a
стаф	s t aː f
шъэо	ʂ a w a
чъу	t͡ʃʷ ə
гъэцӏырэн	ʁ a t͡s ʼ ə r a n
гоучъон	ɡʷ a w t͡ʃʷ a n
хымэ	x ə m a
бгэн	j a b ɣ ə n
тэцӏэшъутыкӏьын	t a t͡s ʼ a ʃʷ t ə kʲ ʼ ə n
бэлахь	b a l aː ħ
жэхэпкӏэн	ʒ a x a p kʲ a n
зэкӏэплъэн	z a t͡ʃ ʼ a kʷ ʼ a n
хэгъэгу	x a ʁ a ɡʷ
шъун	ʃʷ ə n
тхыпкъэ	t x ə p q a
плъыжьыбз	p ɬ ə ʑ ə b z
гощын	ɡʷ a ɕ ə n
ахъ	aː χ
къэцы	q a t͡s ə
тэрэз	t a r a z
блэпкӏьын	b l a p t kʲ ʼ ə n
куандэ	kʷ aː n f a
дэгъналъэ	d a ʁ n aː ɬ a
орыжъ	w a r ə ʐ
гъэшӏон	ʁ a ʃʷ ʼ a n
гъучӏынэ	ʁʷ ə t͡ʂ ʼ ə n a
епцӏыжьын	j a p t͡s ʼ ə ʑ ə n
фэшӏун	f a ʃʷ ʼ ə n
мэбэгъон	m a b a ʁʷ a n
шыр	ʃ ə r
гъэупӏэпӏэн	ʁ a w p ʼ a p ʼ a n
щаибжъэ	ɕ aː j ə b ʐ a
жьэжьын	j a ʑ a ʑ ə n
мэпыгьэн	m a p ə ɡʲ a n
джыхэлъэдэн	d͡ʒ ə x a ɬ a d a n
къэщэн	q a ɕ a n
батыргъэгъ	b aː t ə r ʁ a ʁ
зэйтынчъыг	z a j t ə n t ʂ ə ɣ
гулъытэ	ɡʷ ə ɬ ə t a
цӏэ	t͡s ʼ a
гузэгу	ɡʷ ə z a ɡʷ
бгъэлыб	b ʁ a l ə b
чӏэшъутын	t͡ʂ ʼ a ʃʷ t ə n
гъэлыджын	ʁ a l ə d͡ʒ ə n
къэбаскъэ	q a b aː s q a
цуӏ	t͡ʃʷ ə ʔ
мы	m ə
бгынэн	b ɣ ə n a n
шэнычъэ	ʃ a n t͡ʂ a
гузэжъон	ɡʷ ə z a ʒʷ a n
егъэкӏун	j a ʁ a kʷ ʼ ə n
пщэрыхьапӏэ	p ɕ a r ə ħ aː p ʼ a
жэхэхьан	ʒ a x a ħ a n
гъэсэфытхыдэ	ʁ a s a f ə t x ə d a
цӏэцӏэн	t͡s ʼ a t͡s ʼ a n
къэгъэнэн	q a ʁ a n a n
джэгогъу	d͡ʒ a ɡʷ a ʁʷ
бэскъэн	b a s q a n
зэӏукӏэн	z a ʔʷ ə t͡ʃ ʼ a n
тхылъ	t x ə ɬ
бжым	b ʒ ə m
жэпхъэмыбгъу	ʒ a p χ a m ə b ʁʷ
дэкӏоен	d a kʷ ʼ a j a n
зешъокӏыжьын	z a j ʃʷ a t͡ʃ ʼ ə ʑ ə n
чъыӏалӏэ	t͡ʂ ə ʔ aː ɬ ʼ a
жьырытэдж	ʑ ə r ə t a d͡ʒ
гъубдж	ʁʷ ə b d͡ʒ
зэкӏэхьажьын	z a t͡ʃ ʼ a ħ aː ʑ ə n
шы	ʃ ə
мэсӏэсӏэн	m a s ʼ a s ʼ a n
тӏыгъон	t ʼ ə ʁʷ a n
жъагъэ	ʐ aː ʁ a
пэпсы	p a p s ə
егукӏэн	j a ɡʷ ə t͡ʃ a n
къаплъэн	q aː p ɬ a n
къэбкӏэ	q a b kʲ ʼ a
жъэжъэн	ʐ a ʐ a m
акъыл	ʔ aː q ə l
псэу	p s a w
гъэгъун	ʁ a ʁʷ ə n
уыд	w ə d
псыхъуэгуащэ	p s ə χʷ a ɡʷ aː ɕ a
чан	t͡ʃ aː n
мэпхъэпхъэн	m a p χ a p χ a n
гьи	ɡʲ ə j
бэджэщыр	b a d͡ʒ a ɕ ə r
егъэпхын	j a ʁ a p x ə n
янэ	j aː n a
цӏын	t͡s ʼ ə n
мэщтын	m a q ə n
бжъако	b ʐ aː kʷ a
тхылъылъ	t x ə ɬ ə ɬ
жъыгъуай	ʐ ə ʁʷ aː j
чэты	t͡ʃ a t ə
бахъсымэ	b aː χ s ə m a
егъэусыен	ʁ a w s ə j a n
щыхьан	ɕ ə ħ aː n
ӏупс	ʔʷ ə p
яжьэ	j aː ʑ a
жэмыӏан	ʒ a m ə ʔ aː n
аужым	aː w ʒ ə m
хыкъо	x ə qʷ a
жьаушӏ	ʑ aː w ʃ ʼ
изын	j ə z ə n
лъэкъопцӏанэ	ɬ a qʷ a p t͡s ʼ aː n a
хэон	x a w a n
атакъэ	ʔ a t aː q a
дэхьагъо	d a ħ aː ʁʷ a
бгырыс	b ɣ ə r ə s
хэгъощэн	x a ʁʷ a ɕ a n
шъутыжъ	ʃʷ ə t ə ʐ
пщыгъупшын	p ɕ ə ʁʷ ə p ʃ ə n
дахэ	d aː x a
мэчъэн	m a t͡ʂ a n
дэж	d a ʒ
щырыкъу	ɕ ə r ə qʷ
шъхьэӏужъу	ʂ ħ a ʔʷ ə ʐʷ
гъэцэкӏэн	ʁ a t͡s a t͡ʃ a n
лъыгъачъэ	ɬ ə ʁ aː t͡ʂ a
кӏэлъэтэкьын	t͡ʃ a ɬ a t a kʲ ə n
жъабгъо	ʐ aː b ʁʷ a
щэгьэгъож	ɕ a ɡʲ a ʁʷ a ʒ
лӏыкӏын	ɬˤ ʼ ə kʲ ʼ ə n
кӏьэрыт	kʲ ʼ a r ə t
гугъон	ɡʷ ə ʁʷ a n
нэбзый	n a b z ə j
нарт	n aː r t
кӏотэн	kʷ ʼ a t a n
шъорышӏ	ʃʷ a r ə ʃ ʼ
сырныч	s ə r n ə t͡ʃ
ахъчэбэдзэр	aː χ t͡ʃ a b a d͡z a r
пхъатэ	p χ aː t a
былътырыку	b ə ɬ t ə r ə kʷ
гъоплъышъо	ʁʷ a p ɬ ə ʂʷ a
жабз	ʒ a b z
блегъэкӏын	b l a j ʁ a kʲ ʼ ə n
зэплъэкӏын	z a p ɬ a t͡ʃ ʼ ə n
ахъщэнэпцӏ	aː χ ɕ a n a p t͡s ʼ
пэмэн	p a m a n
хъы	χ ə
жьыгъо	ʑ ə ʁʷ a
бгъотэрым	b ʁʷ t a r ə m
лӏышъхьэ	ɬ ʼ ə ʂ ħ a
нэплъэгъу	n a p ɬ a ʁʷ
пшъэб	p ʂ a b
пихын	p j ə x ə n
шъабэ	ʂ aː b a
налкъут	n aː l qʷ ə t
ӏупэ	ʔʷ ə p a
ахъчэмыкӏу	aː χ t͡ʃ a m ə kʷ ʼ
блабжъ	b l aː b ʐ
гъэпсӏэн	ʁ a p s ʼ ə n
жьыкъуз	ʑ ə qʷ ə z
тхыбзэ	t x ə b z a
къэцӏын	t͡s ʼ ə n
набгъу	n aː b ʁʷ ə
зегъэунэжъыен	z e ʁ a w n a ʐ ə j a n
изы	j ə z ə
утӏэтӏэн	w ə t ʼ a t ʼ a n
унэӏут	w ə n a ʔʷ ə t
псычэтыхъу	p s ə t͡ʃ a t ə χʷ
цӏапӏэ	t͡s ʼ aː p ʼ a
гъэбэдзэжьын	ʁ a b a d͡z a ʑ ə n
пытхъын	p ə t χ ə n
къаум	q aː w ə m
щылэмаз	ɕ ə l a m aː z
чэщыбзыу	t͡ʃ a ʃ ə b s ə w
щэный	ɕ a n ə j
ежьхэ	j a ʑ x a
жэкӏапэ	ʒ a t ʃ ʼ aː p a
хъопсэн	χʷ a p s a n
упсын	w ə p s ə n
кӏэрахъо	t͡ʃ ʼ a r aː χʷ a
фэпцӏын	f a p t͡s ʼ ə n
занкӏэу	z aː n t͡ʃ a w
чӏышъутын	t͡ʂ ʼ ə ʃʷ t ə n
дэкӏоцэн	d a kʷ ʼ a t͡s a n
шъыбын	ʂ ə b ə n
зэгъэлъагъэ	z a ʁ a ɬ aː ʁ a
укӏьын	w kʲ ʼ ə n
зэпытхъын	z a p ə t χ ə n
мэлыджын	m a l ə d͡ʒ ə n
ӏэкӏэхьан	ʔ ə t͡ʃ ʼ a ħ aː n
мыджыр	m ə d͡ʒ ə r
гъэнэфэн	ʁ a n a f a n
ипшын	j ə p ʃ ə n
къуамэ	qʷ aː m a
жъогъу	ʐʷ a ʁʷ
зэпыгъэчъын	z a p ə ʁ a t͡ʂ ə n
фэгъэпсын	f a ʁ a p s ə n
гукъэкӏыжьын	ɡʷ ə q a t͡ʃ ʼ ə ʑ ə n
бгыбзэ	b ɣ ə b z a
уатэ	w aː t a
гъэшӏэгъоны	ʁ a ʃ ʼ a ʁʷ a n ə
жэдэкӏэн	ʒ a d a t͡ʃ a n
гущыӏэухыгъэ	ɡʷ ə ɕ ə ʔ a w x ə ʁ a
сыхьат	s ə ħ aː t
тэпсэ	t a p s a
къэбэртайбзэ	q a b a r t aː j b z a
дэгъу	d a ʁʷ ə
мэгъун	m a ʁʷ ə n
къашъо	q aː ʂʷ a
къэгъэӏун	q a ʁ a ʔʷ ə n
тӏэрэхьын	m a t ʼ a r a ħ ə n
фэӏаз	f a ʔ aː z
бжъэмый	b ʐ a m ə j
рилъэшъон	r ə j ɬ a ʃʷ a n
бжьащэ	b ʑ aː ɕ a
фызын	f ə z ə n
махъушэбзу	m aː χʷ ʃ a b z ə w
егун	j a ɡʷ ə n
илъэсипшӏы	j ə ɬ a s i p ʂ ʼ ə
зыуӏэшын	z ə w ʔ a ʃ ə n
бэкълауэ	b a q l aː w a
пэбзыджын	p a b z ə d͡ʒ ə n
ӏэпхъощ	ʔ a p χʷ a ɕ
зупсын	z ə w ə p s ə n
мэкӏьыин	m a kʲ ʼ ə j ə n
плӏэнэбзы	p ɬ ʼ a n a b z ə
шхъуатӏэ	ʃ χʷ aː t ʼ a
естылӏэн	j a s t ə ɬ ʼ a n
гъэпсэфыгъо	ʁ a p s a f ə ʁʷ a
тэгъэпсэхьэн	t a ʁ a p s a ħ aː n
джырыкъу	d͡ʒ ə r ə qʷ
фэшӏу	f a ʃʷ ʼ ə
тӏэкӏугъашӏэм	t ʼ a kʷ ʼ ʁ aː ʃ ʼ a m
бзэхын	b z a x ə n
нэфы	n a f ə
папкӏэ	p aː p t͡ʃ ʼ a
пшагъо	p ʃ aː ʁʷ a
пкӏыхьапӏ	p t͡ʃ ə ħ aː p ʼ
къэлэсэрай	q a l a s a r aː j
дампӏ	d aː m p ʼ
джамбырыу	d͡ʒ aː m b ə r ə w
шӏыкӏай	ʃ ʼ ə t͡ʃ ʼ aː j
цӏыкӏу	t͡s ʼ ə kʷ ʼ
мэкъамэ	m a q aː m a
лъагъо	ɬ aː ʁʷ a
ӏаджэ	ʔ aː d͡ʒ a
бгыпэ	b ɣ ə p a
къутамэ	qʷ ə t aː m a
бжьыго	b ʑ aː ɡʷ a
дэхьыхын	d a ħ ə x ə n
къэлапчъ	q a l aː p t͡ʃ
бгъузэ	b ʁʷ ə z a
пшъэрылъ	p ʂ a r ə ɬ
уцэӏун	w ə t͡s a ʔʷ ə n
ӏэпытӏэрын	ʔ a p ə t ʼ a r ə n
еӏолӏэн	j a ʔʷ a ɬ ʼ a n
жьыкъухь	ʑ ə qʷ ə ħ
къолэбзыу	qʷ a l a b z ə w
хэщтыхьын	x a q a ħ ə n
кӏоцӏыщыхьан	kʷ ʼ a t͡s ʼ ə ɕ ə ħ aː n
сэмэркъэушӏыл	s a m a r q a w ʃ ʼ ə ɮ
шӏэнгъэ	ʃ ʼ a n ʁ a
жын	ʒ ə n
псэлъэн	p s a ɬ a n
чэфын	t͡ʃ a f ə n
хьарзэ	ħ aː p z a
уты	w t ə
пэхьан	p a ħ aː n
зэрихьэн	z a r i ħ a n
гъэджэн	ʁ a d͡ʒ a n
тхьэгъэлэдж	t ħ a ʁ a l a d͡ʒ
кӏошъэн	kʷ ʼ a ʂ a n
ӏэгъуапэ	ʔ a ʁʷ aː p a
ӏукӏэхьан	ʔʷ ə t͡ʃ ʼ a ħ aː n
пхъашэ	p χ aː ʃ a
гъэӏорышӏэн	ʁ a ʔʷ a r ʃ ʼ a n
хэузыкӏын	x a w z ə t͡ʃ ə n
тхьэмыщкӏь	t ħ a m ə ɕ kʲ ʼ
щыбырысыр	ɕ ə b ə r ə s ə r
къэрабгъэ	q a r aː b ʁ a
чэмыл	t͡ʃ a m ə l
нэшъу	n a ʂʷ ə
бжьыныфыкӏ	b ʑ ə n ə f ə kʲ ʼ
кӏашъо	t͡ʃ ʼ aː ʃʷ a
теуцӏэлэн	t a w t͡s ʼ a l a n
бжьыныфыц	b ʑ ə n ə f ə t s
бзэджашӏэ	b z a d͡ʒ aː ʃ ʼ a
кушъхьэфачъэ	kʷ ə ʂ ħ a f aː t͡ʂ a
мэсӏын	s ʼ ə n
пӏырагу	p ʼ ə r aː ɡʷ
пакӏо	p aː kʷ ʼ a
гъэпщын	ʁ a p ɕ ə n
ашъоку	aː ʂʷ a kʷ
гъын	ʁ ə n
гъунэфын	ʁʷ ə n a f ə n
гъэпсын	ʁ a p s ə n
шъыдгъо	ʂ ə d ʁʷ a
гыкӏэн	ɣ ə t͡ʃ a n
бэрэтӏин	b a r a t i j
зиӏ	z ə j ʔ
пщылӏын	p ɕ ə ɬ ʼ ə n
псэолъэшӏ	p s a w a ɬ a ʃ ʼ
гущыӏанчъэ	ɡʷ ə ɕ ə ʔ a n t͡ʂ ʼ a
хэгъошъхьаӏу	x a ʁʷ a ʂ ħ a ʔʷ
тэкӏутэн	t a kʷ ʼ ə t a n
дес	d a j s
къэхалъэ	q a x aː ɬ a
бжьашӏо	b ʑ aː ʃʷ ʼ a
блэбгъу	b l a b ʁʷ ə
цӏэпапкӏ	t͡s ʼ a p aː p t͡ʃ ʼ
къогъо	qʷ a ʁʷ a
лъэхъуамбэ	ɬ a χʷ aː m b a
тхын	t x ə n
къэбэртай	q a b a r t aː j
мэсэкъатын	m a s a q aː t ə n
лӏакъо	ɬ ʼ aː qʷ a
гоутыт	ɡʷ a w t ə n
мэцыгъон	m a t͡s ə ʁʷ a n
ады	ʔ aː d ə
бгъагъэ	b ʁ aː ʁ a
лъэрыгъачъэ	ɬ a r ə ʁ aː t͡ʂ a
гъучӏыбзыу	ʁʷ ə t͡ʂ ʼ ə b z ə w
бзэбзэн	b z a b z a n
щэрыхъ	ɕ a r ə χ
зегъэшӏужьын	z a j ʁ a ʃʷ ʼ ə ʑ ə n
ӏофшӏэн	ʔʷ a f ʃ ʼ a n
тэгъзакӏэ	t a ʁ z aː kʲ ʼ a
ӏэбыцу	ʔ a b ə t͡sʷ
пӏэркӏьын	p ʼ a n kʲ ʼ ə m
цыпэ	t͡s ə p a
чӏэтэкъун	t͡ʂ ʼ a t a qʷ ə n
ныбжь	n ə b ʑ
къыкъокӏын	q ə qʷ a t͡ʃ ʼ ə n
нэкӏушъхь	n a kʷ ʼ ə ʂ ħ
пчэндэхъу	p t͡ʃ a n d a χʷ
жъогъофах	ʐʷ a ʁʷ a f aː x
куахъо	kʷ aː χʷ a
бэнжъый	b a n ʐ ə j
къещхын	q e ɕ x ə n
лъфын	ɬ f ə n
шъхьэныкъо	ʂ ħ a n ə qʷ a
мэфэкӏ	m a f a t ʃ ʼ
теутхэн	t j a w ə t x ə n
кьэфы	kʲ a f ə
щыгъэзыен	ʃ ə ʁ a z ə j a n
фын	f ə n
мэлӏэн	m a ɬ ʼ a n
чыжьэ	t͡ʃ ə ʑ a
джэгуакӏо	d͡ʒ a ɡʷ aː kʷ ʼ a
пӏэтехъо	p ʼ a t e χʷ a
бжьыныкӏ	b ʑ ə n ə kʲ ʼ
дэзэкӏон	d a z a kʷ ʼ a n
хэшӏэн	x a ʃ ʼ a n
бэ	b a
ты	t ə
усын	w s ə n
блэнагъ	b l a n aː ʁ
щхэны	ɕ x a n ə
къуджыр	qʷ ə d͡ʒ ə r
хьамлыу	ħ a m l ə w
мылъыку	m ə ɬ ə kʷ
кӏыхьэ	t͡ʃ ʼ ə ħ a
зэгожъын	z a ɡʷ a ʐ ə n
чӏегъэбылъхьэн	t͡ʃ ʼ e ʁ a b ə ɬ ħ a n
кӏако	t͡ʃ ʼ aː kʷ a
нэшхъэй	n a ʃ χ a j
нахьышӏу	n aː ħ ə ʃʷ ʼ
парчэ	p aː r t͡ʃ a
шамйэ	ʃ aː m j a
шъхьэнгъупчъэ	ʂ ħ a n ʁʷ ə p t ʂ a
жъыун	ʐ ə w ə n
пчъэӏупэ	p t͡ʃ a ʔʷ ə p a
лимон	l i m ɔ n
бзэмэ	b z aː m a
егъэтыгъ	j a ʁ a t ə ʁ
ежьэн	j a ʑ a n
къыщинэн	q ə ɕ i n a n
псытхьэгуащэ	p s ə t ħ a ɡʷ aː ɕ a
цӏэтхъын	t͡s ʼ a t χ ə n
пхэкӏ	p x a t͡ʃ ʼ
дэгъэнэн	d a ʁ a n a n
тхьакӏумкӏыхь	t ħ a kʷ ʼ m a t͡ʃ ʼ ə ħ
къытегъэзэн	q ə t a j ʁ a z a n
хьэжъу	ħ a ʐʷ
дэгъэбыбыкӏын	d a ʁ a b ə b ə t͡ʃ ə n
гъэпсыкӏын	ʁ a p s ə t͡ʃ ʼ ə n
тамэ	t aː m a
хъяркӏэ	χ ə j aː r t͡ʃ ʼ a
коны	kʷ a n ə
цэхь	t͡s a ħ
бэрэскэф	b a r a s k a f
къэмлан	q a m l aː n
къамыщ	q aː m ə ɕ
убэн	w ə b a n
хьэпӏацӏэ	ħ a p ʼ aː t͡s ʼ a
къэнэн	q a n a n
тыгъуасэ	t ə ʁʷ aː s a
хэщэн	x a ɕ a n
лъэ	ɬ a
гъэ	ʁ a
жъагъ	ʐ aː ʁ
уасэ	w aː s a
бэджыхъ	b a d͡ʒ ə χ
ебгъэчэхын	j a b ʁ a t͡ʃ a x ə n
ешъуакӏо	j a ʃʷ ʼ aː kʷ ʼ a
бзыукӏьалъэ	b z ə w kʲ ʼ aː ɬ a
пхъэчыпэ	p χ a t͡ʃ ə p a
къэон	q a w a n
тхьаматэ	t ħ aː m aː t a
ощхы	w a ɕ x ə
укӏытагъо	w ə t͡ʃ ʼ ə t aː ʁʷ a
фае	f aː j a
гъэпщэн	ʁ a p ɕ a n
нэпчыхьэ	n a p t͡ʃ ə ħ a
абрадж	aː b r aː d͡ʒ
кугъачъ	kʷ ə ʁ aː t͡ʃ
хъуае	χʷ aː j a
дэялъ	d a j aː ɬ
ос	w a s
къеткӏухын	q e t kʷ ʼ ə x ə n
бжъэмыяпщ	b ʐ a m ə j aː p ɕ
гъэшъыпкъэжьын	ʁ a ʂ ə p q a ʑ ə n
гъаф	ʁ aː f
блэбгъуплъ	b l a b ʁʷ ə p ɬ
бгъашъухъо	b ʁ aː ʃʷ χʷ a
джыхашъо	d͡ʒ ə x aː ʃʷ a
мэшъоӏун	m a ʃʷ a ʔʷ ə n
исэн	j ə s a n
къэкӏухьан	q a kʷ ʼ ə ħ aː n
хъупӏэ	χʷ ə p ʼ a
хьашъо	ħ aː ʂʷ a
зыпэгъэплъэн	z ə p a ʁ a p ɬ a n
ахъщэзэблэхъущ	aː χ ʃ a z a b l a χʷ ə n
анэбзыу	a n a b z ə w
чыӏу	t͡ʃ ʼ ə ʔʷ
уэрзэӏанэ	w a r z a ʔ aː n a
пцантхьэ	p t͡s aː n t ħ a
пыхьан	p ə ħ aː n
жъгъырыу	ʐ ʁ ə r ə w
гъэупысӏэн	ʁ a w p s ʼ a n
блэпцэжъый	b l a p t͡ʃ a ʐ ə j
аслъаншыр	aː s ɬ aː n ʃ ə r
лыпцӏэ	l ə p t͡s ʼ a
лъежьэн	ɬ a j ʑ a n
кӏун	kʷ ʼ ə n
шэкэрхафэ	ʃ a kʲ a r x aː f a
дыщыпс	d ə ɕ ə p s
ӏэплъэкӏ	ʔ a p ɬ a t͡ʃ
хьэо	ħ a w a
лъэгъупхъ	ɬ a ʁʷ ə p χ
дэгъэчъыхьэн	d a ʁ a t͡ʃ ə ħ a n
дакъэ	d aː q a
блэрыпс	b l a r ə p s
бэдзэогъумаз	b a d͡z a w a ʁʷ ə m aː z
алэдышъ	aː l a d ə ʂ
зэпыкьын	z a p ə kʰ ə n
пщынэжь	p ɕ ə n a ʑ
нафэ	n aː f a
утэцэн	w ə t a t͡s a n
гъоплъашъу	ʁʷ a p ɬ aː ʂʷ
бзагьэ	b z aː ɡʲ a
сэрай	s a r aː j
гъолагъ	ʁʷ a ɮ aː ʁ
гъэлыгьын	ʁ a l ə ɡʲ ə n
гумэкӏыгъу	ɡʷ ə m a t͡ʃ ə ʁʷ
кӏыб	t͡ʃ ʼ ə b
хьэдэкъаз	ħ a d a q aː z
щэн	ɕ a n
хьэджашъу	ħ a d͡ʒ aː ʂʷ
бзыухьакуаку	b z ə w ħ aː kʷ aː kʷ
хэнэн	x a n a n
хъопсащэ	χʷ a p s aː ɕ a
сэраджэ	s a r aː d͡ʒ a
ӏапшъ	ʔ aː p ʂ
ичӏыпӏэкӏэ	j ə t͡ʂ ʼ ə p ʼ a t͡ʃ ʼ a
дунай	d u n aː j
аушыджэр	aː w ʃ ə d͡ʒ a r
еуджэгъун	j a w d͡ʒ aː ʁʷ ə n
къэутхын	q a w ə t x ə n
гъажъо	ʁ aː ʒʷ a
мэ	m a
кӏуапӏэ	kʷ ʼ aː p ʼ a
жакӏэ	ʒ aː t ʃ ʼ a
хьэшъотоп	ħ a ʂʷ a t o p
унэчӏэгъ	w ə n a t͡ʃ ʼ a ʁ
гомыхь	ɡʷ a m ə ħ
быбыжьын	b ə b ə ʑ ə n
аддэ	aː d d a
гъогумаф	ʁʷ a ɡʷ m aː f
гъэтхъэн	ʁ a t χ a n
дестэ	d a j s t a
шӏоигъоджэн	ʃʷ a j ə ʁʷ a d͡ʒ a n
мыӏэрыс	m ə ʔ a r ə s
антыр	aː n t ə r
бгъуитӏуӏу	b ʁʷ i tʷ ʼ ə ʔʷ
сыунэхъугъ	s ə w n a χʷ ə ʁ
гъэжъэн	ʁ a ʐ a n
зыщыгъэгъупшын	z ə ɕ ə ʁ a ʁʷ ə p ʃ ə n
къэплъан	q a p ɬ aː n
лъышӏэжьакӏо	ɬ ə ʃ ʼ a ʑ aː kʷ ʼ a
шӏэн	ʃ a n
кощын	kʷ a ɕ ə n
щыгъэтын	ɕ ə ʁ a t ə n
блэгъагъ	b l a ʁ aː ʁ
кӏэхьан	t͡ʃ ʼ ə ħ aː n
чэркэс	t͡ʃ a r k a s
шъхьэтэпӏ	ʂ ħ aː t e p ʼ a
кьэт	kʲ a t
пчъэӏу	p t͡ʃ a ʔʷ ə
былымтыгъу	b ə l ə m t ə ʁʷ
бжьыко	b ʑ aː kʷ a
егъэлыен	j a ʁ a ɮ ə j a n
гъочӏэгъ	ʁʷ a t͡ʂ ʼ a ʁ
дэнэн	d a n a n
ехъу	j a χʷ
мэукӏын	m a w t͡ʃ ʼ ə n
темыр	t a j m ə r
чӏымэтх	t͡ʃ ə m a t x
кӏакӏо	t͡ʃ aː kʷ ʼ a
ӏэлгьанэ	ʔ a l ɡʲ aː a n a
къэхьын	q a ħ ə n
бысылмэн	b ə s ə l m a n
жъоныгъуакӏмаз	ʒʷ a n ə ʁʷ aː t͡ʃ ʼ m aː z
ныбжьи	n ə b ʑ ə
хэгъэузыкӏын	x a ʁ a w z e t͡ʃ ə n
акул	aː kʷ ə l
ныбжьэгъу	n ə b ʑ a ʁʷ
мазэ	m aː z a
бзашӏу	b z aː ʃʷ ʼ
икъун	j ə qʷ ə n
быдзталхьэ	b ə d͡z t aː l ħ a
махъушэ	m aː χʷ ə ʃ a
амырми	aː m a r m i
дэгъэбыбэен	d a ʁ a b ə b a j a n
хэхын	x a x ə n
иушӏоин	j ə w ʃʷ a j ə n
фэпщэн	f a p ʃ a n
алырэгъушӏ	aː l ə r a ʁʷ ʃ ʼ
шэмбэт	ʃ a m b a t
бзэрэбзэн	b z a r a b z a n
чӏыплъ	t͡ʃ ə p ɬ
ӏасэу	ʔ aː s a w
абас	aː b aː s
тыгъон	t ə ʁʷ a n
машӏо	m aː ʃʷ ʼ a
гъоз	ʁʷ a z
цӏэшъутэн	t͡s ʼ a ʃʷ t a n
бзэныб	b z a n ə b
пӏэкӏор	p ʼ a kʷ ʼ a r
кхъуайэ	q͡χʷ aː j a
джэнджэш	d͡ʒ a n d͡ʒ a ʃ
псэушъхь	p s a w ʂ ħ
цыз	t͡s ə z
хэхъон	x a χʷ a n
пыскӏьэн	p ə s kʲ a n
хэкӏьын	x a kʲ ʼ ə n
хьамлашкӏу	ħ aː m ɮ aː ʃ kʷ ʼ
баджэ	b aː d͡ʒ a
зэхэфэн	z a x a f a n
уцы	w ə t͡s ə
фэлъэкӏьын	ɬ a kʲ ʼ ə n
тэкӏу	t a kʷ ʼ
гъонлагъэ	ʁʷ a n ɮ aː ʁ a
лъэжъуагъ	ɬ a ʐʷ aː ʁ
шӏобзын	ʃʷ ʼ a b z ə n
мэшӏоку	m a ʃʷ ʼ a kʷ
блэлъэтын	b l a ɬ a t ə n
гъэунэзэн	ʁ a w n a z a n
тӏы	t ʼ ə
хъучӏанэ	χʷ ə t͡ʃ aː n a
лъы	ɬ ə
чӏы	t͡ʂ ʼ ə
псынжъы	p s ə n ʐ ə
насып	n aː s ə p
фэшъхьаф	f a ʂ ħ aː f
таплъэ	t aː p ɬ a
ымышӏахэу	ə m ə ʃ ʼ aː x a w
нашъухъо	n aː ʂʷ χʷ a
хъэбар	χ a b aː r
чыдан	t͡ʃ ə d aː n
тхакӏо	t x aː kʷ ʼ a
зэпыдзын	z a p ə d͡z ə n
еӏун	j a ʔʷ ə n
екӏошъэн	j a kʷ ʼ a ʂ a n
ӏэпыкӏын	ʔ a p ə t͡ʃ ʼ ə n
делэжъ	d a j l a ʐ
джэрыон	d͡ʒ a r ə w a n
къуащэу	qʷ aː ɕ a w
пыуты	p ə w t ə
жьыф	ʑ ə f
бэджэндэутын	b a ʒ a n d a w t ə n
гуапэ	ɡʷ aː p a
ӏорышӏэ	ʔʷ a r ə ʃ ʼ a
мэшӏощыхъу	s ə r n ə t͡ʃ
хыӏушъо	x ə ʔʷ ə ʃʷ a
бэрэ	b a r a
къэлъфын	q a ɬ f ə n
мэчъыен	m a t͡ʃ ə j a n
хэузыкӏьын	x a w z ə kʲ ə n
ӏукӏэн	ʔʷ ə t͡ʃ a n
пысӏэн	p ə s ʼ a n
пшъэ	p ʂ a
напсэ	n aː p s a
гъушъы	ʁʷ ə ʂ ə
бзытэн	b z ə t a n
хыкъохъу	x ə qʷ a χʷ
укӏытэн	w ə t͡ʃ ʼ ə t a n
лъэпс	ɬ a p s
гъэтӏылъын	ʁ a t ʼ ə ɬ ə n
чыфыт	t͡ʃ ə f ə t
тэкӏурэ	t a kʷ ʼ r a
бзэмыӏу	b z a m ə ʔʷ
пшъэдэкӏыжъ	p ʂ a d a t͡ʃ ə ʐ
ябзэгу	j aː v z a ɡʷ
тӏокӏитӏу	tʷ ʼ a t͡ʃ i tʷ ʼ
упӏэпӏэн	w p ʼ a p ʼ a n
блын	b l ə n
шъумэ	ʂʷ əː m a
дэӏэпыӏэн	d a ʔ a p ə ʔ a n
зэпитхъын	z a p i t χ ə n
фэлъэкӏын	ɬ a t͡ʃ ʼ ə n
мыжъокӏашъхъ	m ə ʐʷ a kʲ aː ʂ χ
ахын	aː x ə n
тэкуон	t a kʷ ə w a n
бгъушы	b ʁʷ ə ʃ ə
пэплъэн	p a p ɬ a n
хьэуцхьэш	ħ a w t͡s ħ a ʃ
жьыбгъэос	ʑ ə b ʁ a w a s
гъэтхъэжьын	ʁ aː t χ a ʑ ə n
пыхын	p ə x ə n
егъоин	ʁʷ a j ə n
блэплъын	b l a p ɬ ə n
жъгъау	ʒ ʁ aːʷ
зэкӏэкӏон	z a t͡ʃ ʼ a kʷ ʼ a n
пчыхьэ	p t͡ʃ ə ħ a
пцӏыус	p t͡s ʼ ə w ə s
хьажъу	h aː ʐʷ
бэджэжъые	b a d͡ʒ a ʐ ə j a
нынэпӏос	n ə n a pʷ ʼ a s
лъынтфэ	ɬ ə n t f a
шэн	ʃ a n
зэпыгъэун	z a p ə ʁ a w ə n
пыкьын	p ə kʲ ə n
шъыгъо	ʂ ə ʁʷ a
блыгу	b l ə ɡʷ
ӏэшъхьэтет	ʔ a ʂ ħ a t a j t
псычэт	p s ə t͡ʃ a t
тхьэпкӏэ	t ħ a p t͡ʃ a
ӏэшъхьэ	ʔ a ʂ ħ a
гъэзалъэ	ʁ a z aː ɬ a
къутэн	qʷ ə t a n
лъапсэ	ɬ aː p s a
къошъофы	qʷ a ʂʷ a f ə
гъэпӏэркӏьын	ʁ a p ʼ a r kʲ ə n
гъолагъэ	ʁʷ a ɮ aː ʁ a
зэолӏ	z a w a ɬ ʼ
хэуӏэн	x a w ʔ a n
зыщыгъэзыен	z ə ʃ ə ʁ a z ə j a n
лӏыжъыгъу	ɬ ʼ ə ʐ ə ʁʷ
хьэят	ħ a j aː t
ко	kʷ a
зэгъэпэшын	z a ʔ a p a ʃ ə n
хытӏуал	x ə tʷ ʼ a l
акъылыгъу	aː q ə l ə ʁʷ
укӏын	w ə t͡ʃ ʼ ə n
унэзэн	w n a z a n
пкъыгъо	p s ə ʃʷ a
лэлэн	l a l a n
тэтӏэтӏэн	t a t ʼ a t ʼ a n
нынэпӏэс	n ə n a p ʼ a s
къуащэ	qʷ aː ɕ a
бгылъэ	b ɣ ə ɬ a
къэгъэкӏэхьын	q a ʁ a t͡ʃ a ħ ə n
зэгоутын	z a ɡʷ a w t ə n
хыгъунэ	x ə ʁʷ ə n a
накӏэ	n aː t͡ʃ ʼ a
гъэпсэфын	ʁ a p s a f ə n
ӏэхъуамбэ	ʔ a χʷ aː m b a
лъэгу	ɬ a ɡʷ
жэгъуб	ʒ a ʁʷ ə b
гъэткӏун	ʁ a t kʷ ʼ ə n
къузмэзадэ	qʷ ə z m a z aː d a
нэкӏушъу	n a kʷ ʼ ə ʂʷ
лъапэ	ɬ aː p a
есыпӏэ	j a s ə p ʼ a
блэгъэжъ	b l a ʁ a ʐ
дэн	d a n
ачъэжъ	aː χ t͡ʃ a ʐ
жъоркъ	ʐʷ a r q
щэ	ɕ a
зытегъэкӏэн	z ə t a j ʁ a t͡ʃ ʼ a n
гъожьыплъыжь	ʁʷ a ʑ p ɬ ə ʑ ə
псӏашъухъо	p sˤ ʼ aː ʃʷ χʷ a
гъэӏэсэн	ʁ a ʔ a s a n
хигъэгъощэн	x i ʁ a ʁʷ a ɕ a n
пылъапӏэ	p ə ɬ aː p ʼ a
бгъэхэӏушъхь	b ʁ a x a ʔʷ ə ʂ ħ
дыгьы	d ə ɡʲ ə
бын	b ə n
мэзахэ	m a z aː x a
къытэгъэзэн	q ə t a ʁ a z a n
хьэкъуашъо	ħ a qʷ aː ʃʷ a
гущыӏэрые	ɡʷ ə ɕ ə ʔ a r ə j a
гущыӏап	ɡʷ ə ʃʷ ʼ a p
гъэрэзэн	ʁ a r a z a n
мэщынэн	m a ɕ ə n a n
псӏырый	p s ʼ ə r ə j
лъэхъомбэшх	ɬ a χʷ a m b a ʃ x
блэмыу	b l a m ə w
щхъырыб	ɕ χ ə r ə b
пстэури	p s t a w r i
лӏэшӏэгъу	ɬˤ ʼ a ʃ ʼ a ʁʷ
батыргъэн	b aː t ə r ʁ a n
тикӏэн	t i kʲ a n
анджэрэф	aː n d͡ʒ a r a f
ны	n ə
тэцӏэцӏэн	t a t͡s ʼ a t͡s ʼ a n
темэн	t a j m a n
чызмэ	t͡ʃ ə z m a
зегъэхьын	z a j ʁ a ħ ə n
чӏэӏотыкӏьын	t͡ʂ ʼ a ʔʷ a t ə kʲ ʼ ə n
къаблэ	q aː b l a
щыгугъын	ɕ ə ɡʷ ə ʁ ə n
зетын	z a j t ə n
хьаумэ	ħ aː w m a
азэ	aː z a
кьэрхъон	kʲ a r χʷ a n
мэпыджэн	m a p ə d͡ʒ ə n
лъэкъуапсӏ	ɬ a qʷ aː p s ʼ
шӏуцӏагъэ	ʃʷ ʼ t͡s ʼ aː ʁ a
тхыдэ	t x ə d a
бгышъхь	b ɣ ə ʂ ħ a
епыджын	j a p ə d͡ʒ ə n
бэщкъорэгъ	b a ɕ qʷ a r a ʁ
къахьэуашъо	q aː ħ a w aː ʃʷ a
шыукӏытэн	ʃ ə w t͡ʃ ʼ ə t a n
щае	ɕ aː j a
чӏэн	t͡ʃ ʼ a n
хъыен	χ ə j a n
гъоплъашъо	ʁʷ a p ɬ ə ʂʷ a
джэгупӏэ	d͡ʒ a ɡʷ ə p ʼ a
бгъэпс	b ʁ a p s
ахъщалъ	aː χ ɕ aː ɬ
блэкӏын	b l a t͡ʃ ʼ ə n
гу	ɡʷ ə
ӏанэ	ʔ aː n a
хэку	x a kʷ
адэкӏо	aː d a kʷ ʼ a
декӏэкӏьын	d a i t͡ʃ a kʲ ə n
езэон	j a z a w a n
джынэс	d͡ʒ ə n a s
нэпашъо	n a p aː ʃʷ a
щэбзащ	ɕ a b z aː ɕ
гъучӏыӏунэ	ʁʷ ə t͡ʂ ʼ ə ʔʷ ə n a
джащыгъум	d͡ʒ aː ɕ ə ʁʷ ə m
гъомыл	ʁʷ a m ə ɮ
тэпкӏэн	t a p t͡ʃ ʼ a n
пэсакӏо	p a s aː kʷ ʼ
псышъуалъэ	p s ə ʃʷ aː ɬ a
дэщыен	d a ɕ ə j a n
зэкъошныгъ	z a qʷ a ʃ n ə ʁ
кӏэгъожьын	t͡ʃ a ʁʷ a ʑ ə n
шъотэгын	ʂʷ a t a ɣ ə n
къэущын	q a p ɕ ə n
лъфэн	ɬ f a n
джэщгъум	d͡ʒ a ɕ ʁʷ ə m
пкьэн	p kʲ a n
алырэгъу	aː l ə r a ʁʷ
пэӏоталъхьэ	p a ʔʷ a t aː l ħ a
шэны	ʃ a n
мэшӏухъогъон	m a ʃʷ ʼ ə χʷ ə ʁʷ a n
напэ	n aː p a
жъыгъо	ʐ ə ʁʷ a
дэтхъын	d a t χ ə n
лъэрымыхь	ɬ a r ə m ə ħ
пцӏы	p t͡s ʼ ə
зыгъэсамбырын	z ə ʁ a s aː m b ə r ə n
ӏуртӏагъ	ʔʷ ə n t ʼ aː ʁ
мусэ	m ə w s a
къудыин	qʷ ə d ə j ə n
нэкьыхьытх	n a kʲ ə ħ ə t x
бледзын	b l a j d͡z ə n
мышъэ	m ə ʂ a
пӏэсхъэн	p ʼ a s χ a n
цэ	t͡s a
уцун	w t͡ʃʷ ə n
къэпшӏэжын	q a p ʃ ʼ a ʑ ə n
угощын	w ə ɡʷ a ɕ ə n
къикӏьэсӏын	q ə j kʲ ʼ a s ʼ ə n
хьацэпӏацэ	ħ aː t͡s a p ʼ aː t͡s a
дэбзыкъу	d a b z ə qʷ
щыгъэн	ɕ ə ʁ a n
тхьаркъо	t ħ aː r qʷ a
кӏыгъун	t͡ʃ ʼ ə ʁʷ ə n
къэлыдын	q a ɮ ə d ə n
мысэ	m ə s a
зэблэхъун	z a p l a χʷ ə n
гущыӏэ	ɡʷ ə ɕ ə ʔ a
къашыкъ	q aː ʃ ə q
къоӏус	qʷ a ʔʷ ə s
лачэ	l aː t͡ʃ a
бзэгу	b z a ɡʷ
хэупцӏэн	x a w p t͡s ʼ a n
гъолъын	ʁʷ a ɬ ə n
ӏэгу	ʔ a ɡʷ
тегъэбылъхьэн	t e ʁ a b ə ɬ ħ a n
нэгъучӏыцэ	n a ʁʷ t͡ʂ ʼ ə t͡s a
хьау	ħ a w
ӏэзэ	ʔ a z a
зэхэшӏыкӏын	z a x a ʃ ʼ ə t͡ʃ ʼ ə n
тэуцӏэлэн	t a w t͡s ʼ a l a n
къаунэ	q aː w ə n a
гъэцӏэтхын	ʁ a t͡s ʼ a t x ə n
псатхьэ	p s aː t ħ a
гъэмартын	ʁ a m aː r t ə n
щыдыхьэщхын	ɕ ə d ə ħ a ɕ x ə n
чӏыбгъэ	ħ aː s a t x
дэкӏон	d a kʷ ʼ a n
язырэ	j aː z ə r a
гъэмафэ	ʁ a m aː f a
псысамыр	p s ə s aː m ə r
нэпэшъоутын	n a ɡʷ ə ʃʷ a w t ə n
одыджын	w a d ə d͡ʒ ə n
пэпскъикӏ	p a p s q i t͡ʃ
жэдэзын	ʒ a d a z ə n
егъанэ	j a ʁ aː n a
мэлы	m a ɮ ə
фыжьыбз	f ə ʑ ə b z
бзыхьафынчъ	b z ə ħ aː f ə n t ʂ
шъугъон	ʃʷ ʁʷ a n
кӏосэн	kʷ ʼ a s a n
махъшэбзу	m aː χ t͡ʃ a b z ə w
шыкӏэпшынэ	ʃ ə kʲ a p ʃ ə n a
тхьэлӏыкӏу	t ħ a ɬˤ ə kʷ ʼ
ифын	j ə f ə n
наныу	n aː n ə w
гъэсмэджэн	ʁ a s m a d͡ʒ a n
гьэгу	ɡʲ a ɡʷ
шыбзы	ʃ ə b z ə
текӏэн	t a j t͡ʃ ʼ a n
бгыгъуан	b ɣ ə ʁʷ aː n
нэбгъэ	n a b ʁ a
ошэкур	w a ʃ a kʷ ə r
хьантӏаркъу	ħ a n t aː r qʷ
дэжь	d a ʑ
нет	n a j t
бэнытӏ	b a n ə t ʼ
гъунджэ	ʁʷ ə r d͡ʒ a
текӏутэн	t a j kʷ ʼ ə t a n
ебэнын	j a b a n ə n
шъхьатэ	ʂ ħ aː t a
сын	s ə n
шъхьангъупчъэ	ʂ ħ aː n ʁʷ ə p t ʂ a
арышъ	aː r ə ʂ
шӏухъогъон	ʃʷ ʼ ə χʷ ə ʁʷ a n
хьан	ħ aː n
цэлы	t͡s a l ə
шъоны	ʃʷ a n ə
лэгъупкъопс	l a ʁʷ ə p ʕʷ a p s
хьэкусташ	ħ a kʷ ə s t aː ʃ
шэзгъэ	ʃ a z ʁ a
чъыгшъхьацыз	t͡ʃ ə ɣ ʂ ħ aː t͡ʃ ə z
лъапцӏэ	ɬ aː p t͡s ʼ a
джыхэон	d͡ʒ ə x a w a n
бэрэкъащ	b a r a q aː ɕ
ныкъуалӏэ	n ə qʷ aː ɬ ʼ a
чатэ	t͡ʃ aː t a
гъэчэрэгъун	ʁ a t͡ʃ a r a ʁʷ ə n
пкъышъолы	p q ə ʃʷ a l ə
анэл	aː n a l
хъу	χʷ ə
нэпэӏэплъэкӏ	n a p a ʔ a p ɬ a t͡ʃ ʼ
пхъэшъхьэмышъхь	p χ aː ʂ ħ a m ə ʂ ħ
бырыпх	p ə r ə p x
кӏэлэегъагь	t͡ʃ ʼ a l a ʁ aː ɡʲ
лъэпкъ	ɬ a p q
джэмышх	d͡ʒ a m ə ʃ x
жэхэон	ʒ a x a w a n
хьэкъухъ	ħ a qʷ ə ʐ
мэплъэн	m a p ɬ ə n
пылъалъэ	p ə ɬ aː ɬ a
лъыӏэбэн	ɬ ə ʔ a b a n
пӏэ	p ʼ a
цэлъэкӏ	t͡s a ɬ a t͡ʃ
лъежэн	ɬ a j ʒ a n
пчэгу	p t͡ʃ a ɡʷ
къужъы	qʷ ə ʐ ə
жъуаф	ʐʷ aː f
тегъэун	t a j ʁ a w ə n
щынэжьын	ɕ ə n a ʑ ə n
къохь	qʷ a ħ
дэфыцӏэн	d a f ə t͡s ʼ a n
ӏуагъэ	ʔʷ aː ʁ a
бэджыджэн	b a d͡ʒ ə d͡ʒ a n
койыл	kʷ a j ə l
тегощэн	ɡʷ a ɕ ə n
кудэ	kʷ ə d a
унашъхьэ	w n aː ʂ ħ a
ятэ	j aː t a
дзэкӏолӏы	d͡z a kʷ ʼ a ɬ ʼ ə
шапхъэ	ʃ aː p χ a
пӏысакӏо	p ʼ ə s aː kʷ ʼ a
етӏагъо	j a t ʼ aː ʁʷ a
хытыгъужъ	x ə t ə ʁʷ ə ʐ
кӏэхьы	t͡ʃ ʼ a ħ ə
нэгуихыгъэу	n a ɡʷ i x ə ʁ a w
куцӏы	kʷ ə t͡s ʼ ə
мэушъы	m a w ʂ ə
уахътэ	w aː χ t a
чэрэзын	t͡ʃ a r a z ə n
иупкӏын	j ə w p t͡ʃ ʼ ə n
дзэлӏы	d͡z a ɬ ʼ ə
къэлэмдалъхьэ	q a l a m d aː ɬ ħ a
фэмылъэгъун	f a m ə ɬ a ʁʷ ə n
ибэ	j ə b a
зыгъэпсэфын	z ə ʁ a p s a f ə n
кӏэлэеджакӏо	t͡ʃ ʼ a ɮ a j a d͡ʒ aː kʷ ʼ a
блэнэуц	b l a n a w t͡s
мэшӏоӏун	m a ʃʷ ʼ a ʔʷ ə n
гъэпскӏыпӏэ	ʁ a p s t͡ʃ ə p ʼ a
жьыхьарз	ʑ ə ħ aː r z
япэ	j aː p a
пэкӏо	p a kʷ ʼ a
псэлъыхъо	p s a ɬ ə χʷ a
быбэ	b ə b a
фапщэ	f aː p ʃ a
лъэужь	ɬ a w ə ʑ
пщэрыхь	p ɕ a r ə ħ
зыплъыхьын	z ə p ɬ ə ħ ə n
дыухэр	d ə w a r
гъыбзэ	ʁ ə b z a
гъунэгъу	ʁʷ ə n a ʁʷ
чыжьэу	t͡ʃ ə ʑ a w
чъыгу	t͡ʃ ʼ ə ɡʷ ə
мэхъут	m a χʷ ə t
дыйдэлъ	d ə j d a ɬ
баӏо	b aː ʔʷ a
блырыбл	b l ə r ə b l
ӏулэлын	ʔʷ ə l a l ə n
гугъэн	ɡʷ ə ʁ a n
къэпшӏэн	q a p ʃ ʼ a n
пэкъуэ	p a qʷ a
бэӏул	b a ʔʷ ə l
мэухын	m a w x ə n
зы	z ə
пындж	p ə n d͡ʒ
гумэкӏын	ɡʷ ə m a t͡ʃ ə n
чъуакъо	t͡ʃʷ aː qʷ a
къонцӏэу	qʷ a n t͡s ʼ a w
къэкӏорэгъэ	q a kʷ ʼ a r a ʁ a
лъэой	ɬ a w a j
гъэунэхъун	ʁ a w n a χʷ ʁ n
тыгъурыгъу	t ə ʁʷ r ə ʁʷ ə
напцэ	n aː p t͡s a
ӏэкӏэзын	ʔ a t͡ʃ ʼ a z ə n
кӏэп	t͡ʃ ʼ a p
хырыкӏ	x ə r ə t͡ʃ
джэнчы	d͡ʒ a n t͡ʃ ə
чэзыу	t͡ʃ a z ə w
ошӏу	w a ʃʷ ʼ ə
ешъутырын	m a ʃʷ t ə r ə h
мэджыджэн	m a d͡ʒ ə d͡ʒ a n
нэпцӏы	n a p t͡s ʼ ə
ӏуашъхьэ	ʔʷ aː ʂ ħ a
блашхъо	b l aː ʃ χʷ a
зыщыдзыен	z ə ɕ ə d͡z ə j a n
пцӏэгъоплъ	p t͡sˤ ʼ a ʁʷ a p ɬ
цацэ	t͡s aː t͡s a
гъэрэкӏо	ʁ a r a kʷ ʼ a
бэнакӏо	b a n aː kʷ ʼ a
лъэгуаджэ	ɬ a ɡʷ aː d͡ʒ a
хьазыр	ħ aː z ə r
чъыӏэ	t͡ʂ ə ʔ a
гъозэнэфы	ʁʷ a z a n a f ə
къэркъэтэн	q a r q a t a n
лъэпӏаӏо	ɬ a p ʼ aː ʔʷ a
едэӏун	j a d a ʔʷ ə n
чэцӏы	t͡ʃ a t͡sˤ ʼ ə
щтын	ɕ t ə n
хъызмэт	χ ə z m a t
гъэцохъон	ʁ a t͡sʷ a χʷ a n
пщыпащ	p ɕ ə p aː ɕ
дэхэт	d a x a t
чӏыр	t͡ʃ ʼ ə r
дэгъэкӏоен	d a ʁ a kʷ ʼ a j a n
кӏэнэкӏэн	t͡ʃ ʼ a n a t͡ʃ ʼ a n
хэпкӏэн	x a p t͡ʃ a n
лъэужьэу	ɬ a w ʑ ə m ə j
хьалэмэт	ħ aː l a m a t
рэхьэнйэл	r a ħ a n j a l
гъэпрэзэн	ʁ a p r a z a n
хэхьан	x a ħ aː n
хэдэн	x a d a n
шхэкӏын	ʃ x a t͡ʃ ʼ ə n
шъыдэу	ʂ ə d a w
кӏуснэщаб	kʷ ʼ ə s n a ɕ aː b
дасэ	d aː s a
шэфы	ʃ a f ə
гъэщтын	ʁ a ɕ t ə n
тегъэнэн	t a j ʁ a n a n
бжьэпащ	b ʑ a p aː ɕ
зыгъэухьазырын	ħ aː z ə r ə n
урам	w r aː m
фитын	f ə j t ə n
хьалыгъущапӏэ	ħ aː l ə ʁʷ ɕ aː p ʼ a
дзэ	d͡z a
къэхьуашъо	q a ħ w aː ʂʷ a
аргъой	aː r ʁʷ a j
блэнашкӏэ	b l a n aː ʃ k ʼ a
джыкӏэ	d͡ʒ ə t͡ʃ ʼ a
бзакӏо	b z aː kʷ ʼ a
пынэн	p ə n a n
плӏанэ	p ɬ ʼ aː n a
фӏэ	fˤ a
мэхъаджэ	m a χ aː d͡ʒ a
икӏодыкӏын	j ə kʷ ʼ a d ə t͡ʃ ʼ ə m
текьын	t a j kʲ ə n
къэнэхъэжьын	q a n a χ a ʑ ə n
бэлыджэпс	b a l ə d͡ʒ a p s
гыкӏын	ɣ ə t͡ʃ ə n
ӏэщхьэ	ʔ a ɕ ħ a
чӏэхьапкӏэ	t͡ʃ ʼ a ħ aː p t͡ʃ a
мэзпчэн	m a z p t͡ʃ a n
теплъэшӏу	t a j p ɬ a ʃʷ ʼ
кӏэнкӏэжъапхъэ	t͡ʃ a n t͡ʃ a ʐ aː p χ a
жъогъошӏу	ʐʷ a ʁʷ a ʃʷ
ӏэкӏэгъэхьан	ʔ ə t͡ʃ ʼ a ħ aː n
къэлэсэраи	q a l a s a r aː j ə
ку	kʷ ə
мэгъуен	m a ʁʷ ə j a n
кӏэхэкӏын	t͡ʃ a x a t͡ʃ ə n
гъогурыгъуазэ	ʁʷ a ɡʷ r ə ʁʷ aː z a
кӏэпхын	t͡ʃ ʼ a p x ə n
техакӏу	t e x aː kʷ ʼ
нэшэгъожь	n a ʃ a ʁʷ a ʑ
унэ	w ə n a
игъолъхьан	t a ʁʷ a ɬ ħ aː n
кулъэшъу	kʷ ə ɬ a ʃʷ
псыкъу	p s ə qʷ
дышъэ	d ə ʂ a
зэкӏэ	z a t͡ʃ ʼ a
армэ	aː r m a
бзыукӏалъэ	b z ə w t͡ʃ ʼ aː ɬ a
хэпыгьэн	x a p ə ɡʲ a n
щэчын	ɕ a t͡ʃ ə n
еджапӏэ	j a d͡ʒ aː p ʼ a
лъэгъуае	ɬ a ʁʷ aː j a
пцы	t͡s ə z a
згъэшъхъын	z ʁ a ʂ χ ə n
ӏэмэпсымэ	ʔ a m a p s ə m a
угь	w ə ɡʲ
дехьыен	d a j ħ ə j a n
паӏо	p aː ʔʷ a
бжъэу	b ʐ a w
чӏэ	t͡ʃ ʼ a
къоны	qʷ a n ə
былым	b ə l ə m
бжъэ	b ʐ a
куамэ	kʷ aː m a
шӏу	ʃʷ ʼ ə
губж	ɡʷ ə b ʒ
хьа	ħ aː
пчэ	p t͡ʃ a
блэун	b l a w ə n
къуалъхьэ	qʷ aː ɬ ħ a
ӏэзэгъу	ʔ a z ə ʁʷ
хэкӏодэхьын	x a kʷ ʼ a d a ħ ə n
мафэ	m aː f a
стырыпс	s t ə r ə p s
егъэзыгъ	j a ʁ a t ə ʁ
чылысы	t͡ʃ ə l ə s ə
инахэкӏэ	j ə n aː x a t͡ʃ ʼ a
ерагъкӏэ	j a r aː ʁ t͡ʃ ʼ a
чӏэхьан	t͡ʂ ʼ ə ħ a n
джанэ	d͡ʒ aː n a
ачъэ	aː t ʂ a
ешъугъун	j a ʃʷ ʁʷ ə n
орэдус	w r a d w ə s
дунае	d u n aː j a
бэлъф	b a ɬ f
тӏокӏы	tʷ ʼ a t͡ʃ ə
гъэшъхъэгъ	ʁ a ʂ χ ə ʁ a
блехын	b l a j x ə n
гъэгоӏэн	ʁ a ɡʷ a ʔ a n
тэмэжъый	b l ə p q ə ʐ ə j
апшъ	aː p ʂ
кӏэлэегьакӏо	t͡ʃ ʼ a l a j a ɡʲ aː kʷ ʼ a
гъо	ʁʷ a
хьаджыгъэпс	ħ aː d͡ʒ ə ʁ a p s
мэкуон	m ə kʷ ə w a n
цужъ	t͡sʷ ə ʐ
кӏэнкӏэ	t͡ʃ ʼ a n t͡ʃ ʼ a
ӏэпхъабэ	ʔ a p χ aː b a
пылъын	p ə ɬ ə n
ар	aː r
штэ	ɕ t a
гъэхьын	ʁ a ħ ə n
теуцон	t a j d t͡ʃʷ a n
гушӏуагъо	ɡʷ ə ʃʷ ʼ aː ʁʷ a
нэгу	n a ɡʷ
бзы	b z ə
гъэбылъын	ʁ a b ə ɬ ə n
бгъэшхъуантӏ	b ʁ a ʃ χʷ aː b tˤ ʼ
къазмакъбзыу	q aː z m aː q b z ə w
ӏэнтэгъу	ʔ a n t a ʁʷ
хьэлъэбэкъищ	ħ a ɬ a b a q i ɕ
екӏуэщэн	j a kʷ ʼ a ɕ a n
етӏапсӏэ	j a t ʼ aː p t͡s ʼ a
гъэтэрэзын	ʁ a t a r a z ə n
жъугъэхэку	ʐʷ ə ʁ a x a kʷ
зэгьэм	z a ɡʲ a m
мыст	m ə s t
бжъабгъу	b ʐ aː b ʁʷ ə
къабзэ	q aː b z a
декъыен	d a j q ə j a n
мэкъын	m a q ə n
бгъо	b ʁʷ a
зэхъокӏын	z a χʷ a t͡ʃ ʼ ə n
нысхъапэ	n ə s χ aː p a
бзэмай	b z a m aː j
чӏэбын	t͡ʂ ʼ a b ə n
щанэ	ɕ aː n a
бгъэӏас	b ʁ a ʔ aː s
быргытӏырг	b ə r ɣ ə t ʼ ə r ɣ
джэнчыдз	d͡ʒ a n t͡ʃ ə d͡z
ешӏэн	j a ʃ ʼ a n
изэу	j ə z a w
цӏынэ	t s ʼ ə n a
нэгушъо	n a ɡʷ ə ʃʷ a
былымылы	b ə l ə m ə l ə
шъхьэмажьэ	ʂ ħ a m aː ʑ a
нэбгыр	n a b ɣ ə r
кӏошын	kʷ ʼ a ʃ ə n
къэцыгъуан	q a t͡s ə ʁʷ aː n
бгъурышӏ	b ʁʷ ə r ə ʃ ʼ
хэпкӏьэн	x a p kʲ a n
мэчэрэгъун	m a t͡ʃ a r a ʁʷ ə n
пӏэтедзэ	p ʼ a t e d͡z a
гупсэфыпӏ	ɡʷ ə p s a f ə p ʼ
джыхэхьэн	d͡ʒ ə x a ħ a n
губгъо	ɡʷ ə b ʁʷ a
мэшъутырэн	j a ʃʷ t ə r ə h
псышъонт	p s ə ʂʷ a n t
бэрэчэт	b a r a k a t
зэхэкӏын	z a x a t͡ʃ ʼ ə n
къамэ	q aː m a
бэлыдж	b a l ə d͡ʒ
белэ	b a j l a
хъашъо	χ aː ʃʷ a
къэптан	q a p t aː n
шыкӏэ	ʃ ə t͡ʃ a
шъуапӏэ	ʃʷ ʼ aː p ʼ a
пщэрыхьакӏо	p ɕ a r ə ħ aː kʷ ʼ a
ӏашэнчъэ	ʔ aː ʃ a t n t͡ʂ a
теутхын	t a j a w ə t x ə n
жьызэпеу	ʑ ə z a p a j w
орэдыӏон	w a r a d ə ʔʷ a n
тхьарыӏу	t ħ aː r ə ʔʷ
къепщэн	q a j p ɕ a n
мэпсэлъэн	m a p s a ɬ a n
гъупчъ	ʁʷ ə p t͡ɕ
лъэбыӏу	ɬ a b ə ʔʷ
кушъхьэ	kʷ ə ʂ ħ a
лъэпэон	ɬ a p a w a n
бэщыӏ	b a ɕ ə ʔ
иджыри	j ə d͡ʒ ə r i
чэщтеу	t͡ʃ a ɕ t a j w
нэӏазэ	n a ʔ aː z a
пшахъо	p ʃ a χʷ a
гугъуемылӏ	ɡʷ ə ʁʷ e m ə l ʼ
армэугъ	aː r m a w ʁ
щыды	ɕ ə d ə
мэцӏыцӏын	m a t͡s ʼ ə t͡s ʼ ə n
делъэсыкӏын	d a j ɬ a s ə t͡ʃ ə n
шӏои	ʃʷ ʼ a j ə
хатэ	x aː t a
бэкъу	b a qʷ
арыти	aː r ə t i
гъэлэжьэн	ʁ a l a ʑ a n
налъэ	n aː ɬ a
алъмэкъ	aː ɬ m a q
къэхъун	q a χʷ ə n
шӏыхьагъэ	ʃ ʼ ə ħ aː ʁ a
быныуын	b ə n ə w ə n
зэхэон	q a w a n
арышъхьае	aː r ə ʂ ħ aː j a
мэтэкъон	m a t a qʷ a n
хьамплъыжь	ħ aː m p ɬ ə ʑ
кӏыхьэлыхьэ	t͡ʃ ʼ ə ħ a ɮ ə ħ a
гъэмэхъэшэн	ʁ a m a χ a ʃ a n
пӏуакӏэ	pʷ ʼ aː t͡ʃ a
шъхьэузы	ʂ ħ a w ə z ə
зэуалӏ	z a w aː ɬ ʼ
кӏьэрахъо	kʲ ʼ a r aː χʷ a
тхьамыкӏагъу	t ħ aː m ə t͡ʃ ʼ aː ʁʷ
къэкӏожьын	q a kʷ ʼ a ʑ ə n
дзакӏо	d͡z aː kʷ ʼ a
егупшысэн	j a ɡʷ ə p ʃ ə s a n
еутэкӏьын	j a w t a kʲ ʼ ə n
еджэн	j a d͡ʒ a n
мыпытэ	m ə p ə t a
пахъэ	p aː χ
кьэн	kʰ a n
тӏаркъу	t ʼ aː r qʷ
теунэхъухьан	t a j n a χʷ ə ħ aː n
ӏогъолъхьан	t a ʁʷ a ɬ ħ aː n
пхъэнтӏэкӏущыхьэ	p χ a n t ʼ a kʷ ʼ ɕ ə ħ a
гъэкӏосэн	ʁ a kʷ ʼ a s a n
кой	kʷ a j
жэкъун	ʒ a qʷ ə n
зэтелъхьэн	z a t a j ɬ ħ a n
ишӏыхьан	j ə ʃ ʼ ə ħ aː n
ӏэндыкъ	ʔ a n d ə q
пцэжъые	p t͡s a ʐ ə j a
хэтэрыкӏ	x a t a r ə t͡ʃ
егьэн	j a ɡʲ a n
мыдэ	m ə d a
бжьэмат	b ʑ a m aː t
быжъутэн	b ə ʐʷ ə t a n
урыс	w ə r ə s
тхьэкӏумэ	t ħ a kʷ ʼ m a
мэхъэшэн	m a χ a ʃ a n
стын	s t ə n
чъыгхатэ	t͡ʂ ə ɣ x aː t a
щымэхъэшэн	ɕ ə m a χ a ʃ a n
мытэрэз	m ə t a r a z
шӏомыкӏы	ʃʷ ʼ a m ə t͡ʃ ʼ
зэпачъэ	z a p aː t͡ʂ a
ишъукӏын	j ə ʃʷ ə t͡ʃ ʼ n
зэхэхуэн	z a x a xʷ a n
пчы	p t͡ʃ ə
ныбгъу	n ə b ʁʷ ə
къэшъон	q a ʂʷ a n
къухьэ	qʷ ə ħ a
хъумэн	χʷ ə m a n
сэку	s a kʷ
жэхэкӏоцэн	ʒ a x a kʷ ʼ a t͡s a n
купсэ	kʷ a p s a
бзэшӏэныгъэлӏ	b z a ʃ ʼ a n ə ʁ a ɬ ʼ
ифэн	j ə f a n
зэрэкъэлъагъорэмкӏэ	z a r a q a ɬ aː ʁʷ a r a m t͡ʃ ʼ a
гъу	ʁʷ ə
нэмыкӏ	n a m ə t͡ʃ ʼ
тхъужъ	t χʷ ə ʐ
ежьэжьын	j a ʑ a ʑ ə n
пащ	p aː ɕ
ныбэузы	n ə b a w ə z ə
уцӏэлэн	w ə t͡s ʼ a l a n
хъоу	χʷ a w
тхыцӏэ	t x ə t͡s ʼ a
ӏэпапцӏэ	ʔ a p aː p s ʼ a
къыӏэкӏэхьэн	q ə ʔ a t͡ʃ ʼ a ħ aː n
жэхэпхъэнкӏэн	ʒ a x a p χ a n t͡ʃ a n
зэшӏожьын	z a ʃʷ ʼ ə ʑ ə n
гъэцэкӏэжьын	ʁ a t͡s a t͡ʃ a ʑ ə n
шӏыкӏашӏу	ʃ ʼ ə t͡ʃ ʼ aː ʃʷ ʼ
пщын	p ɕ ə n
бырсырыл	b ə r s ə r ə l
зегъэуджэгъун	z a j ə ʁ a w d͡ʒ a ʁʷ ə n
зыушъэфын	z a w ə ʂ a f ə n
тэгъэтӏысхьэн	t a ʁ a t ʼ ə s ħ a n
мэбэнэн	m a b a n a n
зэужэу	z a w ʒ a w
зэблэдзын	z a b ɮ a d͡z ə n
гъэщтэн	ʁ a ɕ t a n
нэкӏап	n a t͡ʃ ʼ aː p
къэсшъхьэпкӏэтын	q a s ʂ ħ a p kʲ ʼ a t ə n
хэт	x a t
тэшӏыкӏын	t a ʃ ʼ ə t͡ʃ ʼ ə n
хъужьын	χʷ ə ʑ ə n
лъэгуанджэ	ɬ a ɡʷ aː n d͡ʒ a
егъэуагъ	j a ʁ a w aː ʁ
псыхъо	p s ə χʷ a
гоуцон	ɡʷ a w t͡sʷ a n
ехын	j a x ə
пцум	p t͡ʃʷ ə m
хъагъэ	χ aː ʁ a
пелыуан	p a j ɮ ə w aː n
илъэс	j ə ɬ a s
бжамэ	b ʒ aː m a
щыдэхьащхын	ɕ ə d ə ħ a ɕ x ə n
махь	m aː ħ
бжьэ	b ʑ a
хъыжъэн	χ ə ʐ a n
гъэны	ʁ a n ə
маӏьэ	m aː ʔʲ a
щынапхэ	ɕ ə n aː p x a
лэгьэн	ɮ a ɡʲ a n
адыгэбзэ	aː d ə ɣ a b z a
иусыф	j ə w s ə f
щыгъэӏэн	ɕ ə ʔ a n
мэгъэгъэн	m a ʁ a ʁ a n
ахъчэжъгъэй	aː χ t͡ʃ a ʐ ʁ a j
шифэн	ʃ i f a n
бзыукъуай	b z ə w qʷ aː j
хьэцэӏукь	ħ a t͡s a ʔʷ ə kʲ
къапщыкъ	q aː p ɕ ə q
кӏыин	m a t͡ʃ ʼ ə j ə n
арти	aː r t i
чӏэгъолъхьан	t͡ʃ ʼ a ʁʷ a ɬ ħ aː n
къыкӏышын	q ə t͡ʃ ə ʃ ə n
къарэ	q aː r a
тенэцӏэхьын	t a j n a t͡s ʼ a ħ ə n
къэшӏэжын	q a ʃ ʼ a ʑ ə n
еузэпкъын	j a w z a p q ə n
кӏодыгъошӏу	kʷ ʼ a d ə ʁʷ a ʃʷ ʼ
ныбгъэ	n ə b ʁ a
хамэ	x aː m a
мэзай	m a z aː j
бэжъу	b a ʐʷ
минитӏу	m i n i tʷ ʼ
гъэгъэн	m a ʁ a ʁ a n
нэрыплъ	n a r ə p ɬ
хьэцэӏукӏ	ħ a t͡s a ʔʷ ə t͡ʃ
дэптӏэн	d a p t ʼ a n
шэкӏ	ʃ a t͡ʃ ʼ
бгыкъу	b ɣ ə qʷ
пхэндж	p x a n d͡ʒ
деупӏэпӏэн	d a j w p ʼ a p ʼ a n
хьэӏу	ħ a ʔʷ ə
ӏэпыгъэтӏэрын	ʔ a p ə ʁ a t ʼ a r ə n
джары	d͡ʒ aː r ə
нэкӏын	n a t͡ʃ ʼ ə n
шъэжъыяц	ʂ a ʐ ə j aː t͡s
гъойщай	ʁʷ a j ɕ aː j
хьаблыу	ħ aː b l ə w
убэтэн	w ə b a t a n
пшъашъэ	p ʂ aː ʂ a
шӏэхын	ʃ ʼ a x ə n
ӏукӏыхьан	ʔʷ ə t͡ʃ ə ħ aː n
басмэ	b aː s m a
жьыдзапӏэ	ɕ ə d͡z ə p ʼ a
зэзэон	z a z a w a n
пӏысыгъэжъ	p ʼ ə s ə ʁ a ʐ
агъо	aː ʁʷ a
шъэн	ʂ a n
умыармэ	w m ə aː r m a
абрикос	ə b rʲ ɪ k o s
теутэн	t a j w ə t a n
тхьамыкӏ	t ħ aː m ə t͡ʃ
зыгъэшхэкӏын	z ə ʁ a ʃ x a t͡ʃ ʼ ə n
лъэхъан	ɬ a χ aː n
мыжъо	m ə ʐʷ a
зэпыун	z a p ə w ə n
дегупшысэн	d e ɡʷ ə p ʃ ə s a n
шъхьэкӏэфэныгъ	ʂ ħ a t͡ʃ ʼ a f a n ə ʁ
зэпымыурэ	z a p ə m ə w r a
тхьэматэ	t ħ a m aː t a
хьылъэ	ħ ə ɬ a
тфанэ	t f aː n a
кӏуадж	kʷ ʼ aː d͡ʒ
джасэ	d͡ʒ aː s a
нэкӏышъо	n a k ʼ ə ʃʷ a
цыгъо	t͡s ə ʁʷ a
гугъын	ɡʷ ə ʁ ə n
пцыкъо	p t͡s ə qʷ a
мэзгуащэ	m a z ɡʷ aː ɕ a
зэпыдагъэу	z a p ə d aː ʁ a w
ӏыгъэн	ʔ ə ʁ a n
тегъэстыкӏын	t a j ʁ a s ə t͡ʃ ʼ ə n
пцае	p t͡s aː j a
бзэ	b z a
кӏэмгуе	t͡ʃ ʼ a m ɡʷ ə j a
лъэсы	ɬ a s ə
тӏуазэх	tʷ ʼ aː z a x
бгынэжьыгъэ	b ɣ ə n a ʑ ə ʁ a
фэен	f a j a n
хэнэжьын	x a n a ʑ ə n
тӏокӏищ	tʷ ʼ a t͡ʃ i ɕ
мыгъо	m ə ʁʷ a
неущы	n e w ɕ ə
мыхъомышӏ	m ə χʷ a m ə ʃ ʼ
пыкӏэрэплъын	p ə t͡ʃ ʼ a r a p ɬ ə n
чыӏхэн	t͡ʃ ə ʔ x a n
псӏанэ	p s ʼ aː n a
тыгъун	t ə ʁʷ ə n
хъытыу	χ ə t ə w
ӏалъмэкъ	ʔ aː ɬ m a q
гъэпхын	j a ʁ a p x ə n
лъыкӏошъэн	ɬ ə kʷ ʼ a ʂ a n
кӏэгьэн	t͡ʃ ʼ a ɡʲ a n
еубзэн	j a w ə b z a n
гъоу	ʁʷ a w
нысащэ	n ə s aː ɕ a
хэкӏутэн	x a kʷ ʼ ə t a n
чӏыкъу	t͡ʃ ə qʷ
ихьан	j ə ħ aː n
гъэшъхъын	ʁ a ʂ ə χ ə n
ошъогу	w a ʂʷ a ɡʷ
бэйкол	b aː kʷ a l
лъакъо	ɬ aː qʷ a
бэдзэубыт	b a d͡z a w b ə t
ебэун	b a w a n
гъалэ	ʁ aː ɮ a
бжъащэ	b ʐ aː ɕ a
шъхьас	ʂ ħ aː s
бзудэгу	b z ə w d a ɡʷ
ӏоныгъомаз	ʔʷ a n ə ʁʷ a m aː z
пхэ	p x a
упэпцӏын	w p a p t͡s ʼ ə n
гъэгьэн	ʁ a ɡʲ a n
шъхьарыхъон	ʂ ə ħ aː r ə χʷ a n
джынэузэщ	d͡ʒ ə n a w z a ɕ
кӏырыун	t͡ʃ ʼ ə r ə w ə n
къокӏьын	qʷ a kʲ ʼ ə n
ӏукьын	ʔʷ a kʲ ə n
махълъэ	m aː χ ɬ a
бамыкӏ	b aː m ə k
орэдаӏу	w a r a d aː ʔʷ
чӏыбжь	t͡ʃ ə b ʑ
арымэ	aː r ə m a
ычӏэгъ	ə t͡ʃ ʼ a ʁ
бгъусы	b ʁʷ ə s ə
бэткэлӏ	b a t k a ɬ ʼ
жъугъ	ʐʷ ə ʁ
хьалжъогъуан	ħ aː l ʐʷ a ʁʷ aː n
фӏэжъыуфӏ	fˠ a ʐ ə w fˠ
джын	d͡ʒ ə n
шъхьадэхьан	ʂ ħ aː d a ħ aː n n
гъучӏӏунэ	ʁʷ ə t͡ʂ ʼ ə ʔʷ ə n a
шыгу	ʃ ə ɡʷ
шъыдигъо	ʂ ə d ʁʷ a
тӏурытӏу	tʷ ʼ ə r ə tʷ ʼ
шыхъон	ʃ ə χʷ a n
пхъу	p χʷ ə
шъхьэӏатынгъэ	ʂ ħ a ʔ aː t ə n ʁ a
гъэтхапэмаз	ʁ a t x aː p a m aː z
гукъэкӏьын	ɡʷ ə q a kʲ ʼ ə n
езбэрэу	j a z b a r a w
шъитӏу	ʂ i tʷ ʼ
ӏулӏэн	ʔʷ ə ɬ ʼ a n
тезын	t a j z ə n
мылъфыкъо	m ə ɬ f ə qʷ a
мэтэн	m a t a n
псыжъ	p s ə ʐ
джырэ	d͡ʒ ə r a
пхъэнтӏэкӏу	p χ a n t ʼ a kʷ ʼ
машэ	m aː ʃ a
жъэжъый	ʐ a ʐ ə j
кӏэлэгъу	t͡ʃ a l a ʁʷ
быраб	b ə r aː b
панэ	p aː n a
чэфынчъэн	t͡ʃ a f ə n t͡ʂ a n
шъофы	ʂʷ a f ə
тӏуакӏэ	tʷ ʼ aː t͡ʃ ʼ a
зышӏошӏужьын	z ə ʃʷ ʼ ə ʃʷ ʼ a ʑ ə n
бэрэскэшху	b a r a s k a ʃ xʷ
кӏэлъыун	t͡ʃ ʼ a ɬ ə w ə n
лъэдакъэ	ɬ a d aː q a
кӏэкъэпс	t͡ʃ a q a p s
сӏэ	s ʼ a
мэракӏуапцӏэ	m a r aː kʷ ʼ aː t͡s ʼ a
пхъацӏэ	p χ aː t͡s a
гъэушӏоин	ʁ a w ʂʷ a j ə n
зэкӏэчъэн	z a t͡ʃ ʼ a t͡ʂ a n
хэгъэузыкӏьын	x a ʁ a w z e kʲ ə n
бгъунджырыкӏу	b ʁʷ ə n d͡ʒ ə r ə kʷ ʼ
шъухъуатӏэ	ʂʷ ə χʷ aː tˤ ʼ a
ӏекӏын	ʔʲ a t͡ʃ ʼ ə n
гъэпэн	ə ʁ a p a n
гъэщынэн	ʁ a ɕ ə n a n
мэр	m a r
хэщыжьын	x a ɕ ə ʑ ə n
быкӏу	b ə kʷ ʼ ə
шъуакӏо	ʂʷ aː kʷ ʼ a
фылым	f ə l ə m
шъыхьэ	ʂ ə ħ a
хъуанэ	χʷ aː n a
шъхьэпэкӏьын	ʂ ħ a p a kʲ ʼ ə n
шэкӏогъумаз	ʃ a kʷ ʼ a ʁʷ ə m aː z
зэблэкьын	b l a p kʲ ə n
мэлэкӏэн	m a l a t͡ʃ a n
шъхьапцӏэ	ʂ ħ aː p t͡s ʼ a
хэкъэхьын	x a q a ħ ə n
епщэн	j p ɕ a n
шъуты	ʃʷ ə t ə
шъухъогъон	ʃʷ ə χʷ a ʁʷ a n
бгъэн	b ʁ a n
бынынчъэ	b ə n ə n t͡ʃ a
мэфэку	m a f a kʷ
сӏын	s ʼ ə n
езэгъын	j a z a ʁ ə n
щыгушӏукӏын	ʃ ə ɡʷ ə ʃʷ ʼ t͡ʃ ʼ ə n
фыгу	f ə ɡʷ
къихын	q ə j x ə n
пчъын	p t͡ʃ ə n
мэон	m a w a n
нэӏу	n a ʔʷ
чылапхъ	t͡ʃ ə l aː p χ
фэмыф	f a m ə f
гъэутэшъон	ʁ a w t a ʃʷ a n
пыукӏын	p ə w t͡ʃ ʼ ə n
мэджэгун	m a d͡ʒ a ɡʷ ə n
цые	t͡s ə j a
гъогын	ʁʷ a ɣ ə n
дэгу	d a ɡʷ ə
быдзыщ	b ə d͡z ə ɕ
бжьэцы	b ʑ a t͡s ə
натӏэ	n aː t ʼ a
енэпэшъоон	j a n a p a ʃʷ a w a n
бжыхьэ	b ʒ ə ħ a
тхьапэ	t ħ aː p a
зандэ	z aː n d a
дэкӏогъу	d a kʷ ʼ a ʁʷ
ӏэбычъу	ʔ a b ə t͡ʃʷ
мэл	m a l
дэлъыпӏэ	d a ɬ ə p ʼ a
тэтхыкӏын	t a t x ə t͡ʃ ʼ ə n
гуеӏун	ɡʷ j a ʔʷ ə n
икъугъэ	j ə qʷ ə ʁ a
пытӏэрын	p ə t ʼ a r ə n
ощы	w a ɕ ə
ехъушъутэон	χʷ ə ʂʷ t a w a n
зэтэлъхьэн	z a t a ɬ ħ a n
кӏочӏагъэ	kʷ ʼ a t͡ʃ ʼ aː ʁ a
деушъэн	d a j ʂ a n
нэхай	n a x aː j
бзыфы	b z ə f ə
шъэгьашъ	ʂ a ɡʲ aː ʂ
гумыӏан	ɡʷ ə m ə ʔ aː n
мышъыпкъэ	m ə ʂ ə p q a
делэщ	d a j l a ɕ
быркусын	b ə r kʷ ʁ s ə n
пцатхьэ	p t͡s aː t ħ a
гукъэкӏьыжьын	ɡʷ ə q a kʲ ʼ ə ʑ ə n
шъхьацы	ʂ ħ aː t͡ʃ ə
цӏэтхын	t͡s ʼ a t x ə n
даут	d a w ə t
бэкъогъу	b a qʷ a ʁ w
ныбыдж	n ə b ə d͡ʒ
иныжъ	j ə n ə ʐ
пыут	p ə w ə t
гъэшъуен	ʁ a ʂʷ j a n
ӏьалэ	ʔʲ aː l a
къуапцӏэ	qʷ aː p t͡s ʼ a
хъыкӏы	χ ə t͡ʃ ʼ ə
пкъэу	p q a w
блегъэзыкӏын	b l a j ʁ a z ə kʲ ə n
къикӏын	q ə j t͡ʃ ʼ ə n
щысэ	ɕ ə s a
азэнаджапӏ	aː z a n aː d͡ʒ aː pˤ
дыхьэщхын	d ə ħ a ɕ x ə n
абыкъу	aː b ə qʷ
егьапӏэ	j a ɡʲ aː p ʼ a
мэдэӏон	m a d a ʔʷ a n
лъэныкъуащ	ɬ a n ə qʷ aː ɕ
папсӏэ	p aː p s ʼ a
апшъэр	aː p ʂ a r
гъэчъэхын	j a ʁ a t͡ʂ a x ə n
дехын	d a j x ə x
оркъ	w a r q
джантый	d͡ʒ aː n t ə j
лъэхэнэн	ɬ a x a n a n
ушыгун	w ə ɕ ə ɡʷ ə n
хэпыджэн	x a p ə d͡ʒ a n
къэрал	q a r aː ɮ
чэл	t͡ʃ a l
ӏэлъын	ʔ a ɬ ə n
зэготӏэпӏыкӏын	z a ɡʷ a t ʼ a p ʼ ə t͡ʃ ʼ ə n
кьэтыу	kʲ a t ə w
мэшӏыкӏьэен	m a ʃ ʼ ə kʲ ʼ a j a n
шэплъы	ʃ a p ɬ ə
пцӏапӏэ	p t͡sˤ ʼ aː pˤ ʼ a
сэпэон	ɬ a p a w a n
шӏыбзыу	ʃ ʼ ə b z ə w
быдзылъ	b ə d͡z ə ɬ
уэнтэгъу	w a n t a ʁʷ
тэгъэфэн	t a ʁ a f a n
гуп	ɡʷ ə p
хьэнцийгуащэ	ħ a n t͡s i j ɡʷ aː ɕ a
пкӏэнчъ	p t͡ʃ ʼ a n t͡ʂ
уыбэтэн	w ə b a t a n
жэукъ	ʒ a w q
чӏэлъхьан	t͡ʂ ʼ a ɬ ħ a n
пӏуанкӏэ	pʷ ʼ aː n t͡ʃ a
къыпцӏэ	q ə p t͡ʃ a
къошъобэщ	qʷ a ʂʷ a b a ɕ
улэлэн	w ə l a l a n
къохьан	qʷ a ħ aː n
шӏугъэ	ʃʷ ʼ ə ʁ a
хьэб	ħ a b
бгъэгъакӏ	b ʁ a ʁ aː t͡ʃ
щапӏэ	ɕ aː p ʼ a
къэлъы	q a ɬ ə
чэщныкъо	t͡ʃ a ɕ ə n ə qʷ a
нэпэшъоон	n a p a ʃʷ a w a n
тыны	t ə n ə
лъышӏэжь	ɬ ə ʃ ʼ a ʑ
ӏэпэпс	ʔ a p a p s
жэхэкӏотэн	ʒ a x a kʷ ʼ a t a n
ӏэбжъэнэпыупкӏы	ʔ a b ʐ a n a p ə w p t͡ʃ ə
псыгу	p s ə ɡʷ ə
адэ	aː d a
хъыу	χ ə w
хъэдз	χ a d͡z
ӏэхъогъу	ʔ a χʷ a ʁʷ
лъэпэпсӏий	ɬ a p a p s ʼ ə j
бгъу	b ʁʷ ə
ахъщэдэфый	aː χ ʃ a d a f ə j
гын	ɣ ə n
шъуампӏэ	ʃʷ ʼ aː m p ʼ a
жэӏулэлыгъ	ʒ a ʔʷ ə l a l ə ʁ
хъан	χ aː n
еузэнкӏын	j a w z a n t͡ʃ ə n
къэжьын	q a ʑ ə n
самбырын	s aː m b ə r ə n
хэгъолъхьан	x a ʁʷ a ɬ ħ aː n
кӏьэтхъэн	kʲ ʼ a t χ a n
гунахь	ɡʷ ə n aː ħ
щыгъэзын	z ə ɕ ə ʁ a ʁʷ ə p ʃ ə n
къухьэбыб	qʷ ə ħ a b ə b
хэгущыӏэхьан	x a ɡʷ ə ɕ ə ʔ a ħ aː n
бжьыныфщыгъу	b ʑ ə n ə f ɕ ə ʁʷ
пыгъэун	p ə ʁ a w ə n
тӏэрэхын	t ʼ a r a x ə n
зэпырыкӏын	z a p ə r ə t͡ʃ ʼ ə n
укӏьытапх	w kʲ ʼ ə t aː p x
амырмэ	aː m a r m a
лъэкъуацӏэ	ɬ a qʷ aː t͡s ʼ a
жъоныгъуакӏ	ʐʷ a n ə ʁʷ aː t͡ʃ
гыкӏыгъ	ɣ ə t͡ʃ ʼ ə ʁ
ыгъэпэн	ə ʁ a p a n
лъэпапцӏэ	ɬ a p aː p t͡s ʼ a
къэгъэфын	q a ʁ a f ə n
елъэпэон	j a ɬ a p a w a n
мэплъын	m a p ɬ ə n
тхьашъуегъэпсэу	t ħ aː ʂʷ e ʁ p s a w
еубын	j a w b ə n
хьэдрыхэ	ħ a d r ə x a
жэхэупцӏэн	ʒ a x a w p t͡s ʼ a n
фэшӏкӏэ	f a ʃ ʼ ə t͡ʃ ʼ a
дыйшъоутын	d ə j ʃʷ a w t ə n
джэгъун	d͡ʒ a ʁʷ ə n
ӏапӏэ	ʔ aː p ʼ a
къыин	q ə j ə n
адыгэхэ	aː d ə ɣ a x a
зэгоожьын	z a ɡʷ a w a ʑ ə n
хъупӏэжьец	χʷ ə pˤ ʼ a ʑ j a t͡s
бжъэкумыл	b ʐ a kʷ ə m ə l
гъэлъэпӏэн	ʁ a ɬ a p ʼ a n
хэгъэгэжьын	x a ʁ a n a ʑ ə n
ятэш	j aː t a ʃ
егъуин	j a ʁʷ ə j ə n
жэдэлъхьажьын	ʒ a d a ɬ ħ aː ʑ ə n
зыци	z ə t͡s ə j
лъэгъун	p ɬ a ʁʷ ə n
сако	s aː kʷ a
бзыукӏэплъ	b z ə w kʲ a p ɬ
гъэухьазырын	ħ aː z ə r ə n
пкӏэшъэхъу	p t͡ʃ a ʂ a χʷ
ятӏэ	j aː t ʼ a
быгъу	b ə ʁʷ
нэӏуасэ	n a ʔʷ aː s a
пэлэлэжъ	p a l a l a ʐ
кӏон	kʷ ʼ a n
жъуагъо	ʒʷ aː ʁʷ a
лъэшы	ɬ a ʃ ə
къолэнсэлэн	qʷ a l a n s a l a n
ӏа	ʔ aː
дежъыуакӏо	d a j ʐ ə w aː kʷ a
пыскӏэн	p ə s t͡ʃ a n
жъгъэй	ʐ ʁ a j
бзаджэ	b z aː d͡ʒ a
бгъалъэ	b ʁ aː ɬ a
ешъокӏу	j a ʂʷ a kʷ ʼ
ныбджэгъу	n ə b d͡ʒ a ʁʷ
хьэблыу	ħ a b l ə w
тэцӏэшъутыкӏын	t a t͡s ʼ a ʃʷ t ə t͡ʃ ʼ ə n
жьышъхьал	ʑ ə ʂ ħ aː l
шъхьакӏун	ʂ ħ aː kʷ ʼ ə n
кӏын	t͡ʃ ʼ ə n
гэ	ɣ a
къын	q ə n
щытапхэ	ɕ t aː p x a
апшъышъ	ʔ aː p ʂ ə ʂ
пэмкӏыр	p a m t͡ʃ ə r
щэкьын	ɕ a kʲ ə n
мэчэрэзын	m a t͡ʃ a r a z ə n
пхъэтакъэ	p χ a t aː a q a
быратӏ	b ə r aː t ʼ
нэшакӏэ	n a ʃ aː kʲ ʼ a
тыгъэпсы	t ə ʁ a p s ə
пхъэтӏэкӏу	p χ a t ʼ a kʷ ʼ
куашъу	kʷ ʼ aː ʃʷ a
тыгъэ	t ə ʁ a
ныӏэ	n ə ʔ a
непэ	n a j p a
зэкӏон	z a kʷ ʼ a n
пызын	p ə z ə n
щтыргъукӏы	ɕ t ə r ʁʷ ə t͡ʃ
ахъчэ	aː χ t͡ʃ a
ецӏэтхъун	j a t͡s ʼ a t χʷ ə n
гьэфы	ɡʲ a f ə
мэжъутхэн	m a ʒʷ ə t x a n
къазмэ	q aː z m a
псэонгъэ	p s a w a n ʁ a
чылэгъу	t͡ʃ ə ɮ a ʁʷ
къэсын	q a s ə n
ебз	j a b z
мыгьыр	m ə ɡʲ ə r
шӏошӏухъуныгъэ	ʃʷ ʼ a ʃʷ ʼ χʷ ə n ʁ a
тары	t aː r ə
ау	aː w
шъоущыгъу	ʃʷ a w ɕ ə ʁʷ
бгычӏэ	b ɣ ə t ʂ a
бэон	b a w a n
щыр	ɕ ə r
хэкӏэн	x a t͡ʃ ʼ a n
гъуен	ʁʷ ə j a n
сымэджэдэй	s ə m a d͡ʒ a d a j
ыгупэн	ə ɡʷ ə p a n
блыгучӏ	b l ə ɡʷ t͡ʃ
бэдзау	b a d͡aː w
бадзэ	b aː d͡z a
лъэпэд	ɬ a p a d
жэукъыгъ	ʒ a w q ə ʁ
фэшъуашэу	f a ʃʷ aː ʃ a w
плъэкӏун	p ɬ a kʷ ʼ ə n
гъэдэӏон	ʁ a d a ʔʷ ə n
зэхэдзын	z a x a d͡z ə n
такъэ	t aː q a
кӏэщакӏо	t͡ʃ a ɕ aː kʷ ʼ a
плъыр	p ɬʲ ə r
шъхьэатынгъэ	ʂ ħ a ʔ aː t ə n ʁ a
пӏэстхъэн	p ʼ a s t χ a n
бэрэскэжъый	b a r a s k a ʐ ə j
нэпкъы	n a p q ə
утэшъон	w t a ʃʷ a n
чхыӏан	t͡ʃ x ə ʔ aː n
кӏый	kʲ ʼ ə i j
уащхъуэ	w aː ɕ χʷ a
джынэ	d͡ʒ ə n a
хыуай	x ə w a j
тхьэтын	t h a t ə n
цӏыун	t͡s ʼ ə w ə n
блэбгъуп	b l a b ʁʷ ə p
гьэгуалъэ	ɡʲ a ɡʷ aː ɬ a
зэӏэгъэхьэн	z a ʔ a ʁ a ħ a n
апхъурэлъф	aː p χʷ ə r a ɬ f
чъуман	t͡ʃʷ ə m aː n
бэслъыный	b a s ɬ ə n ə j
ӏофы	ʔʷ a f ə
нэкулъ	n a kʷ ə ɬ
бжыхьэбадзэ	b ʒ ə ħ a b aː d͡z a
къэраб	q a r aː b
къэцӏыон	q a t͡s ʼ ə w a n
шъомпӏэжъ	ʃʷ a m p ʼ a ʐ
енэцӏын	j a n a t͡s ʼ ə n
джыбэ	d͡ʒ ə b a
бгынтӏэ	b ɣ ə n tˤ ʼ a
щэмэдж	ɕ a m a ɡʲ ʼ
хьао	ħ aː w a
кӏэрхъон	t͡ʃ ʼ a r χʷ a n
шыу	ʃ ə w
ӏумпэм	ʔʷ a m p a m
ӏудан	ʔʷ ə d aː n
шыдзыен	ʃ ə d͡ʒ ə j a n
жэлъакӏу	ʒ a ɬ aː kʷ ʼ
жэхэплъэн	ʒ a x a p ɬ a n
мэгущыӏэн	m a ɡʷ ɕ ə ʔ a n
зэпыкӏьын	z a p ə kʲ ʼ ə n
блантхъэ	b l aː n t χ a
майтэ	m aː j t a
къэгъэхын	q a ʁ a x ə n
джанкъылъыщ	d͡ʒ aː n ə ɬ ə ɕ
джэгуалъэ	d͡ʒ a ɡʷ aː ɬ a
пхъэцӏакӏэ	p χ a t͡s ʼ aː t͡ʃ a
гъогу	ʁʷ a ɡʷ
къарыу	q aː r ə w
бжъалъ	b ʐ aː ɬ
егыин	j a ɣ ə j ə n
гоӏэн	ɡʷ a ʔ a n
тӏуӏугъэ	tʷ ʼ ə ʔʷ ə ʁ a
пщэрыхьан	p ɕ a r ə ħ aː n
атэш	ʔ aː t a ʃ
куон	kʷ ə w a n
мэу	m a w
дэгъэуцон	d a ʁ a w a t͡sʷ a n
жьыбгъэ	ʑ ə b ʁ a
щао	ʃ aː w a
хегъэхын	x a x ə n
ӏэгьэ	ʔ a ɡʲ a
бжыб	b ʒ ə b
ӏэтэгъу	ʔ a t a ʁʷ
мэзэкӏон	z a kʷ ʼ a n
дэхьэзэ	d a ħ a z a
кӏьэхьылэхь	kʲ ʼ a ħ ə l a ħ
жъот	ʐʷ a t
хьатыр	ħ aː t ə r
пцӏанэ	p t͡s ʼ aː n a
пэгъокӏьын	p a ʁʷ a kʲ ə n
щагуикӏыпӏэ	ɕ aː ɡʷ i t͡ʃ ə p ʼ a
хьазырын	ħ aː z ə r ə n
дэтэкъун	d a t a qʷ ə n
бжьэпчӏ	b ʑ a p t͡ʃ
укӏытапхэ	w t͡ʃ ʼ ə t aː p x
къыӏэхын	q ə ʔ a x ə n
тхылъӏыгъыпӏэ	t x ə ɬ ʔ ə ʁ ə p ʼ a
тхьабыл	t ħ aː b ə l
пытын	p ə t ə n
псэлъыхъон	p s a ɬ ə χʷ ə n
джэгъогъу	d͡ʒ a ʁʷ ə ɡʷ
натрыф	n aː t r ə f
къолай	qʷ l aː j
хъонэн	χʷ a n a n
хьадэгъу	ħ aː d a ʁʷ
гудэ	ɡʷ ə d a
жъуагъэ	ʐʷ aː ʁ a
шӏоилъ	ʃʷ ʼ a j ə ɬ
ешъухъугъон	j a ʃʷ χʷ ə ʁʷ a n
шӏокӏон	ʃʷ ʼ a kʷ ʼ a n
гъэстын	ʁ a s t ə n
хьэдэпчэмыӏу	ħ a d a p t͡ʃ a m ə ʔʷ
тепсэн	t a j p s a n
лъэхъаны	ɬ a χ aː n ə
жьэу	ʑ a w
кӏьапсэ	kʲ ʼ aː p s a
шъуз	ʂʷ ə z ə
сае	s aː j a
насыпынчъэ	n aː s ə p ə n t͡ʂ
бгынагъэ	b ɣ ə n aː ʁ a
батыр	b aː t ə r
бэджэндыку	b a d͡ʒ a n d a kʷ
аслъан	ʔ a s ɬ aː n
благъэ	b l aː ʁ a
шӏойбэхь	ʃʷ ʼ a j b a ħ
бэщышӏ	b a ɕ ə ʃ ʼ
шъхьасын	ʂ ħ aː s ə n
дэгъэдыдыкӏын	d a ʁ a d ə d ə kʲ ə n
ӏэшӏэх	ʔ a ʃ ʼ a x
псапэ	p s aː p a
бэгын	b a ɣ ə n
бжъакъэ	b ʐ aː q a
къэгъэхъэн	q a ʁ a χ a n
дзуцон	d͡zʷ ə t͡sʷ a n
сӏынэ	s ʼ ə n a
гъэпшъын	ʁ a p ʂ ə n
гъатхэ	ʁ aː t x a
тыркъо	t ə r qʷ a
кӏэлэегъадж	t͡ʃ ʼ a ɮ a ʁ aː d͡ʒ
бгъузапӏэ	b ʁʷ ə z aː pˤ ʼ a
гъугъэ	ʁʷ ə ʁ a
мэхъыен	m a χ ə j a n
цуабзэ	t͡sʷ aː b z a
зыщэӏэн	z ə ɕ a ʔ a n
шъуялъэ	ʃʷ ə j aː ɬ a
лӏэныгъ	ɬˤ ʼ a n ə ʁ
къизын	q i z ə n
пӏуаблэ	pʷ ʼ aː b ɮ a
хъот	χʷ a t
бжъанэ	b ʐ aː n a
къарэу	q aː r a w
нэӏэбэсын	n a ʔ a b a s ə n
тгъосэнэхьпэ	t ʁʷ a s a n a ħ p a
бэдзэрыкӏу	b a d͡z a r ə kʷ ʼ
зэплъэкӏыгъу	z a p ɬ a t͡ʃ ʼ ə ʁʷ
ӏолӏэн	ʔʷ a ɬ ʼ a n
бзукӏэзэгох	b z ə w t͡ʃ a z a ɡʷ a x
кукуу	kʷ ə kʷ ə w
жашӏу	ʒ aː ʃʷ ʼ
тӏэкӏу	t ʼ a kʷ ʼ
еджыджэхын	j a d͡ʒ ə d͡ʒ a n
жъугъэпащ	ʐʷ ə ʁ a p aː ɕ
къэхъушъун	q a χʷ ə ʃʷ ə n
шхонч	ʃ xʷ a n t͡ʃ
бэгу	b a ɡʷ
унэгъуацӏэ	w ə n a ʁʷ a t͡s ʼ a
къэщэкьын	q a ɕ a kʲ ə n
лэныстэ	l a n ə s t a
къиякъ	q i j aː q
гопэн	ɡʷ a p a n
мэз	m a z
гъымакъэ	ʁ ə m aː q a
техьагъу	t a j ħ aː ʁʷ
чэмы	t͡ʃ a m ə
гъэжъон	ʁ a ʒʷ a n
бжымы	b ʒ ə m ə
дыу	d ə w
чӏэухъумэ	t͡ʂ ʼ a w χʷ ə m a
джыхэкӏотэн	d͡ʒ a x a kʷ ʼ a t a n
ридзын	r ə j d͡ʒ ə n
жъогъорыплъ	ʐʷ a ʁʷ a r ə p ɬ
шъэджэшъэжъ	ʂ a d͡ʒ aː ʂ ə ʐ
анэхь	aː n a ħ
пшӏанэ	p ʃ ʼ aː n a
къуэдэс	qʷ a d a s
идзэн	j ə d͡z a n
хьантхъупсы	ħ aː n t χʷ ə p s ə
ӏухын	ʔʷ ə x ə n
хыгъэхъунэныкъу	x ə ʁ a χʷ ə n a n ə qʷ ə
бжыхьапэ	b ʒ ə ħ aː p a
гъэкьэрэзын	ʁ a kʲ a r a z ə n
шъэфы	ʂ a f ə
бэежъ	b a j a ʐ
иен	j a j ə n
пкӏэ	p t͡ʃ ʼ a
еджэжьын	d͡ʒ a ʑ ə n
еӏорышӏэн	j a ʔʷ a r ʃ ʼ a n
къухьэтӏысыпӏ	qʷ ə ħ a t ʼ ə s ə p ʼ
шъынэ	ʂ ə n a
фэрэхьатын	f a r a ħ aː t ə n
ежэн	j a ʒ a n
хьэлъэбакъо	ħ a ɬ a w b aː q
мэпцӏын	m a p t͡s ʼ ə n
ибэдалэу	j ə b a d aː l a w
гъэпсэн	ʁʷ a t ə n
нэмысыпэу	n a m ə s ə p a w
дебзын	d e b z ə n
гупсэф	ɡʷ ə p s a f
блыныкӏ	b l ə n ə t͡ʃ
фэщэӏэн	f a ɕ a ʔ a n
коц	kʷ a t͡s
жьыуз	ʑ ə w z
тыгъужъ	t ə ʁʷ ə ʐ
зэӏунын	z a ʔʷ ə n ə n
къошъошӏы	qʷ a ʂʷ a ʃ ə
деӏэтаен	d e ʔ a t aː j a n
зэгокӏын	z a ɡʷ a t͡ʃ ʼ ə n
къохьэн	qʷ a ħ a n
лъэгъуен	ɬ a ʁʷ ə j a n
укӏьытэн	w ə kʲ ʼ ə t a n
пыгъэхьан	p ə ʁ a ħ aː n
енэгуй	j a n a ɡʷ ə j
гъашӏэ	ʁ aː ʃ ʼ a
нысэпхъапэ	n ə s a p χ aː p a
бзыгъ	b z ə ʁ
мэпӏэркӏьын	m a p ʼ a r kʲ ə n
кӏьэлъыун	kʲ ʼ a ɬ ə w ə n
шъыпкъэмкӏэ	ʂ ə p q a m t͡ʃ ʼ a
лъашъхьэ	ɬ aː ʂ ħ a
шӏокӏын	ʃʷ ʼ a t͡ʃ ʼ ə n
фэпсӏын	f a p s ʼ ə n
узы	w ə z ə
жыфлъат	ʑ ə f ɬ aː t
чэупчъэ	t͡ʃ a w ə p t͡ʂ a
нахэ	n aː x a
кӏэтхъун	t͡ʃ ʼ a t χʷ ə n
хэӏэбэн	x a ʔ a b a n
гъэзэзэн	ʁ a z a z a n
къэгъэгъунэн	q a ʁ a ʁ a ʁʷ ə n a n
жъый	ʐ ə j
зуагъуэ	zʷ aː ʁʷ a
еӏэзэн	j a ʔ a z a n
шӏуабэ	ʃʷ ʔ aː b a
армэу	aː r m a w
чӏырыкӏу	t͡ʃ ə r ə kʷ
быргусыргу	b ə r ɡʷ ə s ə r ɡʷ
егъэтын	j a ʁ a t ə n
мэцӏыон	m a t͡s ʼ ə w a n
шхын	ʃ x əː n
стыгъэ	s t ə ʁ a
шкӏэ	ʃ k ʼ a
лъышӏэжьын	ɬ ə ʃ ʼ a ʑ ə n
нэгушӏу	n a ɡʷ ə ʃʷ ʼ
бгы	b ɣ ə
къыхэущыкӏьын	q ə x a w ɕ ə kʲ ʼ ə n
гъэунэн	ʁ a w ə n ə n
енэгуен	j a n a ɡʷ ə j a n
хэгъэкӏын	x a ʁ a t͡ʃ ə n
угьын	w ə ɡʲ ə n
деузэнкӏын	d a j w z a n t͡ʃ ə n
ашъуихьан	aː ʃʷ i ħ aː n
тхьаусхэн	t ħ aː w ə s x a n
пхъуант	p χʷ aː n t
башэ	b aː ʃ a
даргу	d aː r ɡʷ
ӏужъу	ʔʷ a ʐʷ ə
жьыгъэбыб	ʑ ə ʁ a b ə b
дао	d aː w a
къыӏэпхъотэн	q ə ʔ a p χʷ a t a n
кӏоцӏыщыхьэн	kʷ ʼ a t͡s ʼ ə ɕ ə ħ a n
ӏорышӏэн	ʔʷ a r ʃ ʼ a n
хъатэ	χ aː t a
етӏагъу	j a t ʼ aː ʁʷ
фэ	f a
щэхьын	ɕ a ħ ə n
шэшэн	ʃ a ʃ a n
сотрэш	s o t r a ʃ
пшысэ	p ʃ ə s a
тхьауегъэпсэу	t ħ aː w a j ʁ a p s a w
къэц	q a t͡s
адэм	ʔ aː d a m
гуао	ɡʷ aː w a
гъэрэкӏопагъэ	ʁ a r a kʷ ʼ a p aː ʁ a
мэмэхъэшэн	m a m a χ a ʃ a n
пызы	p ə z ə
къэгъэнэжьын	q a ʁ a n a ʑ ə n
пхъапэ	p χ aː p a
хьакӏэкъуакӏэ	ħ aː t͡ʃ a qʷ aː t͡ʃ a
бжъау	b ʐ aː w
мыжъодэбыш	m ə ʐʷ a d a m ə ʃ
дагъо	d aː ʁʷ a
мэтӏыгъон	m ə t ʼ ə ʁʷ a m
дэлъхьэн	d a ɬ ħ a n
къегъоин	q a j ʁʷ a j ə n
лъыхъун	ɬ ə χʷ ə n
жъоку	ʐʷ a kʷ
мэшъухъугъон	m a ʃʷ χʷ ə ʁʷ a n
зыгокӏэ	z ə ɡʷ a r a t͡ʃ ʼ a
гъэӏонтӏэн	ʁ a ʔʷ a n t ʼ a n
мыхъумыбз	m ə χʷ ə m ə b z
рсысын	s ə s ə n
кӏоцӏыхьан	kʷ ʼ a t͡s ʼ ə ħ aː n
псэхалӏэ	p s a x a ɬ ʼ z
зэхэгъэшъухъон	z a x a ʁ a ʃʷ ə χʷ a n
зыгъэпсыкӏын	z ʁ a p s t͡ʃ ʼ ə n
арап	aː r aː p
тэщгъум	t a ɕ ʁʷ ə m
гъэпсэфакӏо	ʁ a p s a f aː kʷ ʼ a
пшъэшъэгъу	p ʂ a ʂ a ʁʷ
мэпкӏэн	m a p t͡ʃ ʼ a n
телӏэхьын	t a j ɬ ʼ a ħ ə n
езбырэу	j a z b ə r a w
цӏыфхэ	t͡s ʼ ə f x a
мэутэшъон	w t a ʃʷ a n
нэхь	n a ħ
уанэ	w aː n a
мэхапӏэ	m a x aː p ʼ a
псыгъэхъун	p s ə ʁ a χʷ ə n
дае	d aː j a
гушӏуагъэ	ɡʷ ə ʃʷ ʼ aː ʁ a
губгъэ	ɡʷ ə b ʁ a
мэпшъын	m a p ʂ ə n
фэгоӏэн	f a ɡʷ a ʔ a n
хьэбзу	ħ a b z ə w
хыгъэхъун	x ə ʁ a χʷ ə n
жьыхъырз	ʑ ə χ ə r z
цӏэрыӏу	t͡s ʼ a r ə ʔʷ
ӏэпызын	ʔ a p ə z ə n
жьыӏо	ʑ ə ʔʷ a
мэбзэен	m a b z a j a n
хьантыкъуакъу	ħ a n t ə qʷ aː qʷ
дэгъэптӏэн	d a ʁ a p t ʼ a n
пшъэшъэжъые	p ʂ a ʂ a ʐ ə j a
къылъыкӏотэн	q ə ɬ ə kʷ ʼ a t a n
уцӏынын	w ə t͡s ʼ ə n ə n
шэнтэ	ʃ a n t a
штэн	ʃ t a n
ныожъ	n ə w a ʐ
кӏежьэжьын	ʔʷ a r ə ʃ ʼ a
мэхьанэ	m a ħ aː n a
зыцый	z ə t͡s ə j
жьыгъогу	ʑ ə ʁʷ a ɡʷ
плъыжьгьэф	p ɬ ə ʑ ɡʲ a f
хьэнцэ	ħ a n t͡s a
ӏон	ʔʷ a n
жъыӏо	ʐ ə ʔʷ a
дэкӏояпӏэ	d a kʷ ʼ a j aː p ʼ a
ожъубанэхьэмлыу	w a ʐʷ b aː n a ħ a m l ə w
ӏэдакъэ	ʔ a d aː q a
гъэгубжын	ʁ a ɡʷ ə b ʒ ə n
шыгъо	ʃ ə ʁʷ a
гъэкӏэрэкӏэн	ʁ a t͡ʃ a r a t͡ʃ a n
ӏапэ	ʔ aː p a
хыкъумэ	x ə qʷ ə m a
пчэдыгъо	p t͡ʃ a d ə ʁʷ a
тегъэпкӏэн	t a j ə a p t͡ʃ ʼ a n
сысын	s ə s ə n
хъусӏысый	χʷ ə s ʼ ə s ə j
ныкъо	n ə qʷ a
хъэдэн	χ a d a n
лагъымэ	ɮ aː ʁ ə m a
кӏэлъыкӏон	t͡ʃ a ɬ ə kʷ ʼ a n
пӏэстӏэкӏэшып	p a s t a t͡ʃ a ʃ ə p
деутын	d a j t ə n
чӏыкӏухьныкъу	t͡ʃ ə kʷ ə ħ n ə qʷ
амал	aː m aː l
пэбжъакъо	p a b ʐ aː qʷ a
санэ	s aː n a
щэгьэгъожь	ɕ a ɡʲ a ʁʷ a ʒ
джакӏо	d͡ʒ aː kʷ ʼ a
шъхьэгьашъу	ʂ ħ a ɡʲ aː ʃʷ
ӏэпэӏас	ʔ a p a ʔ aː s
зэхэгъэтэкъун	z a x a ʁ a t a qʷ ə n
гъумы	ʁʷ ə m ə
гъотын	ʁʷ a t ə n
быты	b ə t ə
шъищ	ʂ i ɕ
къэхын	q a x ə n
бзыу	b z ə w
бэдзжьын	b a d͡z a ʑ ə n
гъэушӏоркъын	ʁ a w ʃʷ ʼ a r q ə n
хъырбыдз	χ ə r b ə d͡ʒ
шъыпкъэ	ʂ ə p q a
гъэфэбапӏэ	ʁ a f a b aː p ʼ a
чэрэуан	k a r a w aː n
етӏапцӏэ	j a t ʼ aː p t͡s ʼ a
гъэпӏоркӏын	ʁ a pʷ ʼ a n t͡ʃ ʼ ə n
пцӏэун	p t͡s ʼ a w ə m
ихьисапын	j ə ħ i s aː p ə n
гъэпцӏакӏо	ʁ a p t͡s ʼ aː kʷ ʼ a
хъуат	χʷ aː t
блашъо	b l aː ʂʷ a
ехъункӏын	j a χʷ ə n t͡ʃ ə n
узын	w ə z ə n
цӏыӏргъ	t s ə ʔ r ʁ
хьэшхъурэӏу	ħ a ʃ χʷ ə r a ʔʷ
делъэсэен	d a j ɬ a s a j a n
пщылӏыгъо	p ɕ ə ɬ ʼ ə ʁʷ a
зэпэзэдакъ	z a p a z a d aː q
жьао	ʑ aː w a
губжыпх	ɡʷ ə b ʒ ə p x
щамсый	ɕ aː m s ə j
мэсэн	m a s a n
шъуял	ʃʷ ə j aː ɮ
цуакъэ	t͡sʷ aː q a
къыпыщын	q ə p ə ɕ ə n
тхыкъупшъхь	t x ə qʷ ə p ʂ ħ
еӏункӏын	j a ʔʷ ə n t͡ʃ ʼ ə n
чъыетхъун	m a ʃ t͡ə j a t χʷ ə n
итын	j ə t ə n
кӏэкӏьащын	t͡ʃ ʼ a kʲ ʼ aː ɕ ə n
гъэгъушъын	ʁ a ʁʷ ʂ ə n
ригъэбылъхьэн	r i ʁ a b ə ɬ ħ a n
щтэ	ɕ t a
зэхэщын	z a x a ɕ ə n
гъунд	ʁʷ ə n d
абан	aː b aː n
матэ	m aː t a
сэнэхьат	s a n a ħ aː t
онэгу	w a n a ɡʷ
чылыс	t͡ʃ ə ɮ ə s
гъожьышэплъ	ʁʷ a ʑ ə ʃ a p ɬ
шэнынчъ	ʃ a n t͡ʂ a
къу	qʷ ə
гулъытэн	ɡʷ ə ɬ ə t a n
цэлъэкӏалъэ	t͡s a ɬ a t͡ʃ ʼ aː ɬ a
жэкӏэф	ʒ a t͡ʃ a f
ешъукӏын	j a ʃʷ ə t͡ʃ ʼ ə n
бы	b əː
чэу	t͡ʃ ʼ a w
дэубытэн	d a w b ə t a n
техъон	t a j χʷ a n
дегун	d e ɡʷ ə n
гырзын	ɣ ə r z ə n
кӏапсэрыкӏо	t͡ʃ ʼ aː p s a r ə kʷ ʼ a
хьакӏэщ	ħ aː t͡ʃ a ɕ
стыр	s t ə r
мэкъуогъумаз	m a qʷ ə w a ʁʷ ə m aː z
ӏэплъэкӏжъые	ʔ a p ɬ a t͡ʃ ʐ ə j a
хэшъон	x a ʂʷ a n
ушӏоин	w ə ʃʷ a j ə n
ошъоку	w a ʃʷ a kʷ
нэпэон	n a p a w a n
щы	ɕ ə
пӏонкӏын	pʷ ʼ a n t͡ʃ ʼ ə m
гъучӏы	ʁʷ ə t͡ʃ ʼ ə
нэкӏьышъо	n a k ʼ ə ʃʷ a
шъхьэ	ʂ ħ a
къэфын	q a f ə n
зыохьын	z ə w a ħ ə n
ӏухьан	ʔʷ ə ħ aː n
шӏын	ʃ ə n
пкӏыкӏэ	p t͡ʃ ə t͡ʃ a
гущыӏэн	m a ɡʷ ɕ ə ʔ a n
бэнэн	b a n a n
джыхэпкӏэн	d͡ʒ ə x a p t͡ʃ ʼ a n
хьапщ	ħ a p ɕ
зэгъэфэгъэн	z a ʁ a f a ʁ a n
ушхъухьакӏо	w ə ʃ χʷ ħ aː kʷ ʼ a
кӏэшӏэн	t͡ʃ ʼ a ʃ ʼ a n
пхъэн	p χ a n
ӏугъо	ʔʷ ə ʁʷ a
упэшӏын	w ə p a ʃ ʼ ə n
губгъэн	ɡʷ ə b ʁ a n
сыд	s ə d
гъойщэен	ʁʷ a j ɕ a j a n
мэлылъфэгъумаз	m a l ə ɬ f a ʁʷ ə m aː z
ӏэнэжъ	ʔ a n a ʐ
мэзытхьэ	m a z ə t ħ a
нэхъут	n a χʷ ə t
пхъэ	p χ a
хьацэ	ħ aː t͡s a
янэш	j aː n a ʃ
дэфэн	d a f a n
дзын	d͡z ə n
къашыкъхъурай	q aː ʃ ə q χʷ ə r aː j
ахъщэмыкӏу	aː χ ʃ a m ə kʷ ʼ
отэгъу	w a t a ʁʷ
дэӏон	d a ʔʷ a n
упчӏэн	w ə p t͡ʃ ʼ a n
хэкӏон	x a kʷ ʼ a n
быбыпӏ	b ə b ə p ʼ
къэкъушъун	q a qʷ ə ʃʷ ə n
жъажъэ	ʐ aː ʐ a
аӏууц	aː ʔʷ ə w ə t͡s
лъыфыгъэ	ɬ f ə ʁ a
зыгъэгусэн	z ə ʁ ə ɡʷ ə s a n
тхъурыжъ	t χʷ ə r ə ʐ
плъыжьы	p ɬ ə ʑ ə
бжьыгъэ	b ʑ ə ʁ a
сыда	s ə d aː
удзуцон	w d͡zʷ ə t͡sʷ a n
рэзэгъэн	r a z a ʁ a n
нэшанэ	n a ʃ aː n
епхын	j a p x ə n
чэм	t͡ʃ a m
хэти	x aː t i
пчыхьэшъхьашхэ	p t͡ʃ ə ħ a ʂ ħ aː ʃ x a
гъошэгь	ʁʷ a ʃ a ɡʲ
он	w a n
хэстыхьан	x a s t ə ħ a n
пщыкъу	p ɕ ə qʷ ə
шӏыхьан	ʃ ʼ ə ħ aː n
гъунгьэ	ʁʷ ə n ɡʲ a
хъурмэ	χʷ ə r m a
нэгъургьэ	n a ʁʷ ə r ɡʲ a
бэщ	b a ɕ
бзэхабзэ	b z a x aː b z
джаргъэн	d͡ʒ aː r ʁ a n
пасэ	p aː c a
бзыупцӏ	b z ə w p t͡sˤ ʼ
лэжьэн	l a ʑ a n
ашъыу	aː ʃʷ ʼ ə w
гукъэгъэкӏын	ɡʷ ə q a ʁ a t͡ʃ ʼ ə n
парчъыхь	p aː r t ʂ ə ħ
коцы	kʷ a t͡s ə
ахъщэжъгъэй	aː χ ʃ a ʐ ʁ a j
щэмэгь	ɕ a m a ɡʲ ʼ
псыкӏэ	p s ə t͡ʃ ʼ a
жьыкорен	ʑ ə kʷ a r a j n
ӏэпыкӏьын	ʔ a p ə kʲ ʼ ə n
къарыунчъэ	q aː r ə w ə n t͡ʂ
кӏэй	t͡ʃ ʼ a j
зэӏэхьэн	z a ʔ a ħ a n
нэгъучӏыц	n a ʁʷ t͡ʂ ʼ ə t͡s a
шъорышӏын	ʃʷ a r ə ʃ ʼ ə n
джарэу	d͡ʒ aː r a w
бжыхьакӏэ	b ʒ ə ħ aː t͡ʃ a
исхьэкъ	j ə s ħ a q
джэгъучӏэлъ	d͡ʒ a ʁʷ a ɬ
кӏэупкӏэн	t͡ʃ ʼ a w p t͡ʃ ʼ a n
бытырбыф	b a t ə r b ə f
мэлхъогъ	m a l χʷ a ʁ
хьэлъэубакъу	ħ a ɬ a w b aː q
кӏыфы	t͡ʃ ʼ ə f ə
шъоуалъэ	ʃʷ a w aː ɬ a
цыгъон	t͡s ə ʁʷ a n
ӏугъуашъо	ʔʷ ə ʁʷ a ʃʷ a
лъытфэ	ɬ ə t f a
шъхьатепӏо	ʂ ħ aː t e pʷ ʼ a
нацэӏуцэ	n a t s a ʔʷ t s a
абэдзэкъуай	aː b a d͡z a qʷ aː j
плъэн	p ɬ a n
аджал	aː d͡ʒ aː l
бэрауты	b a r aː w t ə
тгъуакӏо	t ʁʷ aː kʷ ʼ a
нэкӏьэон	n a kʲ ʼ a w a n
зэтеуцон	z a t a j w t͡ʃʷ a n
атэшыпхъу	ʔ aː t a ʃ ə p χʷ
тегупшысыкӏын	t a j ɡʷ ə p ʃ ə s ə t͡ʃ ʼ ə n
кӏэпхъ	t͡ʃ ʼ a p χ
якъуб	j aː qʷ ə b
зыпэгъотхьажьын	z ə p a ʁʷ a t ħ a ʑ ə n
блахэ	b l aː x a
фэгъэгъун	f a ʁ a ʁʷ ə n
хьанцэ	ħ a n t͡s a
копкъ	kʷ a p q
бжьыны	b ʑ ə n ə
бгъэны	b ʁ a n ə
екӏолӏэн	j a kʷ ʼ a ɬ ʼ a n
ун	j a w ə n
жэгъуулал	ʒ a ʁʷ ə w l aː l
егъэжьэн	j a ʁ a ʑ a n
хъырцэ	χ ə r t͡s a
нэдэлъфыбзэ	n a d a ɬ f ə b z a
етӏуанэ	j a tʷ ʼ aː n a
угъоин	w ə ʁʷ a j ə n
пыжъы	p ə ʐ ə
нэчыхь	n a t͡ʃ ə ħ
ӏэргъуй	ʔ a r ʁʷ ə j
жъотын	ʐʷ a t ə n
къыпылэлын	q ə p ə ɮ a ɮ ə n
сыдэу	s ə d a w
быбэтэн	b ə b a t a n
дестэгъу	d a j s t a ʁʷ
гъожьы	ʁʷ a ʑ ə
шъуен	ʃʷ ə j a n
деӏэн	d a j ʔ a n
зэпэчъэн	z a p a t͡ʂ a n
уӏэн	w ə ʔ a n
лӏыгъэкӏэ	ɬ ʼ ə ʁ a t͡ʃ ʼ a
жэмачыу	ʒ a m aː t͡ʃ ə w
бэлыджакӏэ	b a l ə d͡ʒ aː k ʼ a
мэмэхын	m a m a x ə n
зэӏэхьан	z a ʔ a ħ a n
кӏоцӏы	kʷ ʼ a t͡s ʼ ə
ӏэлъмэкъ	ʔ a ɬ m a q
илыягъ	j ə ɮ ə j aː ʁ
хъохъ	χʷ a χʷ
амэ	aː m a
хыбзу	x ə b z ə w
хэӏэжьын	x a ʔ a ʑ ə n
мыгъэ	m a ʁ a
унапчъэ	w ə n aː p t͡ʂ a
утхъоен	w ə t χʷ a j a n
фэдэкъабз	f a d a q aː b z
пакъ	p aː q
кӏодын	kʷ ʼ a d ə n
дэгъэзын	d a ʁ a z ə n
ушъын	w ə ʂ ə n
къекӏэхын	q a j t͡ʃ ʼ a x ə m
дзапӏэ	d͡z aː p ʼ a
гъэцэкӏэжьыпӏэ	ʁ a t͡s ə t͡ʃ a ʑ ə p ʼ a
шъхьэукъэн	ʂ ħ a w q a n
къуапэ	qʷ aː p a
алыркъэб	aː l ə r q a b
гупэн	ə ɡʷ ə p a n
япэрэ	j aː p a r a
бжьахъо	b ʑ aː χʷ a
фэд	f a d
нэбгы	n a b ɣ ə
зыщыгъэзын	z ə ɕ ə ʁ a ʁʷ ə p ʃ ə n
жьыдзэ	ʑ ə d͡z ə p ʼ a
къегъэблэгъэн	q a j ʁ a b l a ʁ a n
шӏыкӏьэ	ʃ ʼ ə kʲ ʼ a
быбылъ	b ə b ə ɬ
тэдрэз	t a d r a z
пхъы	p χ ə
гъунапкъэ	ʁʷ ə n aː p q a
пхъэгулъ	b χ a ɡʷ ə ɬ
зэщыкъон	z a ɕ ə qʷ a n
аргъойпаӏу	aː r ʁʷ a j aː ʔʷ
гъэутӏэпӏын	t ʼ s a p ʼ ə n
жэрыплъ	ʒ a r ə p ɬ
гъаблэ	ʁ aː b ɮ a
къыдэкӏохьын	q ə d a kʷ ʼ a ħ ə n
чӏыунэ	w n aː ʂ ħ a
уцышъо	w ə t͡s ə ʂʷ a
хэплъын	x a p ɬ ə n
шӏоигъон	ʃʷ a j ə ʁʷ a n
мэтхэн	m a t x a n
лъыкӏон	ɬ ə kʷ ʼ a n
бгъэгу	b ʁ a ɡʷ
адыгэкъэб	aː d ə ɣ a q a b
бзыхьан	b z ə ħ aː n
ипхъыхьан	j ə p χ ə ħ aː n
къэлэм	q a l a m
пчъэпсы	p t͡ʃ a p s ə
егъэзын	j a ʁ a t ə n
лъэкъорыгъачъэ	ɬ a qʷ a r ə ʁ aː t͡ʂ a
лыгъон	ɮ ə ʁʷ a n
блэгъожъ	b l a ʁʷ a ʐ
нухь	n ə w ħ
гъэлэлэн	ʁ a l a l a n
хьэнчэмыӏу	ħ a n t͡ʃ a m ə ʔʷ
пшэсэн	p ʃ a s a n
шэнынчъэ	ʃ a n t͡ʂ a
джамбырыугъазэ	d͡ʒ aː m b ə r ə w ʁ aː z a
хэщын	x a ɕ ə n
пкӏышъхьэмышъхьэ	p t͡ʃ ə ʂ ħ a m ə ʂ ħ a
блашъхьэ	b l aː ʂ ħ a
бзыушыр	b z ə w ʃ ə r
тыдэ	t ə d a
кьэтжъые	kʲ a t ʐ ə j
ыкӏи	ə t͡ʃ ʼ ə j
бгычап	b ɣ ə t͡ʃ aː p
дэбыбэен	d a b ə b a j a n
мычӏы	m ə t͡ʃ ə
налэ	n aː l a
ахъчашъхь	aː χ t͡ʃ aː ʂ ħ
чэмахъо	t͡ʃ a m aː χʷ a
зэон	z a w a n
шамгьэн	ʃ a m ɡʲ a n
сырэ	s ə r a
ахъчэбэг	aː χ t͡ʃ a b a ɣ
шъуапэ	ʂʷ aː p a
щэху	ɕ a xʷ ə
тӏыргун	t ʼ ə r ɡʷ ə n
жъогъоплӏэн	ʐʷ a ʁ a p ɬ a n
тӏэкӏушӏэмэ	t ʼ a kʷ ʼː ʃ ʼ a m a
псыгъо	p s ə ʁʷ a
чъыӏаӏо	t͡ʂ ə ʔ aː ʔʷ a
цохъон	t͡sʷ a χʷ a n
къыгъэ	q ə ʁ a
шӏыкӏэен	ʃ ʼ ə k ʼʲ a j a n
пхыр	p x ə r
арэущтэу	aː r a w ɕ t a w
сэшхо	s a ʃ xʷ a
къилъын	q ə j ɬ ə n
блэхъушъутын	b l a χʷ ə ʂʷ t ə n
чӏыгу	t͡ʃ ʼ ə ɡʷ ə
къарыунчъ	q aː r ə w ə n t͡ʂ
адыгэ	aː d ə ɣ a
гуӏэн	ɡʷ ə ʔ a n
бгъуагъэ	b ʁʷ aː ʁ a
сымэджэщ	s ə m a d͡ʒ a ɕ
ибрахьим	j ə b r aː ħ i m
гушӏон	ɡʷ ə ʃʷ ʼ a n
гъогуонэкӏуныр	ʁʷ a ɡʷ ə w a n a kʷ ʼ ə n ə r
хьацӏэбацӏэ	ħ aː t͡sˤ ʼ a b aː t͡sˤ ʼ a
мэкӏыин	m a t͡ʃ ʼ ə j ə n
жэдэплъыхьан	ʒ a d a p ɬ ə ħ aː n
къэкӏохьын	q a kʷ ʼ a ħ ə n
пэсын	p a s ə n
чэмыӏо	t͡ʃ a m ə ʔʷ a
махъчэбзу	m aː χ t͡ʃ a b z ə w
зэгощын	z a ɡʷ a ɕ ə n
малъхъо	m aː ɬ χʷ a
къипсэн	q i n p s a n
джаузэ	d͡ʒ aː w z a
бэдзэгъалӏэ	b a d͡z a ʁ aː ɬ ʼ a
зыгъэпскӏын	z ʁ a p s t͡ʃ ʼ ə n
хъожьын	χʷ a ʑ ə n
гъогогъу	ʁʷ a ɡʷ a ʁʷ
алашэ	aː l aː ʃ a
жъонакӏу	ʐʷ a n aː kʷ
нэгъуцу	n a ʁʷ ə t͡ʃʷ
жэкӏэупс	ʒ a t͡ʃ a w p s
тэгъолъхьан	t a ʁʷ a ɬ ħ aː n
бгэрый	b ɣ ə r ə j
мин	m i n
цэкъэн	t͡s a q a n
ахъчалъ	aː χ t͡ʃ aː ɬ
плӏэмый	p ɬ ʼ a m ə j
куашъо	kʷ ʼ aː ʃʷ a
гъэсэныгъэ	ʁ a s a n ə ʁ a
гъэунэшкӏун	ʁ a w n a ʃ kʷ ʼ ə n
дэсын	d a s ə n
кьэпчъэӏу	kʲ a p t͡ʂ a ʔʷ
чӏылъ	t͡ʃ ʼ ə ɬ
бжъэшъу	b ʐ a ʂʷ
ежьашъо	j a ʑ aː ʂʷ a
ахъчапс	aː χ t͡ʃ aː p s
кӏэрыкӏэу	t͡ʃ ʼ a r ə t͡ʃ ʼ a w
кӏэен	t͡ʃ ʼ a j a n
хьалыжъощыхьагъэ	ħ aː l ə ʐʷ a ɕ ə ħ aː ʁ a
ханэ	x aː n a
чэмэдан	t͡ʃ a m a d aː n
дэон	d a w a n
чӏэухъумэн	t͡ʂ ʼ a w χʷ ə m a n
самбыр	s aː m b ə r
дышъэкӏ	d ə ʂ a t͡ʃ
ригъэчъэхын	j a ʁ a t͡ʂ a x ə n
егъэлъэгъун	j a ʁ a ɬ a ʁʷ ə n
тэгьын	t a ɡʲ ə n
ецэгъон	j a t͡s ə ʁʷ a n
есын	j a s ə n
бзэу	b z a w
шъэ	ʂ a
лъэбакъу	ɬ a b aː qʷ
ӏынджыр	ʔ ə n d͡ʒ ə r
джэуап	d͡ʒ a w aː p
сӏакӏьэ	s ʼ aː kʲ ʼ a
гурыгъэӏон	ɡʷ ə r ə ʔʷ a n
бжьышӏо	b ʑ ə ʃʷ ʼ a
мэцӏын	m a t͡s ʼ ə n
пыжъ	p ə ʐ
лӏыукӏ	m a χ aː d͡ʒ a
хыкъу	x ə qʷ ə
дэшхын	d a ʃ x ə n
хьадэпчэмыӏу	ħ aː d a p t͡ʃ a m ə ʔʷ
жэлый	ʒ a l ə j
лъасэ	ɬ aː s a
ӏэрс	ʔ a p s
тэгъэцӏэшъутыкӏын	t a ʁ a t͡s ʼ a ʃʷ t ə t͡ʃ ʼ ə n
шэдыгъо	ʃ a d ə ʁʷ a
пхъэкӏыпхъ	p χ a t͡ʃ ə p χ
жэӏулэл	ʒ a ʔʷ ə l a l
анэу	aː n a w
жъырку	ʐ ə r kʷ
хэплъэн	x a p ɬ a n
илъэдэн	j ə ɬ a d a n
щалъ	ɕ aː ɬ
щыӏэн	ɕ ə ʔ a n
гъэшӏыкӏэен	ʁ a ʃ ʼ ə t͡ʃ ʼ a j a n
ӏэкӏэукӏэн	ʔ a t͡ʃ ʼ a w t͡ʃ ʼ a n
гупсэн	ɡʷ ə p s a n
ӏэ	ʔ a
гъэкуон	ʁ a kʷ ə w a n
фэшӏын	f a ʃ ʼ ə n
чэщы	t͡ʃ a ɕ ə
деухьэн	d e w ħ a n
пылэлын	p ə ɮ a ɮ ə n
къощыр	qʷ a ɕ ə r
сэмэркъэу	s a m a r q a w
ӏэфӏ	ʔ a f ʼ ə
бжьыныф	b ʑ ə n ə f
ӏоф	ʔʷ a f
убын	w ə b ə
быбын	b ə b ə n
жьын	ʑ ə n
бжъапэ	b ʐ aː p a
пэӏухъо	p a ʔʷ ə χʷ a
мэкъу	m a qʷ
блапцӏэ	b l aː p t͡s ʼ a
къэщэчын	q a ɕ a t͡ʃ ə n
пыл	p ə l
бэдзэр	b a d͡z a r
джэгъолӏ	d͡ʒ a ʁʷ a ɬ ʼ
дадыу	d aː d ə w
джэдыгу	d͡ʒ a d ə ɡʷ
псыӏушъо	p s ə ʔʷ ə ʃʷ a
гъолагъу	ʁʷ a ɮ aː ʁ
гъуаплъэ	ʁʷ aː p ɬ a
жьыгъэшъуй	ʑ ə ʁ a ʂʷ ə j
цыхьэ	t͡s ə ħ a
фикъун	f ə j qʷ ə n
гъэӏулэн	ʁ a ʔʷ ə l a n
псынкӏагъэ	p s ə t͡ʃ ʼ aː ʁ a
пэщэн	p a ɕ a m
теплъаджэ	t e p ɬ aː d͡ʒ a
мэгъын	m a ʁ ə n
тӏуанэ	tʷ ʼ aː n a
хьаплъэ	ħ a p ɬ a
амылкъан	aː m ə l q aː n
бэджэшъ	b aː d͡ʒ a ʂ
мэзы	m a z ə
ипэтхьэмафэ	j ə p a t ħ a m aː f a
джэнэпылъапӏ	d͡ʒ a n a p ə ɬ aː p ʼ
жыкъузалъ	ʒ ə qʷ ə z aː ɬ
нэшэбэгу	n a ʃ a b a ɡʷ
гъычгъэ	ʁ ə t͡ʃ ʁ a
акъужъ	aː qʷ ə ʐ
амдэз	aː m d a z
гъэгъын	ʁ a ʁ ə n
гъэкощын	ʁ a kʷ a ɕ ə n
сымаджэ	s ə m aː d͡ʒ a
кӏурэжъый	kʷ ʼ ə r a ʐ ə j
тещыныхьан	t a j ɕ ə n ə ħ aː n
пшъэшъэжъый	p ʂ a ʂ a ʐ ə j
фо	f o
ащ	aː ɕ
жъоныгъу	ʐʷ a n ə ʁʷ
бжыхьас	b ʒ ə ħ aː s
гъэутхъон	ʁ a w t χʷ a n
бгыкъупхъ	b ɣ ə qʷ ə p χ
шӏуанэ	ʃʷ ʼ aː n a
лэжьакӏу	l a ʑ aː kʷ ʼ
псынкӏэу	p s ə n t͡ʃ ʼ a w
щтапхэ	ɕ t aː p x a
лӏымыш	ɬ ʼ ə m ə ʃ
гъэделэн	ʁ a d a j l a n
къошъомэзэжъый	qʷ a ʂʷ a m a z a ʐ ə j
чӏэрэп	t͡ʂ ʼ a r a p
тыпсэ	t ə p s a
ӏэпапсӏэ	ʔ a p aː p s ʼ a
пхъэх	p χ a x
хафэ	x aː f a
блэпкӏын	b l a p t͡ʃ ʼ ə n
хьэкӏущтащхьэ	ħ a kʷ ʼ ɕ t aː ɕ ħ a
хъэпрашъо	χ a p r aː ʂʷ a
пакӏэ	p aː t͡ʃ ʼ a
къэхьпэ	q a ħ p a
кӏэнлъэ	t͡ʃ ʼ a n ɬ a
цӏашъутэ	t͡s ʼ aː ʃʷ t a
щэӏун	ɣ ə r z ə n
мэхъун	m a χʷ ə n
лӏыхъу	ɬ ʼ ə χʷ
мэтхьаусхэн	m a t ħ aː w ə s x a n
бэгыгъэ	b a ɣ ə ʁ a
бэгъэгус	b a ʁ a ɡʷ ə s
тэгъэтӏэтӏэн	ʁ a t ʼ a t ʼ a n
жъышъхьэ	ʐ ə ʂ ħ a
тегъэстыхьан	t a j ʁ a s ə ħ aː n
бгъэузы	b ʁ a w ə z ə
сыдигъо	s ə d ə j ʁʷ a
зэфэчъэн	z a f a t͡ʂ a n
пчэны	p t͡ʃ a n ə
гумыӏу	ɡʷ ə m ə ʔʷ
нысэ	n ə s a
бырыукъ	b ə r ə w q
мэуӏэн	m a w ʔ a n
атэ	aː t a
ухын	w x ə n
къэшъуакӏо	q a ʃʷ aː kʷ ʼ a
нэмкӏ	n a m t͡ʃ ʼ
тутын	t ə w t ə n
пакӏьэ	p aː kʲ ʼ a
ӏахъо	ʔ a χʷ a
шӏошъхъуныгъэ	ʃʷ ʼ a ʃʷ ʼ χʷ ə n ʁ a
тэтхыкӏьын	t a t x ə kʲ ʼ ə n
теӏэбэхьын	t a j ʔ a b a ħ ə n
пэгъон	p a ʁʷ aː n a
ащгъум	aː ɕ ʁʷ ə m
зэребылэу	z a r a j b ə ɮ a w
ӏэхъу	ʔ a χʷ
ехъурэ	j a χʷ r a
кӏэтхъэн	t͡ʃ ʼ a t χ a n
бэнанэ	b a n aː n a
лымышх	l ə m ə ʃ x
олъэн	w a ɬ a n
ӏэпэпсӏий	ʔ a p a p s ʼ ə j
щыгъущ	ɕ ə ʁʷ ə ɕ
шъэнэкъо	ʂ a n a qʷ a
хьакъун	ħ aː qʷ ə n
джэныкъу	d͡ʒ a n ə qʷ
деузэндын	d a j w z a n d ə n
пкъыгъуацӏэ	p q ə ʁʷ aː t͡s ʼ
шыдкъолэн	ʃ ə d qʷ a l a n
деусэн	d a j s a n
лъэшыдж	ɬ a ʃ ə d͡ʒ
лъэкӏапӏ	ɬ a t͡ʃ aː p ʼ a
осыпсы	w a s ə p s ə
шъутырэхьын	ʃʷ ə t ə r a ħ ə n
тхыцэ	t x ə t͡ʃ a
ӏашӏу	ʔ a ʃʷ ʼ ə
хьалыгъу	ħ aː l ə ʁʷ
анэ	ʔ aː n a
бгъотэн	b ʁʷ a t a n
кӏожьын	kʷ ʼ a ʑ ə n
дэигъэ	d a j ə ʁ a
плъышъо	p ɬ ə ʃʷ a
мэнэкъокъон	m a n a qʷ a qʷ a n
дыин	d ə j ə n
укъэбзын	w q a b z ə n
мэчэн	m a t͡ʃ a n
цӏэпӏэжъ	t͡s ʼ a p ʼ a ʐ
быун	b ə w ə n
щэджэгъуашхэ	ɕ a d͡ʒ a ʁʷ aː ʃ x a
гъэшӏыкӏьэен	ʁ a ʃ ʼ ə kʲ ʼ a j a n
цӏыцӏын	t͡s ʼ ə t͡s ʼ ə n
къуао	qʷ aː w a
пӏакӏэ	p ʼ aː t͡ʃ a
дэгъэзен	d a ʁ a z a j a n
бгъакъэ	b ʁ aː q a
хьалы	ħ aː l ə
хъои	χʷ a j ə
жъышъхьэмыгъу	ʐ ə ʂ ħ a m a ə ʁʷ
игъуадж	j ə ʁʷ aː d͡ʒ
бзэил	b z a j ə l
жъы	ʐ ə
хэлъхьан	x a ɬ ħ aː n
лӏэкъолъэш	ɬ a qʷ a ɬ a ʃ
джае	d͡ʒ aː j a
еупчын	j a w p t͡ʃ ə n
жъогъуаплъэ	ʐʷ a ʁ aː p ɬ a
лъэкӏапӏэ	ɬ a t͡ʃ aː p ʼ
кӏьэ	kʲ ʼ a
къычӏэхын	q ə t͡ʃ ʼ a x ə n
еубэн	j a w b a n
пщыкӏэ	p ɕ ə t͡ʃ ʼ a
хъун	χʷ ə n
хъо	χʷ a
къеулэлэхын	q a j ɬ a ɬ a x ə n
къэгъэлъэгъоны	q a ʁ a ɬ a ʁʷ a n ə
жэкӏэпэпкъ	ʒ a t ʃ ʼ a p a p q
псыжъо	p s ə ʐʷ a
бгъэджыб	b ʁ a d͡ʒ ə r
гъэпсыкӏьын	ʁ a p s ə kʲ ʼ ə n
хьаӏьэ	ħ aː ʔʲ a
лъытэн	ɬ ə t a n
блыпкъышъхь	b l ə p q ə ʂ ħ
ечъэжьэн	j a t͡ʂ a ʑ a n
тхьацэ	t ħ aː t͡s a
дакӏэ	d aː t͡ʃ a
жэрыӏу	ʒ a r ə ʔʷ
къурнэ	qʷ ə r n a
ушъорэкӏын	w ə ʃʷ a r a t͡ʃ ʼ ə n
мэлъэхъу	m a ɬ a χʷ
мэцохъон	m a t͡sʷ a χʷ a n
мэзыпчэн	m a z ə p t͡ʃ a n
пчъэ	p t͡ʃ a
гукӏае	ɡʷ ə t͡ʃ ʼ aː j a
купэ	kʷ ə p a
шъхьафитныгъ	ʂ ħ aː f i t n ə ʁ
гъэзэжьын	ʁ a z a ʑ ə n
бэхьал	b a ħ aː l
хьасэ	ħ aː s a
кӏапсэ	t͡ʃ ʼ aː p s a
ӏорышӏадж	ʔʷ a r ə ʃ ʼ aː d͡ʒ
анезе	a n a j z a j
кӏэтӏэй	t͡ʃ a t ʼ a j
ӏункӏыбзэ	ʔʷ ə n t͡ʃ ʼ ə b z a
жьыуай	ʑ ə w aː j
гъун	ʁʷ ə n
шъуае	ʂʷ aː j a
лъэпхъабэ	ɬ a p χ aː b a
анэшыпхъу	ʔ aː n a ʃ ə p χʷ
къегъэкӏын	q a j ʁ a t͡ʃ ʼ ə n
нэшхъэигъу	n a ʃ χ a j ə ʁʷ
щыблэ	ɕ ə b l a
нэчыхьытх	n a t͡ʃ ə ħ ə t x
жае	ʒ aː j a
пкӏау	p t͡ʃ aː w
бжьаӏо	b ʑ aː ʔʷ a
шыдгъо	ʃ ə d ʁʷ a
псыцу	p s ə t͡sʷ a
къаигъэ	q aː j ə ʁ a
бжалэ	b ʒ aː l a
ӏотэн	ʔʷ a t a n
мэгъушъын	m a ʁʷ ʂ ə n
дебзыкӏэн	d e b z ə t͡ʃ a n
чъэпыогъумаз	t͡ʂ a p ə w a ʁʷ ə m aː z
гъэжьэн	j a ʁ a ʑ a n
бэкъудадз	b a qʷ d aː d͡z
хьаплъы	ħ aː p ɬ ə
благъо	b l aː ʁʷ a
лӏапӏэ	ɬ ʼ aː p ʼ a
хьандзуачӏ	ħ aː n d͡zʷ aː t͡ʃ
жьынэӏу	ʑ ə n a ʔʷ
цагэ	t͡s aː ɣ a
зэщыгъо	z a ɕ ə ʁʷ a
джэфы	d͡ʒ a f ə
пэгъодз	p a ʁʷ a d͡z
бакъмэр	b aː q m a r
анэш	ʔ aː n a ʃ
сшъхьэпкӏэтын	s ʂ ħ a p kʲ ʼ a t ə n
дефыен	d a j f ə j a n
бгъэбзы	b ʁ a b z ə
хъанзэгу	χ aː n z a ɡʷ
къухьэуцупӏэ	qʷ ə ħ a w t͡sʷ ə p ʼ a
хэлъэшъон	x a ɬ a ʃʷ a n
псыкъефэх	p s ə q a j f a x
нахьыбэрэм	n aː ħ ə b a r a m
гъушъын	ʁʷ ə ʂ ə n
зэрихьан	z a r i ħ a n
къыухьан	q ə w ə ħ aː n
хьэнтӏэрэпӏый	ħ a n t a r a p ə j
къэсэхын	q a s a x ə n
бгырыпх	b ɣ ə r ə p x
текӏьэн	t a kʲ ʼ a n
хыкум	x ə kʷ ə m
ӏэтын	ʔ aː t ə n
жъыкъат	ʐ ə q aː t
хэутын	x a w t ə n
гъэзэн	ʁ a z a n
къэхьыуашъо	q a ħ w aː ʂʷ a
блэн	b l a n
теплъэ	t aː p ɬ a
къетӏэрэхын	q a j t ʼ a r a x ə n
лӏыжъы	ɬ ʼ ə ʐ ə
хэкӏодыкӏын	x a kʷ ʼ a d ə t͡ʃ ʼ ə m
жэдэфэн	ʒ a d a f a n
бзэгуп	b z a ɡʷ ə p
гьанэ	ɡʲ aː n a
цыджанэ	t͡s ə d͡ʒ aː n a
амышӏэр	aː m ə ʃ ʼ a r
лэгъупышху	l a ʁʷ ə p ə ʃ xʷ
шъхьач	ʂ ħ aː t͡ʃ
нэкӏэтӏэр	n a kʲ ʼ a tˤ ʼ a r
зэгъэфэн	z a ʁ a f a n
гущаӏэ	ɡʷ ə ɕ aː ʔ a
бжьэбын	b ʑ a b ə n
пытапӏэ	p ə tː pˤ ʼ a
зэхъокӏьын	z a χʷ a kʲ ʼ ə n
бзэджай	b z a d͡ʒ aː j
блещын	b l a j ɕ ə n
пылъэн	p ə ɬ a n
хьацэгъуй	ħ aː t͡s a ʁʷ ə j
мэгънэнэн	m a ʁ n a n a n
пэкӏэрэплъын	p ə t͡ʃ ʼ a r a p ɬ ə n
шъхьэпай	ʂ ħ a p aː j
кӏыкӏьай	t͡ʃ ə kʲ aː j
хэкӏы	x a t͡ʃ ʼ ə
хьэбадзэ	ħ a b aː d͡z a
абдзах	aː b d͡z aː x
арми	aː m a
дысы	d ə s ə
еджэнджэшын	j a d͡ʒ a n d͡ʒ a n ʃ ə n
жэгъу	ʒ a ʁʷ
теутын	t a j w ə t ə n
жакъэ	ʒ aː q a
бэрджахь	b a r d͡ʒ aː ħ
пыдж	p ə d͡ʒ
шъхьэкӏьэ	ʂ ħ a kʲ ʼ a
щыгъозэн	ɕ ə ʁʷ a z a n
къеджэн	q a j d͡ʒ a n
мэуцун	m a w t͡sʷ ə n
пцӏырый	p t͡s ʼ ə r ə j
кӏэлэхъуцӏыкӏу	t͡ʃ ʼ a ɮ a χʷ t͡s ʼ ə kʷ ʼ
хъэ	χ a
зэгъэфагъ	z a ʁ a f aː ʁ
тхыгъэ	t x ə ʁ a
бгъодэт	b ʁʷ a d a d
хъулъфыгъэ	χʷ ə ɬ f ə ʁ a
щынагъу	ɕ ə n aː ʁʷ
бжьэгъалӏэ	b ʑ a ʁ aː ɬ ʼ a
бзэшэн	b z a ʃ a n
хэгъуашъхьэ	x a ʁʷ aː ʂ ħ a
аргъэйфыгу	aː r ʁ a j f ə ɡʷ
гъэсэкъатын	ʁ a s a q aː t ə n
нэзэжъу	n a z a ʒʷ
пчэдыжьы	p t͡ʃ a d ə ʑ ə
делагъэ	d a j l aː ʁ a
щыбжьый	ɕ ə b ʑ ə j
мые	m ə j a
хъэн	χ a n
такъыр	t aː q ə r
ужы	w ʒ ə
укӏакӏо	w t͡ʃ ʼ aː kʷ ʼ a
пхъэкӏэн	p χ a t͡ʃ a n
дегъэзэн	d e ʁ a z a n
жьэн	ʑ a n
блыгучӏад	b l ə ɡʷ t͡ʃ ʼ aː d
гукъэкӏын	ɡʷ ə q a t͡ʃ ʼ ə n
егъэпхыгъ	x a ʃ ʼ aː ʁ
чӏыбзу	t͡ʃ ə b z ə w
жьыкъэщэн	ʑ ə q a ɕ a n
нып	n ə p
десэгъу	d a j s a ʁʷ
ныбгъэшъу	n ə b ʁ a ʂʷ
емынэ	j a m ə n a
бзэгужъый	b z a ɡʷ ʐ ə j
лыпцэ	l ə p t͡s a
шъхьакӏо	ʂ ħ aː kʷ ʼ a
чӏырыгъыс	t͡ʃ ʼ ə r ə ʁ ə s
хьэпс	ħ a p s
бэны	b a n ə
сэмэгу	s a m a ɡʷ
тетхыкӏын	t a t x ə t͡ʃ ʼ ə n
бзый	b z ə j
нэмыӏэкӏэ	n a m ə ʔ a t͡ʃ ʼ a
фэӏофытэн	ʔʷ a f ə t a n
къэгъуен	q a ʁʷ a j ə n
бегъымбар	b e ʁ ə m b aː r
пэгъокӏын	p a ʁʷ a t͡ʃ ə n
щынэн	ɕ ə n a n
чэтжъые	t͡ʃ ʼ a t ʐ ə j
уфын	w ə f ə n
шхъуантӏэ	ʃ χʷ aː n t ʼ a
тӏокӏэжъ	tʷ ʼ a t͡ʃ ʼ a ʐ
ӏофшӏэнынчъэ	ʔʷ a f ʃ ʼ a n ə n t͡ʂ a
мэубэтэн	m a w ə b a t a n
мэунэхъун	m a w n a χʷ ʁ n
гугъу	ɡʷ ə ʁʷ
къэгъэзэгъу	q a ʁ a z a ʁʷ
кхъужъы	q͡χʷ ə ʐ ə
бэйкъогъуз	b aː j qʷ a ʁʷ ə z
хэгъэдэн	x a ʁ a d a n
бгъодж	b ʁʷ a d͡ʒ
нэнэжъ	n a n a ʐ
тгъэргъаз	t ʁ a r ʁ aː z
макӏэ	m aː t͡ʃ a
щыпэлъф	ɕ ə p a ɬ f
орэдыӏу	w a r a d ə ʔʷ
хьэцэ	ħ a t͡s a
мэулъыен	m a w ə ɬ ə j a n
нэчэпэ	n a t͡ʃ a p a
зэжъу	z a ʐʷ ə
гъэхъэн	ʁ a χ a n
шъуамбгъо	ʂʷ aː m b ʁʷ aː
гурыӏон	ɡʷ ə r ə ʔʷ a n
быбхалъ	b ə b x aː ɬ
ишъун	j ə ʃʷ ə n
мэшъуен	m a ʃʷ ə j a n
жъышъо	ʐ ə ʂʷ a
бзэджэнрылъф	b z a d͡ʒ a n r ə ɬ f
жъанч	ʐ aː n t͡ʃ
псао	p s aː w a
данэ	d aː n a
нэмыкӏыр	n a m ə t͡ʃ ʼ ə r
корэныгу	kʷ a r a n ə ɡʷ
гуигъэун	ɡʷ ə j ʁ a w ə n
къэгъэуцун	q a ʁ a w t͡sʷ ə n
жъутхэн	m a ʒʷ ə t x a n
лъащэ	ɬ aː ɕ a
дэкьэн	d a kʲ a n
зэндалэ	z a n d aː l a
тэшӏыкӏьын	t a ʃ ʼ ə kʲ ʼ ə n
мэхъагьэ	m a χ aː ɡʲ a
шашыф	ʃ aː ʃ ə f
бырсырын	b ə r s ə r ə n
гъэхъужьын	ʁ a χʷ ə ʑ ə n
тхытхын	t x ə t x ə n
ерагъ	j a r aː ʁ
батырыгъ	b aː t ə r ə ʁ
ӏупшӏэ	ʔʷ ə p ʃ ʼ a
упчӏэ	w ə p t͡ʃ ʼ a
лъэкӏэн	ɬ a t͡ʃ a n
чэрэгъун	t͡ʃ a r a ʁʷ ə n
блэгъэкӏын	b l a ʁ a t͡ʃ ə n
джыхьан	d͡ʒ ə ħ aː n
жьыуапӏэ	ʑ ə w aː p ʼ a
гухахъо	ɡʷ ə x aː χʷ a
техьан	t a j ħ aː n
дехьыхын	d a j ħ ə x ə n
гъэлыгъон	ʁ a ɮ ə ʁʷ a n
мэкъэркъэтэн	m a q a r q a t a n
мэзыкъу	m a z ə qʷ
бжьы	b ʑ ə
мэзэгъэн	m a z a ʁ a n
жъогъокӏэкӏахь	ʐʷ a ʁʷ a t͡ʃ a t͡ʃ aː ħ
бэджэбы	b a d͡ʒ a b ə
пчыкӏэ	p t͡ʃ ə t͡ʃ ʼ a
япэрэу	j aː p a r a w
ренэу	r a j n a w
мэтӏэрэхьын	m a t ʼ a r a ħ ə n
жьы	ʑ ə
епыгьын	j a p ə ɡʲ ə n
блыпкъыщ	b l ə p q ə ɕ
шӏэхэу	ʃ ʼ a x a w
нэпэталхьэ	n a p a t aː l ħ a
ныӏэп	n ə ʔ a p
цӏыон	t͡s ʼ ə w a n
фэпшэн	f a p ʃ a n
тӏамы	t aː m ə
ӏун	ʔʷ ə n
ехъырхъышэн	j a χ ə r χ ə ʃ a n
бзэджапӏэ	b z a d͡ʒ aː pˤ ʼ a
гъэхъун	ʁ a χʷ ə n
быслымэн	b ə s l ə m a n
гьэнэпылъапӏ	ɡʲ a n a p ə ɬ aː p ʼ
зэгъэн	z a ʁ a n
мэзчэт	m a z t͡ʃ a t
деупсэен	d e w p s a j a n
дзэлыкъуэбгъэ	d z a l ə qʷ a b ʁ a
етӏэхъун	j a t ʼ a χʷ ə n
гъэохъун	ʁ a w a χʷ ə n
щэджагъо	ɕ a d͡ʒ aː ʁʷ a
жъопхъу	ʐʷ a p χʷ
къешӏэн	q a j ʃ ʼ a n
жэдэлъын	ʒ a d a x ə n
лэгъу	l a ʁʷ
гукъэгъэкӏьын	ɡʷ ə q a ʁ a kʲ ʼ ə n
пашъхьэ	p aː ʂ ħ a
былымылӏэ	b ə l ə m ə ɬ ʼ a
тхъу	t χʷ ə
гъутхьан	ʁʷ ə t ħ aː n
щабзэ	ɕ aː b z a
шъхьэталъхьэ	ʂ ħ a t aː ɬ ħ a
лыкъумэ	l ə qʷ m a
дэщтэн	d a ɕ t a n
нат	n aː t
гун	ɡʷ ə n
нэбзыц	n a b z ə t͡s
насыпынчъ	n aː s ə p ə n t͡ʂ
пшъэдалхь	p ʂ a d aː l ħ
ахъщашъхь	aː χ ʃ aː ʂ ħ
шъутыпцӏэ	ʃʷ ə t ə p s ʼ a
зэфачъэ	z a f aː t͡ʂ a
отыч	w a t ə t͡ʃ
уз	w ə z
зегъэкӏын	z e ʁ a t͡ʃ ʼ ə n
гъэпсыкӏ	ʁ a p s ə t͡ʃ ʼ
къозын	p ə ɬ ə n
пцыкъу	p t͡s ə qʷ
ягъэ	j aː ʁ a
жэмай	ʒ a m aː j
гъэкъэбзэн	ʁ a q a b z a n
абрагъу	aː b r aː ʁʷ
хэукъон	x a w qʷ a n
пкӏэн	p t͡ʃ ʼ a n
нэущымыщкӏь	n a w ɕ ə m ə ɕ kʲ ʼ
щыбжьэдум	ɕ ə b ʑ a d u m
ӏэпыӏэн	ʔ a p ə ʔ a n
дэхьащхын	d a ħ aː ɕ x ə n
былыхъу	b ə l ə χʷ
шӏункӏы	ʃʷ ʼ ə n t͡ʃ ə
джырэблагъ	d͡ʒ ə r a b l aː r
лъытэныгъ	ɬ ə t a n ə ʁ
бгъэ	b ʁ a
гъэзэщын	ʁ a z a ʃ ə n
ӏалы	ʔ aː ɮ ə
нэзы	n a z ə
еблэгъапӏэ	j a b l a ʁ aː p ʼ a
хьадэ	ħ aː d a
пыджэн	p ə d͡ʒ a n
пэшӏэн	p a ʃ ʼ a n
зыплъыхьапӏэ	z ə p ɬ ə ħ aː p ʼ a
къушъхьэ	qʷ ə ʂ ħ a
натыф	n aː t ə f
дыджы	d ə d͡ʒ ə
къуаджэ	qʷ aː d͡ʒ a
джэгъогъун	d͡ʒ a ʁʷ ə ɡʷ ə n
пагэ	p aː ɣ a
тын	t ə n
щытхъу	ɕ ə t χʷ
щхын	ɕ x ə n
тэжъутхэн	t a ʒʷ ə t x a n
зэдзэкӏакӏу	z a d͡z a t͡ʃ aː kʷ ʼ
блыпэ	b l ə p a
арба	a r b aː
енэкӏэон	j a n a t͡ʃ a w a n
ӏэгьы	ʔ a ɡʲ ə
псау	p s aː w a
ай	aː j
къазгъыр	q aː z ʁ ə r
ӏэкощ	ʔ a kʷ ʼ a ɕ
шыкъу	ʃ ə qʷ
дауш	d aː w ʃ
лъыӏэсын	ɬ ə ʔ a s ə n
лъэӏуакӏо	ɬ a ʔʷ aː kʷ ʼ a
бзако	b z aː kʷ a
зэгу	z a ɡʷ ə
лышъутӏэ	l ə ʃʷ t ʼ a
шъхьантэ	ʂ ħ aː n t a
егъэӏун	j a ʁ a ʔʷ ə n
жъышъхьэмаф	ʐ ə ʂ ħ a m aː f
лъэбэкъу	ɬ a b a qʷ
щтэн	ɕ t a n
ӏунэн	ʔʷ ə n a n
нэущы	n a w ɕ ə
гъопэкӏьэхь	ʁʷ aː p a kʲ ʼ a ħ
шъуил	ʃʷ ə j aː ɮ
абадз	aː b aː d͡z
пхъэшъхьэмышъхьэхэр	p χ a ʂ ħ a m ə ʂ ħ a x a r
епӏэстхъын	j a p ʼ a s t χ ə n
ешъон	j a ʂʷ a n
адэбз	aː d a b z
къыщыкӏэн	q ə ɕ ə t͡ʃ ʼ a n
егъэчъэхын	j a ʁ a t͡ʂ a x ə n
анай	aː n aː j
псыкӏэу	p s ə t͡ʃ ʼ a w
мэтазэ	m a t aː z a
хъурай	χʷ ə r aː j
жэдэтэкъон	ʒ a d a z ə n
тӏысыпӏэ	t ʼ ə s ə p ʼ a
махъсымэ	m aː χ s ə m a
кӏэух	t͡ʃ ʼ a w ə x
хьаӏ	ħ aː ʔ
хэкъутыхьан	x a qʷ ə t ə ħ aː n
жэрыплъагъ	ʒ a r ə p ɬ aː ʁ
теуцогъу	t e w t͡sʷ a ʁʷ
къэсӏын	s ʼ ə n
къегъэсын	q e ʁ a s ə n
шӏуцӏэ	ʃʷ ʼ ə t͡s ʼ a
къокӏыпӏэ	qʷ a t͡ʃ ʼ ə p ʼ a
бжыдзэ	b ʒ ə d͡z a
бзэгохь	b z a ɡʷ a ħ
къамыл	q aː m ə ɮ
пкӏантӏэ	p t͡ʃ aː n t ʼ a
тэдэгьи	t a d a ɡʲ i
псэуагъэ	p s a w aː ʁ a
шъхьэтепхъу	ʂ ħ a t a j p χʷ
зафэ	z aː f a
шъхьапсӏэ	ʂ ħ aː p t͡s ʼ a
ебзэин	j a b z a j ə n
тхъын	t χ ə n
сыдж	s ə d͡ʒ
шъыпкъэу	ʂ ə p q a w
ӏэпшъэхъу	ʔ a p ʂ a χʷ
яужым	j aː w ʒ ə m
бгъотагъэ	b ʁʷ a t aː ʁ a
ӏофытэн	ʔʷ a f ə t a n
хьайнапэ	ħ a j ə n aː p
хэӏон	x a ʔʷ a n
мэлэлэн	m a l a l a n
джагъу	d͡ʒ a ʁʷ
къоладжэ	qʷ a l aː d͡ʒ a
пщынао	p ɕ ə n aː w a
жъэгъуай	ʐ a ʁʷ a j
дэи	d a j ə
джэндын	d͡ʒ a n d ə n
къамцӏыч	q aː m t͡s ʼ ə t͡ʃ
ӏэкӏэкӏын	ʔ a t͡ʃ ʼ a t͡ʃ ʼ ə n
къэгъэзэн	q a ʁ a z a n
гушӏуапкӏэ	ɡʷ ə ʃʷ ʼ a p t͡ʃ ʼ a
бжьэшх	b ʑ a ʃ x
уды	w ə d ə
ожьы	w a ʑ ə
щыгъу	ɕ ə ʁʷ
кӏолӏэн	j a kʷ ʼ a ɬ ʼ a n
шъхьэпразэ	ʂ ħ a p r aː z a
къыцэ	q ə t͡s a
дыйшъо	d ə j ʃʷ a
кӏэрэхъоцыкӏу	t͡ʃ a r a χʷ a t͡s ə kʷ ʼ
мэцӏэцӏэн	m a t͡s ʼ a t͡s ʼ a n
шъутыпсӏэ	ʃʷ ə t ə p s ʼ a
хегъэбылъхьэн	x e ʁ a b ə ɬ ħ a n
бгъэхэлъ	b ʁ a x a ɬ
багьэ	b aː ɡʲ a
пкӏэтэн	p t͡ʃ ʼ a t a n
дегъэбылъхьэн	d e ʁ a b ə ɬ ħ a n
аджар	aː d͡ʒ aː r
абхъаз	aː b χ aː z
енэгуягъо	j a n a ɡʷ ə j aː ʁʷ a
зи	z ə j
блыпкъыжъый	b l ə p q ə ʐ ə j
пыцӏэн	p ə t s ʼ a n
деусын	d a j s ə n
блыны	b l ə n ə
лъэш	ɬ a ʃ
пщтын	p ɕ t ə n
джэдыпэ	d͡ʒ a d ə p a
лыдын	ɮ ə d ə n
зэпедзын	z a p a j d͡z ə n
бгъэжъ	b ʁ a ʐ
зыплъыхьан	z ə p ɬ ə ħ aː n
пэӏоӏожьын	p a ʔʷ a ʔʷ a ʑ ə n
былымахъу	b ə l ə m aː χʷ
лъынэ	ɬ ə n a
шъойцый	ʃʷ a j t͡s ə j
лъэмыдж	ɬ a m ə d͡ʒ
лъэецуакъо	ɬ a j a t͡sʷ aː qʷ a
шэчалъ	ʃ a t͡ʃ aː ɬ
мыкӏэ	m ə t͡ʃ ʼ a
псэори	p s a w a r i
ыунэхъун	ʁ a w n a χʷ ʁ n
ӏэджэбыжэ	ʔ a d͡ʒ a b ə ʒ a
убытын	w b ə t ə n
жьыӏэшӏу	ʑ ə ʔ a ʃʷ ʼ
сакӏо	s aː kʷ ʼ a
бзэутэ	b z a w t a
лъэбжъанэ	ɬ a p ʐ aː n a
тэсӏэсӏэн	t a s ʼ a s ʼ a n
къуапсӏэ	qʷ aː p s ʼ a
гъончэдж	ʁʷ a n t͡ʃ a d͡ʒ
гупшысэн	ɡʷ ə p ʃ ə s a n
дежъыон	d a j ʐ ə w a n
иджэгъун	d͡ʒ a ʁʷ ə n
тецӏэцӏэн	t a j t͡s ʼ a t͡s ʼ a n
дырын	d ə r ə n
екӏун	j a kʷ ʼ ə n
апс	aː p s
нэфын	n a f ə n
джыджэн	m a d͡ʒ ə d͡ʒ a n
псэолъэшӏыпӏ	p s a w a ɬ a ʃ ʼ ə p ʼ
оды	w a d ə
фэшӏыкӏэ	f a ʃ ʼ ə t͡ʃ ʼ a
ешъугъон	j a ʃʷ ʁʷ ə n
былымбэлыдж	b ə l ə m b a l ə d͡ʒ
ланчъэ	l aː n t͡ʃ a
къашхъо	q aː ʃ χʷ a
пхъэныӏу	p χ a n ə ʔʷ
джагъо	d͡ʒ aː ʁʷ a
кӏыӏу	t͡ʃ ʼ ə ʔʷ
мэузын	m a w z ə n
кутлэ	kʷ ə t l a
пае	p aː j a
щыкӏэгъэн	ɕ ə t͡ʃ ʼ a ʁ a n
мэкӏосэн	m a kʷ ʼ a s a n
бэджанд	b a d͡ʒ aː n d
къошъолӏы	qʷ a ʂʷ a ɬ ʼ ə
ӏукӏын	ʔʷ a t͡ʃ ʼ ə n
мэушӏоин	m a w ʂʷ a j ə n
тепхэ	t a j p x a
щылыч	ɕ ə l ə t͡ʃ
тхыпкъылъэ	t x ə p q ə ɬ a
лъэшэу	ɬ a ʃ a w
пӏупкӏэ	pʷ ʼ ə n t͡ʃ ʼ a
зэуакӏо	z a w aː kʷ ʼ a
щыгушӏукӏьын	ʃ ə ɡʷ ə ʃʷ ʼ kʲ ʼ ə n
шыпхъу	ʃ ə p χʷ
зылӏэжьын	z aː ɬ ʼ a ʑ ə n
тӏэтӏэй	t ʼ a t ʼ a j
сымагьэ	s ə m aː ɡʲ a
еры	j a r ə
хъыбый	χ ə b ə j
быны	b ə n ə
мэтӏатӏэ	m a t ʼ aː t ʼ a
шъыда	ʂ ə d aː
шъуашэ	ʃʷ aː ʃ a
шъуатэ	ʃʷ aː t a
нэгъунджэ	n a ʁʷ ə n d͡ʒ a
мэтӏыгъо	m a t ə ʁʷ a
фэдэн	f a d a n
зэкӏэхьан	z a t͡ʂ a ħ a n
ины	j ə n ə
неущымыкӏ	n a j w ɕ ə m ə t͡ʃ ʼ
ӏэубытыпӏэ	ʔ a w b ə t ə p ʼ a
пӏысын	p ʼ ə s ə n
ал	aː l
обзэгъу	w a b z a ʁʷ
заулэ	z aː w l a
тучан	t u t͡ʃ aː n
джаущтэу	d͡ʒ aː w ə ɕ t a w
къэгужъон	q a ɡʷ ə ʒʷ a n
джыри	d͡ʒ ə r i
тхылъыщэ	t x ə ɬ ə ɕ a
нэпчэдыжьы	n a p t͡ʃ a d ə ʑ ə
шэпсэун	ʃ a p s a w ə n
мэткӏун	m a t kʷ ʼ ə n
джыны	d͡ʒ ə n ə
хьэ	ħ a
блэхьадж	b l a ħ aː d͡ʒ
декъузэн	d a j qʷ ə z a n
езэщын	j a z a ʃ ə n
ӏэнэгъунэ	ʔ a n a ʁʷ ə n a
хьарз	ħ a r z
пщылӏы	p ɕ ə ɬ ʼ
пылъапӏ	p ə ɬ aː p ʼ
лъэшыӏо	ɬ a ʃ ə ʔʷ a
гыныплъ	ɣ ə n ə p ɬ
чъохъон	t͡ʃʷ a χʷ a n
етын	j a t ə n
еукӏорэикӏын	j a w kʷ ʼ a r a j ə t͡ʃ ʼ ə n
щымын	z a w ə ʂ a f ə n
шъхьэӏух	ʂ ħ a ʔʷ ə x
псыбыб	p s ə b ə b
шъыкӏэ	ʂ ə kʲ a
лъэпкъгъэкӏод	ɬ a p q ʁ a kʷ ʼ a d
джыхьынэм	d͡ʒ ə ħ ə n a m
бэгъон	b a ʁʷ a n
ешӏужьын	j a ʃʷ ʼ ə ʑ ə n
гъуамэ	ʁʷ aː m a
ӏункӏэн	ʔʷ ə n t͡ʃ ʼ a n
пшъэдэлъ	p ʂ a d a ɬ
щыӏ	ɕ ə ʔ
гъэуэн	ʁ a w a n
хэшӏагъ	x a ʃ ʼ aː ʁ
мэлыгьын	m a l ə ɡʲ ə n
гъурз	ʁʷ ə r z
щызэу	ɕ ə z a w
ецыгъон	j a t͡s ə ʁʷ a n
хьарыпӏ	ħ aː r ə p ʼ
стылӏэн	s t ə ɬ ʼ a n
тхыон	t x ə w a n
къычӏэгъэкӏын	q ə t͡ʃ ʼ a ʁ a kʲ ʼ ə n
дэуахьы	d a w aː ħ ə
итхагъэп	j ə t x aː ʁ a p
ошъуапщэ	w a ʂʷ aː p ɕ a
кӏьэй	kʲ ʼ a j
джаур	d͡ʒ aː w ə r
бгъэхэӏу	b ʁ a x a ʔʷ
рэхьат	r a ħ aː t
бланэ	b l a n ɜ
тӏын	t ʼ ə n
шэкӏуахь	ʃ a kʷ ʼ aː ħ
чӏэгъэсӏэн	t͡ʃ ʼ a ʁ a s ʼ a n
ныбачъ	n ə b aː t͡ʂ
гъусэ	ʁʷ ə s a
мэкӏошъэн	m a kʷ ʼ a ʂ a n
екъудыин	qʷ ə d ə j ə n
зэ	z a
зэуэн	z a w a n
тэӏэн	t a ʔ a n
гъэсэн	ʁ a s a n
къолэн	qʷ a l a n
мэпрэзэн	m a p r a z a n
псэи	p s a j ə
кӏэлъэӏун	t͡ʃ ʼ a ɬ a ʔʷ ə n
жъапхъэ	ʐ aː p χ a
жэдэкон	ʒ a d a kʷ a n
гъэтӏысын	ʁ a t ʼ ə ɬ ə n
дэхьэ	d a ħ a
мамыщ	aː f ə
къакъыр	q aː q ə r
кӏьасэ	kʲ ʼ aː s a
цӏыфы	t͡s ʼ ə f ə
фегъэпэн	f a j ʁ a p a n
бзэджэн	b z a d͡ʒ a n
кӏасэ	t͡ʃ ʼ aː s a
мылы	m ə ɮ ə
мэукӏытэн	m a w t͡ʃ ə t a n
къычӏэщын	q ə t͡ʂ ʼ a ɕ ə n
гохьан	ɡʷ a ħ aː n
бгъэкӏэс	b ʁ a t͡ʃ a s
зыӏэгъэхьан	z a ʔ a ʁ a ħ a n
цӏэлъэн	t͡s ʼ a ɬ a n
къутыр	qʷ ə t ə r
пцэ	p t͡s a
мажьэ	m aː ʑ a
гукъау	ɡʷ ə q aː w
остыгъ	w a s t ə ʁ
зэплъэхьын	z a p ɬ a ħ ə n
кӏьэмгуе	kʲ ʼ a m ɡʷ ə j a
жъогъобын	ʐʷ a ʁʷ a b ə n
мэкъэкъащ	m a q a q aː ɕ
мацӏэ	m aː t͡s ʼ a
брацэ	b r aː t͡s a
фэшъуаш	f a ʃʷ aː ʃ
кӏьыин	kʲ ʼ ə j ə n
ӏэпшэхъу	ʔ a p ʃ a χʷ
ӏае	ʔ aː j a
пыун	p ə w ə n
еутэкӏын	j a w t a t͡ʃ ʼ ə n
джы	d͡ʒ ə
щыкӏэпс	ɕ ə kʲ ʼ a p s
пэтырэ	p a t ə r a
ӏэбжъанэ	ʔ a b ʐ aː n a
емын	j a m ə n
гогонжъый	ɡʷ a ɡʷ a n ʐ ə j
тэджын	t a d͡ʒ ə n
цӏэтхъун	t͡s ʼ a t χʷ ə n
гъы	ʁ ə
тхьэет	t h a j a t
къэсшъхьэпкӏьэтын	q a s ʂ ħ a p kʲ ʼ a t ə n
жантӏ	ʒ aː n t ʼ
тхьэ	t ħ a
деокӏын	d a j w a t͡ʃ ə n
бзыуцыф	b z ə w t͡s ə f
къины	q ə j n ə
сӏэсӏэн	s ʼ a s ʼ a n
адыгагъ	aː d ə ɣ aː ʁ
лӏагъэ	ɬˤ ʼ aː ʁ a
ӏэдэб	ʔ a d a b
удж	w ə d͡ʒ
матхъэжьын	m aː t χ a ʑ ə n
егъэбэджын	j a ʁ a b a d͡ʒ ə n
языфагу	jː z ə f aː ɡʷ
гъэлагъэ	ʁ a l aː ʁ a
пӏур	pʷ ʼ ə r
куогъу	kʷ ə w a ʁʷ
гъощэн	ʁʷ a ɕ a n
шӏокӏьын	ʃʷ ʼ a kʲ ʼ ə n
къыдэкӏухьан	q ə d a kʷ ʼ ə ħ aː n
жъоркъы	ʒʷ a r q ə
мэгъолъын	m a ʁʷ a ɬ ə n
щэрыу	ɕ a r ə w
хэкӏодэн	x a ʁʷ a ɕ a n
къэгъэучъыӏын	q a ʁ a w t ʂ ə ʔ ə n
шыукӏьытэн	ʃ ə w kʲ ʼ ə t a n
къоджэгъу	t͡ʃ ə ɮ a ʁʷ
псыжъы	p s ə ʐ ə
махъчэ	m aː χ t͡ʃ a
мыхъатэ	m ə χ aː t a
ерыуадж	j a r ə w aː d͡ʒ
блыпкъ	b l ə p q
блефын	b l a j f ə n
гухэгъэкӏын	ɡʷ ə x a ʁ a t͡ʃ ʼ ə n
мэщтэн	m a ɕ t a n
лъэу	ɬ a w
жэӏонтӏагъ	ʒ a ʔʷ a n t ʼ aː ʁ
лъэуж	ɬ a w ə ʒ
жьыкъыдэгъэкӏын	ʑ ə q ə d a ʁ a t͡ʃ ə n
ӏэчӏэхьан	ʔ a t͡ʃ ʼ a ħ aː n
тепӏо	t a j pʷ ʼ a
тегъэзын	t a j ʁ a z ə n
ӏус	ʔʷ ə s
дэгъэтӏытӏэн	d a ʁ a t ʼ ə t ʼ a n
лъфащэ	ɬ f aː ɕ a
жьызалъ	ʑ ə z aː ɬ
апэрэу	aː p a r a w
узыныгъэ	w ə z ə n ə ʁ a
чъужъ	t͡ʃʷ ə ʐ
оры	w a r ə
жъоплъ	ʐʷ a p ɬ
къэгъэущын	q a ʁ a w ɕ ə n
зэутэкӏын	z a w t a t͡ʃ ə n
мэкъупӏ	m a qʷ p ʼ
щыщэн	ɕ ə ɕ a n
даӏо	d aː ʔʷ a
улъыин	w ə ɬ ə j ə n
шыбгъэ	ʃ ə b ʁ a
мэфэзакъу	m a f a z aː qʷ
ежь	j a ʑ
бедэхьау	b e d a ħ aː w
цолъын	t͡ʃʷ a ɬ ə n
жэрыӏуабз	ʒ a r ə ʔʷ aː b z
дый	d ə j
тыгъуакӏо	t ə ʁʷ aː kʷ ʼ a
чӏылъэтеплъ	t͡ʃ ə ɬ a t a j p ɬ
япхъурэлъф	aː p χʷ ə r a ɬ f
пӏастӏэ	pˤ ʼ aː s tˤ ʼ a
лэжьын	ɮ a ʑ ə n
созэрэш	s o z a r a ʃ
лӏыгъэ	ɬ ʼ ə ʁ a
нэхаш	n a x aː ʃ
кьэупчъэ	kʲ a w ə p t͡ʂ a
джэрыуакӏо	d͡ʒ a r ə w aː kʷ ʼ a
мэчъыетхъун	m a ʃ t͡ə j a t χʷ ə n
бзыулъахъ	b z ə w ɬ aː χ
зыпари	z ə p aː r ə j
нэшан	n a ʃ aː n
адырабгъу	aː d ə r aː b ʁʷ
жъыу	ʐ ə w
нысэщэджэгу	n əː s a ɕ a d͡ʒ a ɡʷ
дэпкъы	d a p q ə
зэпичын	z a p i t͡ʃ ə n
мэкьэн	m a kʲ a n
къэкъыин	q a q ə j ə n
осы	w a s ə
хысыдж	x ə s ə d͡ʒ
кӏэракӏ	t͡ʃ ʼ a r aː t͡ʃ ʼ
ахъу	aː χʷ ə
кӏэшъун	t͡ʃ ʼ a ʃʷ ə n
къэ	q a
дэхьапӏэ	d a ħ aː p ʼ a
мэутӏэтӏэн	w ə t ʼ a t ʼ a n
чӏыгъыкӏэлъыбз	t͡ʃ ə ʁ ə t͡ʃ a ɬ ə b z
адрабгъу	aː d ə r aː b ʁʷ
пыдэн	p ə d a n
хэгъэон	x a ʁ a w a n
кӏэегъулъын	t͡ʃ ʼ a j a ʁʷ ə ɬ ə n
хьамцӏый	ħ aː m t͡sˤ ʼ ə j
тхьэцу	t ħ a t͡ʃʷ
лъыкӏотэн	ɬ ə kʷ ʼ a t a n
чӏэцӏэн	t͡ʂ ʼ a t͡s ʼ a n
жъогъозекӏу	ʐʷ a ʁʷ a z e kʷ
шӏоӏун	ʃʷ ʼ a ʔʷ ə n
къесын	q e s ə n
пщэры	p ɕ a r ə
шъотехьэтекӏ	ʂʷ a t a j ħ a t a j t͡ʃ
гуих	ɡʷ ə j ə x
чъыглэныстэ	t ʂ ə ɣ l a n ə s t a
зекӏо	z a j kʷ ʼ a
ебгын	j a b ɣ ə n
едзын	j a d͡ʒ ə n
лӏэужьыгъо	ɬ ʼ a w ʑ ə ʁʷ a
гъэшӏоӏун	ʁ a ʃʷ ʼ a ʔʷ ə n
жэкӏэпэсыс	ʒ a t͡ʃ a p a s ə s
цӏакӏэ	t͡s ʼ aː t͡ʃ a
чъыг	t ʂ ə ɣ
шхончау	ʃ xʷ a n t͡ʃ aː w
ӏашэнчъ	ʔ aː ʃ a t n t͡ʂ
лъэкӏоцӏ	ɬ a kʷ ʼ a t͡s ʼ
тӏыргъон	t ʼ ə r ʁʷ a n
чъэн	t ʂ a n
жалэ	ʒ aː l a
лӏыкӏо	ɬ ʼ ə kʷ ʼ a
пый	p ə j
пӏун	pʷ ʼ ə n
ехъопсэн	j a χʷ a p s a n
шӏуежьэжьын	ʃʷ ʼ a j ʑ a ʑ ə n
бзыукъолэн	b z ə w qʷ a l a n
цыулэ	t͡s ə w l a
кьэ	kʲ a
еблэгъэн	j a b l a ʁ a n
мэзэбэлыдж	m a z a b a l ə d͡ʒ
тэфэн	t a f a n
цыхьэмышӏ	t͡s ʼ ə ħ a m ə ʃ ʼ
жакӏьэ	ʒ aː kʲ a
нашэ	n aː ʃ a
къэщыпын	ʔʷ ə x ə n
зэокӏокъуашъу	z a w kʷ ʼ a qʷ a ʂʷ ə
феуэн	f a j w a n
чъыгышъхьэцыз	t͡ʂ ə ɣ ə ʂ ħ a t͡s ə z
изакъу	j ə z aː qʷ
жъыгъэ	ʐ ə ʁ a
мэтӏэтӏэн	m a t ʼ a t ʼ a n
бэлэрыгъ	b a l a r ə ʁ
гупыт	ɡʷ ə p ə t
абрамыжъу	aː b r aː m ə ʐʷ
лӏэн	ɬ ʼ a n
шъхьэгъусэ	ʂ ħ a ʁʷ ə s a
чэфынчъэ	t͡ʃ a f ə n t͡ʂ a
дегъэбзыхыкӏэн	ʁ a p s ə n
блэ	b l a
гупшысэ	ɡʷ ə p ʃ ə s a
мэтхытхын	m a t x ə t x ə n
хьаджыгъэ	ħ aː d͡ʒ ə ʁ a
зэӏыхьан	z a ʔ a ħ a n
прилъэшъон	p r ə j ɬ a ʃʷ a n
бэшӏагъ	b a ʃ ʼ aː ʁ
мэпщэн	m a p ɕ a n
алахь	aː lˤ aː ħ
ӏэбэн	ʔ a b a n
цызэ	t͡s ə z a
сэнэтхьапэ	s a n a t ħ aː p a
бжъэдыгъу	b ʐ a d ə ʁʷ
архъожъ	aː r χʷ a ʐ
