mosafræði	m ɔː s a f r a iː ð ɪ
belgur	p ɛ l k ʏ r
fjarstýra	f j a r̥ s t iː r a
vogunarsjóður	v ɔː ɡ ʏ n a r s j o uː ð ʏ r
garðyrkjumaður	k a r ð ɪ r̥ c ʏ m aː ð ʏ r
hvolfa	kʰ v ɔ l v a
riðill	r ɪː ð ɪ t l
léttúð	l j ɛ h t uː ð
tjaldur	tʰ j a l t ʏ r
gætni	c a i h t n ɪ
vingull	v i ŋ k ʏ t l
líkskurður	l iː k s k ʏ r ð ʏ r
koli	kʰ ɔː l ɪ
klaufalegur	kʰ l ø yː v a l ɛː ɣ ʏ r
jafnaðarstefna	j a p n aː ð a r s t ɛ p n a
skarð	s k a r ð
blær	p l a i̯ː r
fjallgarður	f j a t l k a r ð ʏ r
nágranni	n a uː k r a nː ɪ
stökkva	s t œ h k v a
bjalla	p j a t l a
næra	n a iː r a
hastur	h a s t ʏ r
svili	s v ɪː l ɪ
fjarvera	f j a r v ɛː r a
testósterón	tʰ ɛ s t o uː s t ɛː r o uː n
hárleggjastör	h a u r l ɛ cː a s t œː r
skynja	s c ɪ n j a
flöskuskeyti	f l œ s k ʏ s c e iː t ɪ
trúlegur	t r uː l ɛː ɣ ʏ r
sæta	s a iː t a
sigla	s ɪ k l a
sorg	s ɔ r k
spark	s p a r̥ k
safírblár	s aː f iː r p l a uː r
svelta	s v ɛ l̥ t a
el	ɛː l
goð	k ɔː ð
jarðskjálftafræði	j a r ð s c a u l̥ t a f r a iː ð ɪ
sýn	s iː n
skjaldarmerki	s c a l t a r m ɛ r̥ k ɪ
höstugur	h œ s t ʏː ɣ ʏ r
öryggisráð	œː r ɪ cː ɪ s r a uː ð
bakka	p a h k a
stjúpdóttir	s t j uː p t o u h t ɪ r
prútta	pʰ r u h t a
handarkriki	h a n t a r kʰ r ɪː c ɪ
fjötra	f j œː t r a
lægja	l a iː j a
bik	p ɪː k
jarðhneta	j a r ð n̥ ɛː t a
aðdráttur	a ð t r a u h t ʏ r
stífa	s t iː v a
hryggbrjóta	r̥ ɪ kː p r j o uː t a
kaðall	kʰ aː ð a t l
færeyskur	f a iː r e i s k ʏ r
klakkur	kʰ l a h k ʏ r
jónmundur	j o u n m ʏ n t ʏ r
slétta	s t l j ɛ h t a
þorsteinína	θ ɔ r̥ s t e iː n iː n a
hengistör	h e i ɲ c ɪ s t œː r
kæsa	cʰ a iː s a
sigfúsína	s ɪ x f uː s iː n a
sturlína	s t ʏ r t l iː n a
enskur	ɛ n s k ʏ r
járningamaður	j a u r t n i ŋ k a m aː ð ʏ r
ritill	r ɪː t ɪ t l
næs	n a iː s
tenging	tʰ e i ɲ c i ŋ k
tíð	tʰ iː ð
sítar	s iː tʰ aː r
skattur	s k a h t ʏ r
falda	f a l t a
kennd	cʰ ɛ n t
bleikja	p l e iː c a
háband	h a uː p a n t
mari	m aː r ɪ
prestur	pʰ r ɛ s t ʏ r
tölvupóstur	tʰ œ l v ʏ pʰ o u s t ʏ r
fantur	f a n̥ t ʏ r
krem	kʰ r ɛː m
hertogadæmi	h ɛ r̥ tʰ ɔː ɣ a t a iː m ɪ
halli	h a t l ɪ
frygð	f r ɪ ɣ ð
siga	s ɪː ɣ a
víðfrægur	v i ð f r a iː ɣ ʏ r
þríhyrnuburkni	θ r iː h ɪ r t n ʏ p ʏ r̥ k n ɪ
málsgrein	m a u l s k r e iː n
bil	p ɪː l
amper	a m̥ p ɛː r
óraddaður	o uː r a tː aː ð ʏ r
ríkisborgararéttur	r iː c ɪ s p ɔ r k a r a r j ɛ h t ʏ r
innihalda	ɪ nː ɪ h a l t a
kjötæta	cʰ œː t a iː t a
píka	pʰ iː k a
þynnka	θ i ŋ̊ k a
roðna	r ɔ ð n a
haugur	h ø yː ɣ ʏ r
slátur	s t l a uː t ʏ r
býsn	p i s t n
snemma	s n ɛ mː a
gagn	k a k n
múrhúð	m uː r h uː ð
farseðill	f a r̥ s ɛː ð ɪ t l
fjós	f j o uː s
eyvindína	e iː v ɪ n t iː n a
létta	l j ɛ h t a
tilgangur	tʰ ɪ l k a u ŋ k ʏ r
skósmiður	s k o uː s m ɪː ð ʏ r
marta	m a r̥ t a
sessa	s ɛ sː a
gler	k l ɛː r
hvalaskoðun	kʰ v aː l a s k ɔː ð ʏ n
hnoðafræhyrna	n̥ ɔː ð a f r a iː h ɪ r t n a
blóðleysi	p l o u ð l e iː s ɪ
þórey	θ o uː r e iː
klepri	kʰ l ɛː p r ɪ
hnykill	n̥ ɪː c ɪ t l
þéttur	θ j ɛ h t ʏ r
niðurlæging	n ɪː ð ʏ r l a iː j i ŋ k
þjálfa	θ j a u l v a
maki	m aː c ɪ
rjómakaka	r j o uː m a kʰ aː k a
orða	ɔ r ð a
hindrun	h ɪ n t r ʏ n
kommúnisti	kʰ ɔ mː uː n ɪ s t ɪ
kría	kʰ r iː j a
sandkassi	s a n t kʰ a sː ɪ
partur	pʰ a r̥ t ʏ r
ykkur	ɪ h k ʏ r
nefnd	n ɛ m t
drumbur	t r ʏ m p ʏ r
ánægður	a uː n a i ɣ ð ʏ r
lásbogi	l a uː s p ɔː j ɪ
sígaretta	s iː ɣ a r ɛ h t a
þrútna	θ r u h t n a
arinn	aː r ɪ nː
akarn	aː kʰ a r t n
hýena	h iː ɛ n a
íspinni	iː s pʰ ɪ nː ɪ
fjölröddun	f j œ l r œ tː ʏ n
nautakjöt	n ø yː t a cʰ œː t
bumba	p ʏ m p a
fótleggur	f o uː t l ɛ kː ʏ r
meðlæti	m ɛ ð l a iː t ɪ
móðurbróðir	m o uː ð ʏ r p r o uː ð ɪ r
kverkar	kʰ v ɛ r̥ k a r
frakkland	f r a h k l a n t
neópren	n ɛː o uː pʰ r ɛː n
ess	ɛ sː
aþeningur	aː θ ɛː n i ŋ k ʏ r
tríóla	tʰ r iː j o uː l a
sviti	s v ɪː t ɪ
norðmaður	n ɔ r ð m aː ð ʏ r
sæði	s a iː ð ɪ
hika	h ɪː k a
sefa	s ɛː v a
lúður	l uː ð ʏ r
pía	pʰ iː j a
hyr	h ɪː r
gras	k r aː s
lotugræðgi	l ɔː t ʏ k r a i ð c ɪ
varkár	v a r̥ kʰ a uː r
titrari	tʰ ɪː t r a r ɪ
innritun	ɪ nː r ɪː t ʏ n
skógur	s k o uː ʏ r
heilindi	h e iː l ɪ n t ɪ
tík	tʰ iː k
rúmur	r uː m ʏ r
hanna	h a nː a
umferð	ʏ m f ɛ r ð
hófsóley	h o u v s o uː l e iː
skraut	s k r ø yː t
prentun	pʰ r ɛ n̥ t ʏ n
vænta	v a i n̥ t a
holur	h ɔː l ʏ r
farsakenndur	f a r̥ s a cʰ ɛ n t ʏ r
gletta	k l ɛ h t a
meðstjórnendur	m ɛ ð s t j o u r t n ɛ n t ʏ r
mergur	m ɛ r k ʏ r
vídd	v i tː
beð	p ɛː ð
kyrrlæti	cʰ ɪ r l a iː t ɪ
kaldi	kʰ a l t ɪ
jafnoki	j a p n ɔː c ɪ
akbraut	aː k p r ø yː t
minnihluti	m ɪ nː ɪ l̥ ʏː t ɪ
stressa	s t r ɛ sː a
magnúsína	m a k n uː s iː n a
bumbubúi	p ʏ m p ʏ p uː ɪ
miski	m ɪ s c ɪ
hræða	r̥ a iː ð a
valmúi	v a l m uː ɪ
sívalningur	s iː v a l n i ŋ k ʏ r
almennur	a l m ɛ nː ʏ r
ket	cʰ ɛː t
guðjónína	k v ʏ ð j o uː n iː n a
námskeið	n a u m s c e iː ð
jafna	j a p n a
sefur	s ɛː v ʏ r
morthens	m ɔ r̥ t ɛ n s
greypa	k r e iː p a
smá	s m a uː
hvarmur	xʷ a r m ʏ r
heilbrigður	h e i l p r ɪ ɣ ð ʏ r
þýfður	θ i v ð ʏ r
feðraveldi	f ɛ ð r a v ɛ l t ɪ
agalegur	aː ɣ a l ɛ ɣ ʏ r
efla	ɛ p l a
guðbrandína	k v ʏ ð p r a n t iː n a
kamfóra	kʰ a m f o uː r a
stuna	s t ʏː n a
útbreiðsla	uː t p r e i ð s t l a
knöttur	kʰ n œ h t ʏ r
rjómaís	r j o uː m a iː s
ávinningur	a uː v ɪ nː i ŋ k ʏ r
lyfta	l ɪ f t a
men	m ɛː n
dádýr	t a uː t iː r
víða	v iː ð a
jarðúlfur	j a r ð u l v ʏ r
nói	n o uː ɪ
staðaratviksorð	s t aː ð a r aː t v ɪ k s ɔ r ð
hylur	h ɪː l ʏ r
fat	f aː t
kynbundinn	cʰ ɪ n p ʏ n t ɪ nː
maðra	m a ð r a
kyrkingur	cʰ ɪ r̥ c i ŋ k ʏ r
bjórvömb	p j o u r v œ m p
krap	kʰ r aː p
svertingi	s v ɛ r̥ t i ɲ c ɪ
posi	pʰ ɔː s ɪ
sannfæra	s a nː f a iː r a
tjarnablaðka	tʰ j a r t n a p l a ð k a
brautarstöð	p r ø yː t a r s t œː ð
augljóslega	ø y ɣ l j o uː s l ɛː ɣ a
tíðni	tʰ i ð n ɪ
frunti	f r ʏ n̥ t ɪ
munur	m ʏː n ʏ r
fágaður	f a uː a ð ʏ r
vordís	v ɔ r t iː s
eldsneyti	ɛ l t s n e iː t ɪ
asna	a s t n a
sinna	s ɪ nː a
hafragrautur	h a v r a k r ø yː t ʏ r
skyggn	s c ɪ k n
kæfa	cʰ a iː v a
þessi	θ ɛ sː ɪ
krókódíll	kʰ r o uː k o u t i t l
hraðbraut	r̥ a ð p r ø yː t
samfundur	s a m f ʏ n t ʏ r
of	ɔː v
ístað	iː s t aː ð
drjúpa	t r j uː p a
spað	s p aː ð
varmi	v a r m ɪ
haltur	h a l̥ t ʏ r
eygja	e iː j a
kerfill	cʰ ɛ r v ɪ t l
náma	n a uː m a
ólga	o u l k a
þykkni	θ ɪ h k n ɪ
frumlag	f r ʏ m l aː ɣ
ótti	o u h t ɪ
soldill	s ɔ l t ɪ t l
andrés	a n t r j ɛː s
helvíti	h ɛ l v iː t ɪ
sólarlag	s o uː l a r l aː ɣ
traktor	tʰ r a x t ɔ r
holtasóley	h ɔ l̥ t a s o uː l e iː
smánetla	s m a uː n ɛ h t l a
sippa	s ɪ h p a
núa	n uː a
stef	s t ɛː v
hjálmur	ç a u l m ʏ r
frónsk	f r o u n s k
kænn	cʰ a i t n
múhameð	m uː h a m ɛː ð
mey	m e iː
hvörf	kʰ v œ r v
tvíburi	tʰ v iː p ʏː r ɪ
gandur	k a n t ʏ r
smygill	s m ɪː j ɪ t l
fákur	f a uː k ʏ r
biðstöð	p ɪ ð s t œː ð
digur	t ɪː ɣ ʏ r
víst	v i s t
tré	tʰ r j ɛː
landafræði	l a n t a f r a iː ð ɪ
geirharður	c e iː r h a r ð ʏ r
árásarmaður	a uː r a uː s a r m aː ð ʏ r
spinna	s p ɪ nː a
gimbur	c ɪ m p ʏ r
embætti	ɛ m p a i h t ɪ
lúði	l uː ð ɪ
kafa	kʰ aː v a
bendir	p ɛ n t ɪ r
kólna	kʰ o u l n a
eldstöð	ɛ l t s t œː ð
ætt	a i h t
apalhraun	aː p a l r̥ ø yː n
saur	s ø yː r
daglega	t a ɣ l ɛː ɣ a
snoppufríður	s t n ɔ h p ʏ f r iː ð ʏ r
foreldrar	f ɔː r ɛ l t r a r
árstími	a u r s tʰ iː m ɪ
nashyrningur	n aː s h ɪ r t n i ŋ k ʏ r
knipla	kʰ n ɪ h p l a
görn	k œ r t n
sundgleraugu	s ʏ n t k l ɛː r ø yː ɣ ʏ
ljár	l j a uː r
freista	f r e i s t a
háaloft	h a uː a l ɔ f t
stóðgarður	s t o u ð k a r ð ʏ r
saurugur	s ø yː r ʏː ɣ ʏ r
vigt	v ɪ x t
eyra	e i r a
heyrn	h e i r t n
sæunn	s a iː j ʏ nː
ofurhetja	ɔː v ʏ r h ɛː t j a
bremsa	p r ɛ m s a
dunda	t ʏ n t a
hólmur	h o u l m ʏ r
hávaði	h a uː v aː ð ɪ
sviss	s v ɪ sː
sjampó	s j a m̥ p o uː
nagdýr	n a ɣ t iː r
veiðimaður	v e iː ð ɪ m aː ð ʏ r
sögn	s œ k n
byggð	p ɪ ɣ ð
gretta	k r ɛ h t a
kvaka	kʰ v aː k a
ryð	r ɪː ð
knéfiðla	kʰ n j ɛː f ɪ ð l a
fram	f r a mː
efnilegur	ɛ p n ɪ l ɛː ɣ ʏ r
styggja	s t ɪ cː a
aðskilnaður	a ð s c ɪ l n aː ð ʏ r
tregi	tʰ r e iː j ɪ
loga	l ɔː ɣ a
líkamlegur	l iː kʰ a m l ɛː ɣ ʏ r
nálægur	n a uː l a iː ɣ ʏ r
auðæfi	ø yː ð a iː v ɪ
kálfur	kʰ a u l v ʏ r
ákafur	a uː k aː v ʏ r
kristján	kʰ r ɪ s t j a uː n
riða	r ɪː ð a
púla	pʰ uː l a
egglos	ɛ kː l ɔː s
freydís	f r e iː t iː s
prakkarastrik	pʰ r a h k a r a s t r ɪː k
átt	a u h t
klósett	kʰ l o uː s ɛ h t
stoppun	s t ɔ h p ʏ n
mjónefur	m j o uː n ɛː v ʏ r
fimm	f ɪ mː
eysill	e iː s ɪ t l
naflagras	n a p l a k r aː s
gengi	c e i ɲ c ɪ
gylta	c ɪ l̥ t a
sauðvingull	s ø y ð v i ŋ k ʏ t l
gvatemala	k v aː tʰ ɛː m aː l a
ris	r ɪː s
sætur	s a iː t ʏ r
fiskibolla	f ɪ s c ɪ p ɔ lː a
fífl	f i p l
klaki	kʰ l aː c ɪ
flak	f l aː k
etýða	ɛː tʰ iː ð a
kræklóttur	kʰ r a i h k l o u h t ʏ r
gissunn	c ɪ sː ʏ nː
spónn	s p o u t n
akurstjarna	aː k ʏ r s t j a r t n a
girnd	c ɪ r n t
kvendýr	kʰ v ɛ n t iː r
dráttur	t r a u h t ʏ r
tristan	tʰ r ɪ s t a n
tónkvísl	tʰ o u n kʰ v i s t l
haddur	h a tː ʏ r
rann	r a nː
meri	m ɛː r ɪ
taska	tʰ a s k a
gróf	k r o uː v
glíma	k l iː m a
korn	kʰ ɔ r t n
skóli	s k o uː l ɪ
hávær	h a uː v a iː r
skuldari	s k ʏ l t aː r ɪ
flórens	f l o uː r ɛ n s
þeta	θ ɛː t a
sverð	s v ɛ r ð
stansa	s t a n s a
stofa	s t ɔː v a
frakkneskur	f r a h k n ɛ s k ʏ r
þíða	θ iː ð a
slag	s t l aː ɣ
biðtími	p ɪ ð tʰ iː m ɪ
vigur	v ɪː ɣ ʏ r
stöngull	s t ø y ŋ k ʏ t l
meiddur	m e i tː ʏ r
hálfsystir	h a u l v s ɪ s t ɪ r
fríða	f r iː ð a
petrína	p ɛː t r iː n a
skorningur	s k ɔ r t n i ŋ k ʏ r
sólhattur	s o u l h a h t ʏ r
samþykki	s a m θ ɪ h c ɪ
belti	p ɛ l̥ t ɪ
klukka	kʰ l ʏ h k a
geit	c e iː t
göldróttur	k œ l t r o u h t ʏ r
furðulegur	f ʏ r ð ʏ l ɛː ɣ ʏ r
sauðlaukur	s ø y ð l ø yː k ʏ r
túndra	tʰ u n t r a
hnetusmjör	n̥ ɛː t ʏ s m j œː r
sundlaug	s ʏ n t l ø yː ɣ
smala	s m aː l a
dýfa	t iː v a
klettafrú	kʰ l ɛ h t a f r uː
dögg	t œ kː
hella	h ɛ t l a
viður	v ɪː ð ʏ r
gustur	k ʏ s t ʏ r
hrossafluga	r̥ ɔ sː a f l ʏː ɣ a
vélbúnaður	v j ɛ l p uː n aː ð ʏ r
kok	kʰ ɔː k
dafna	t a p n a
kitla	cʰ ɪ h t l a
göfugur	k œː v ʏ ɣ ʏ r
kristþyrnir	kʰ r ɪ s t θ ɪ r t n ɪ r
harmóníum	h a r m o uː n iː j ʏ m
kröggur	kʰ r œ kː ʏ r
hneykja	n̥ e iː c a
andersen	a n t ɛ r s ɛ nː
klipping	kʰ l ɪ h p i ŋ k
durgur	t ʏ r k ʏ r
leikkona	l e iː k kʰ ɔː n a
handavinna	h a n t a v ɪ nː a
pyttur	pʰ ɪ h t ʏ r
uppsalir	ʏ h p s aː l ɪ r
bakstur	p a x s t ʏ r
boða	p ɔː ð a
stífna	s t i p n a
bygging	p ɪ cː i ŋ k
fals	f a l s
sápa	s a uː p a
súrmjólk	s u r m j o u l̥ k
kisa	cʰ ɪː s a
fölna	f œ l n a
verkfæri	v ɛ r̥ k f a iː r ɪ
bakuggi	p aː k ʏ cː ɪ
spæla	s p a iː l a
sverja	s v ɛ r j a
síbería	s iː p ɛ r iː j a
jarðskorpa	j a r ð s k ɔ r̥ p a
fölur	f œː l ʏ r
bras	p r aː s
auðmýking	ø y ð m iː c i ŋ k
ljósvaki	l j o uː s v aː c ɪ
garðaprjón	k a r ð a pʰ r j o uː n
nostalgía	n ɔ s t a l c i j a
bruggun	p r ʏ kː ʏ n
gróði	k r o uː ð ɪ
undarlega	ʏ n t a r l ɛː ɣ a
stjórnborð	s t j o u r t n p ɔ r ð
gjöfull	c œː v ʏ t l
pollur	pʰ ɔ t l ʏ r
lífvörður	l i v v œ r ð ʏ r
svipta	s v ɪ f t a
frelsishetja	f r ɛ l s ɪ s h ɛː t j a
deyja	t e iː j a
framhlaðningur	f r a m l̥ a ð n i ŋ k ʏ r
fursti	f ʏ r̥ s t ɪ
minni	m ɪ nː ɪ
dauði	t ø yː ð ɪ
heimskautsnótt	h e i m s k ø y t s n o u h t
löggjafarþing	l œ ɣ c aː v a r θ i ŋ k
hlýja	l̥ iː j a
heima	h e iː m a
þráðnykra	θ r a u ð n ɪː k r a
grasnykra	k r aː s n ɪː k r a
soffía	s ɔ fː iː j a
albínói	a l p iː n o uː ɪ
sulta	s ʏ l̥ t a
ofviðri	ɔ v v ɪ ð r ɪ
bílalest	p iː l a l ɛ s t
höfðaborg	h œ v ð a p ɔ r k
ómega	o uː m ɛː k a
heild	h e i l t
hjörtur	ç œ r̥ t ʏ r
aðalakkeri	aː ð a l a h k ɛː r ɪ
vasapeli	v aː s a pʰ ɛː l ɪ
handleggur	h a n t l ɛ kː ʏ r
herfugl	h ɛː r f ʏ k l
hýði	h iː ð ɪ
ólafía	o uː l a v iː j a
hérmeð	ç ɛ r m ɛː ð
bolur	p ɔː l ʏ r
kjarkur	cʰ a r̥ k ʏ r
deild	t e i l t
aðdráttarafl	a ð t r a u h t a r a p l
ævi	a iː v ɪ
majór	m a j o uː r
velkomandaminni	v ɛ l kʰ ɔː m a n t a m ɪ nː ɪ
magur	m aː ɣ ʏ r
kósínus	kʰ o uː s iː n ʏ s
rannsókn	r a nː s o u h k n
aukning	ø y h k n i ŋ k
kristín	kʰ r ɪ s t iː n
múrmeldýr	m u r m ɛ l t iː r
breiður	p r e iː ð ʏ r
glymur	k l ɪː m ʏ r
afríkanska	aː f r iː kʰ a n s k a
regnþykkni	r ɛ k n θ ɪ h k n ɪ
boð	p ɔː ð
as	aː s
sannlega	s a nː l ɛː ɣ a
víóla	v iː j o uː l a
koks	kʰ ɔ x s
unna	ʏ nː a
froða	f r ɔː ð a
dreyri	t r e iː r ɪ
ilskór	ɪ l s k o uː r
skorpa	s k ɔ r̥ p a
skíðaþjálfari	s c iː ð a θ j a u l v aː r ɪ
staðarfall	s t aː ð a r f a t l
eiturlyfjanotandi	e iː t ʏ r l ɪ v j a n ɔː t a n t ɪ
hjólabretti	ç o uː l a p r ɛ h t ɪ
skáli	s k a uː l ɪ
fjalldalafífill	f j a t l t aː l a f iː v ɪ t l
hálfur	h a u l v ʏ r
legbólga	l ɛ ɣ p o u l k a
mútta	m uʰ t a
noregur	n ɔː r ɛː ɣ ʏ r
þeba	θ ɛː p a
glissa	k l ɪ sː a
leiða	l e iː ð a
hnefaleikar	n̥ ɛː v a l e iː k a r
mjaldur	m j a l t ʏ r
vanræksla	v a n r a i k s t l a
piss	pʰ ɪ sː
einhentur	e iː n h ɛ n̥ t ʏ r
landbúnaður	l a n t p uː n aː ð ʏ r
mýmargur	m iː m a r k ʏ r
umfang	ʏ m f a u ŋ k
rígur	r iː ɣ ʏ r
svindl	s v ɪ n t l
eimur	e iː m ʏ r
þrakía	θ r aː cʰ iː j a
vetrarbraut	v ɛː t r a r p r ø yː t
feikn	f e i h k n
hleri	l̥ ɛː r ɪ
beykitré	p e iː c ɪ t r j ɛː
dingla	t i ŋ l a
breiðþota	p r e i ð θ ɔː t a
bleyði	p l e iː ð ɪ
alexander	aː l ɛ k s a n t ɛː r
rafsvið	r a v s v ɪː ð
brauðmylsna	p r ø y ð m ɪ l s t n a
hélumosi	ç ɛː l ʏ m ɔː s ɪ
tríósónata	tʰ r iː j o uː s o uː n aː t a
asni	a s t n ɪ
kölkun	kʰ œ l̥ k ʏ n
trúarjátning	tʰ r uː a r j a u h t n i ŋ k
segja	s e iː j a
fræðsla	f r a i ð s t l a
sala	s aː l a
grúbba	k r u pː a
þyrping	θ ɪ r̥ p i ŋ k
ekill	ɛː c ɪ t l
klúbbur	kʰ l u pː ʏ r
mör	m œː r
liðþjálfi	l ɪ θ θ j a u l v ɪ
eiginleiki	e iː j ɪ n l e iː c ɪ
lipur	l ɪː p ʏ r
haraldína	h aː r a l t iː n a
vinur	v ɪː n ʏ r
gula	k ʏː l a
gúlrotta	k u l r ɔ h t a
spurnarfornafn	s p ʏ r t n a r f ɔ r n a p n
teikning	tʰ e i h k n i ŋ k
pinni	pʰ ɪ nː ɪ
skilaboð	s c ɪː l a p ɔː ð
lægð	l a i ɣ ð
evrópa	ɛ v r o uː p a
hafna	h a p n a
saltaður	s a l̥ t aː ð ʏ r
brúðkaup	p r u ð kʰ ø yː p
kúkur	kʰ uː k ʏ r
skeyta	s c e iː t a
trúss	tʰ r u sː
múli	m uː l ɪ
austurríki	ø y s t ʏ r r iː c ɪ
reyna	r e iː n a
lífsandi	l i f s a n t ɪ
einhjól	e i n ç o uː l
hrjósa	r̥ j o uː s a
nokkur	n ɔ h k ʏ r
arður	a r ð ʏ r
friðmundur	f r ɪ ð m ʏ n t ʏ r
fress	f r ɛ sː
blífa	p l iː v a
stétt	s t j ɛ h t
einveldi	e i n v ɛ l t ɪ
afbökun	a v p œː k ʏ n
tennis	tʰ ɛ nː ɪ s
ragnheiður	r a k n h e iː ð ʏ r
umbrot	ʏ m p r ɔː t
hringvöðvi	r̥ i ŋ k v œ ð v ɪ
illska	ɪ l s k a
misræmi	m ɪː s r a iː m ɪ
flenna	f l ɛ nː a
ónáða	o uː n a uː ð a
tölva	tʰ œ l v a
skæri	s c a iː r ɪ
kím	cʰ iː m
kvars	kʰ v a r̥ s
dugur	t ʏː ɣ ʏ r
spænska	s p a i n s k a
hirð	h ɪ r ð
sigmar	s ɪ ɣ m aː r
eða	ɛː ð a
hrelling	r̥ ɛ t l i ŋ k
gum	k ʏː m
svað	s v aː ð
tætingur	tʰ a iː t i ŋ k ʏ r
hrína	r̥ iː n a
lyngjafni	l i ŋ k j a p n ɪ
krukka	kʰ r ʏ h k a
kerra	cʰ ɛ rː a
skriflegur	s k r ɪ v l ɛː ɣ ʏ r
pakkhús	pʰ a h k h uː s
gull	k ʏ t l
stýfa	s t iː v a
sig	s ɪː ɣ
hark	h a r̥ k
körfuknattleiksþjálfari	kʰ œ r v ʏ kʰ n a h t l e i k s θ j a u l v a r ɪ
há	h a uː
staukur	s t ø yː k ʏ r
stroff	s t r ɔ fː
beiti	p e iː t ɪ
glufa	k l ʏː v a
æðri	a i ð r ɪ
tónsproti	tʰ o u n s p r ɔː t ɪ
skipasmíði	s c ɪː p a s m iː ð ɪ
skref	s k r ɛː v
bana	p aː n a
kýpur	cʰ iː p ʏ r
sesín	s ɛː s iː n
kynsjúkdómur	cʰ ɪ n s j uː k t o uː m ʏ r
töframaður	tʰ œ v r a m aː ð ʏ r
þræta	θ r a iː t a
skjöldur	s c œ l t ʏ r
ártíð	a uː r tʰ iː ð
klekja	kʰ l ɛː c a
hraður	r̥ aː ð ʏ r
hængur	h a i ŋ k ʏ r
lóga	l o uː a
bljúgur	p l j uː ʏ r
skæla	s c a iː l a
makedónía	m aː kʰ ɛː t o uː n iː j a
æs	a iː s
hylling	h ɪ t l i ŋ k
kalkspat	kʰ a l̥ k s p aː t
jafningi	j a p n i ɲ c ɪ
mæðgur	m a i ð k ʏ r
gepill	c ɛː p ɪ t l
stynja	s t ɪ n j a
skulda	s k ʏ l t a
fjölskylda	f j œ l s c ɪ l t a
fær	f a iː r
símon	s iː m ɔː n
klafi	kʰ l aː v ɪ
rota	r ɔː t a
tómstundagaman	tʰ o u m s t ʏ n t a k aː m a n
pílári	pʰ iː l a uː r ɪ
skurður	s k ʏ r ð ʏ r
formkaka	f ɔ r m kʰ aː k a
leðja	l ɛ ð j a
ísmael	iː s m aː ɛː l
leira	l e iː r a
voff	v ɔ fː
sí	s iː
hangikjöt	h a u ŋ c ɪ cʰ œː t
grár	k r a uː r
míga	m iː ɣ a
yfirtónn	ɪː v ɪ r tʰ o u t n
ferðamaður	f ɛ r ð a m aː ð ʏ r
mynda	m ɪ n t a
þríhliða	θ r iː l̥ ɪː ð a
gana	k aː n a
rusla	r ʏ s t l a
sessunautur	s ɛ sː ʏ n ø yː t ʏ r
cé	s j ɛː
mismikill	m ɪː s m ɪː c ɪ t l
dauðadá	t ø yː ð a t a uː
sigríður	s ɪ ɣ r iː ð ʏ r
litúrgískur	l ɪː tʰ u r c i s k ʏ r
sameind	s aː m e i n t
kynblendingur	cʰ ɪ n p l ɛ n t i ŋ k ʏ r
tyggja	tʰ ɪ cː a
narfi	n a r v ɪ
heimsendir	h e i m s ɛ n t ɪ r
umdeildur	ʏ m t e i l t ʏ r
hreindýramosi	r̥ e i n t iː r a m ɔː s ɪ
tíðahvörf	tʰ iː ð a xʷ œ r v
kaktus	kʰ a x t ʏ s
skeiðklukka	s c e i ð kʰ l ʏ h k a
fræni	f r a iː n ɪ
hringa	r̥ i ŋ k a
peningaseðill	pʰ ɛː n i ŋ k a s ɛː ð ɪ t l
fyl	f ɪː l
votta	v ɔ h t a
moppa	m ɔ h p a
kínín	cʰ iː n iː n
gikkja	c ɪ h c a
ell	ɛ t l
spjót	s p j o uː t
sólsetur	s o u l s ɛː t ʏ r
sölvi	s œ l v ɪ
útlenskur	uː t l ɛ n s k ʏ r
apótekari	aː p o uː tʰ ɛː k aː r ɪ
skrín	s k r iː n
frjó	f r j o uː
sjóða	s j o uː ð a
trufla	tʰ r ʏ p l a
mögulegur	m œː ɣ ʏ l ɛː ɣ ʏ r
tumi	tʰ ʏː m ɪ
aðstoðarmaður	a ð s t ɔː ð a r m aː ð ʏ r
júnímánuður	j uː n iː m a uː n ʏ ð ʏ r
álftalaukur	a u l̥ t a l ø yː k ʏ r
fólk	f o u l̥ k
föstudagur	f œ s tʰ ʏ t aː ɣ ʏ r
dunkur	t u ŋ̊ k ʏ r
gullintoppa	k ʏ t l ɪ n tʰ ɔ h p a
rúmfræði	r u m f r a iː ð ɪ
trunta	t r ʏ n̥ t a
strjúka	s t r j uː k a
stjörnufræðingur	s t j œ r t n ʏ f r a iː ð i ŋ k ʏ r
brunahani	p r ʏː n a h aː n ɪ
frægð	f r a i ɣ ð
býfur	p iː v ʏ r
blóðþrýstingur	p l o u ð θ r i s t i ŋ k ʏ r
mauka	m ø yː k a
veill	v e i t l
eintal	e i n tʰ aː l
dvína	t v iː n a
þorskur	θ ɔ r̥ s k ʏ r
loft	l ɔ f t
blár	p l a uː r
ritkerfi	r ɪː t cʰ ɛ r v ɪ
heimula	h e iː m ʏː l a
sull	s ʏ t l
fræði	f r a iː ð ɪ
númer	n uː m ɛː r
útiloka	uː t ɪ l ɔː k a
forstaða	f ɔ r̥ s t aː ð a
brottfall	p r ɔ h t f a t l
vatt	v a h t
slíta	s t l iː t a
smók	s m o uː k
bjó	p j o uː
handbremsa	h a n t p r ɛ m s a
sníða	s n iː ð a
snifsi	s t n ɪ f s ɪ
þurr	θ ʏ rː
korra	kʰ ɔ rː a
hlutur	l̥ ʏː t ʏ r
kross	kʰ r ɔ sː
ánægjulegur	a uː n a i j ʏ l ɛː ɣ ʏ r
kækur	cʰ a iː k ʏ r
silkibygg	s ɪ l̥ c ɪ p ɪ kː
setningafræði	s ɛ h t n i ŋ k a f r a iː ð ɪ
farsi	f a r̥ s ɪ
stífur	s t iː v ʏ r
reglulegur	r ɛ k l ʏ l ɛː ɣ ʏ r
blæösp	p l a iː œ s p
kássa	kʰ a u sː a
falur	f aː l ʏ r
víður	v iː ð ʏ r
kenjar	cʰ ɛ n j a r
bárður	p a u r ð ʏ r
lausung	l ø yː s u ŋ k
nám	n a uː m
sigdís	s ɪ ɣ t iː s
skriðuhnoðri	s k r ɪː ð ʏ n̥ ɔ ð r ɪ
orðsifjabók	ɔ r ð s ɪ v j a p o uː k
lykta	l ɪ x t a
bifa	p ɪː v a
þríeinn	θ r iː e i t n
kjarkmikill	cʰ a r̥ k m ɪː c ɪ t l
sitja	s ɪː t j a
klöpp	kʰ l œ h p
flýtir	f l iː t ɪ r
lás	l a uː s
mýrasóley	m iː r a s o uː l e iː
boðberi	p ɔ ð p ɛː r ɪ
millinafn	m ɪ t l ɪ n a p n
radísa	r aː t iː s a
plampa	pʰ l a m̥ p a
óléttur	o uː l j ɛ h t ʏ r
gæs	c a iː s
spekt	s p ɛ x t
rengla	r e i ŋ l a
skratti	s k r a h t ɪ
nafnháttarmerki	n a p n h a u h t a r m ɛ r̥ c ɪ
dabbi	t a pː ɪ
broddsúla	p r ɔ tː s uː l a
álfheiður	a u l v h e iː ð ʏ r
mannlegur	m a nː l ɛː ɣ ʏ r
hjartafífill	ç a r̥ t a f iː v ɪ t l
skylda	s c ɪ l t a
tákn	tʰ a u h k n
stafla	s t a p l a
blinda	p l ɪ n t a
slys	s t l ɪː s
auka	ø yː k a
draumsóley	t r ø y m s o uː l e iː
hræðsla	r̥ a i ð s t l a
fljótur	f l j o uː t ʏ r
nígería	n iː k ɛː r iː j a
þrái	θ r a uː ɪ
seðja	s ɛ ð j a
bosnía	p ɔ s t n iː j a
díki	t iː c ɪ
jess	j ɛ sː
vín	v iː n
próf	pʰ r o uː v
hjólreiðabraut	ç o u l r e iː ð a p r ø yː t
sjal	s j aː l
milljón	m ɪ l j o uː n
líkindi	l iː c ɪ n t ɪ
koddaver	kʰ ɔ tː a v ɛː r
áhugasamur	a u h ʏː ɣ a s aː m ʏ r
tækling	tʰ a i h k l i ŋ k
kóróna	kʰ o uː r o uː n a
áttundi	a u h t ʏ n t ɪ
runnamura	r ʏ nː a m ʏː r a
fimma	f ɪ mː a
sporðdreki	s p ɔ r ð t r ɛː c ɪ
drjúgur	t r j uː ʏ r
blunda	p l ʏ n t a
kalifornía	kʰ aː l ɪ f ɔ r n i j a
skírlífi	s c i r l iː v ɪ
gengill	c e i ɲ c ɪ t l
ilma	ɪ l m a
padda	pʰ a tː a
fjárhundur	f j a u r h ʏ n t ʏ r
matreiðsla	m aː t r e i ð s t l a
efna	ɛ p n a
breyting	p r e iː t i ŋ k
þvo	θ v ɔː
háseti	h a uː s ɛː t ɪ
blogga	p l ɔ kː a
bronsöld	p r ɔ n s œ l t
mund	m ʏ n t
safi	s aː v ɪ
segl	s ɛ k l
túli	tʰ uː l ɪ
rigning	r ɪ k n i ŋ k
laugardagur	l ø yː ɣ a r t aː ɣ ʏ r
fiðla	f ɪ ð l a
hjarna	ç a r t n a
málefni	m a uː l ɛ p n ɪ
karen	kʰ aː r ɛː n
baks	p a k s
gulna	k ʏ l n a
austur	ø y s t ʏ r
ósíris	o uː s iː r ɪ s
jötunn	j œː tʰ ʏ nː
albanska	a l p a n s k a
flagasóley	f l aː ɣ a s o uː l e iː
halldís	h a l t iː s
handrið	h a n t r ɪː ð
spói	s p o uː ɪ
titringur	tʰ ɪː t r i ŋ k ʏ r
æviágrip	a iː v ɪ a uː k r ɪː p
liðfætla	l ɪ ð f a i h t l a
súpa	s uː p a
þristur	θ r ɪ s t ʏ r
gjaldeyrir	c a l t e iː r ɪ r
grænkál	k r a i n kʰ a uː l
vega	v ɛː ɣ a
uppsetning	ʏ h p s ɛ h t n i ŋ k
skoðun	s k ɔː ð ʏ n
gramúlfur	k r aː m u l v ʏ r
mýbit	m iː p ɪː t
matarborð	m aː t a r p ɔ r ð
goði	k ɔː ð ɪ
gikkur	c ɪ h k ʏ r
mjalli	m j a t l ɪ
rússland	r u s t l a n t
myndband	m ɪ n t p a n t
prag	pʰ r aː ɣ
strumpur	s t r ʏ m̥ p ʏ r
viti	v ɪː t ɪ
sök	s œː k
elfa	ɛ l v a
lykt	l ɪ x t
stuttermabolur	s t ʏ h t ɛ r m a p ɔː l ʏ r
kvaran	kʰ v aː r a n
hermd	h ɛ r m t
skauta	s k ø yː t a
hlýna	l̥ iː n a
blossi	p l ɔ sː ɪ
þjónusta	θ j o uː n ʏ s t a
jólakúla	j o uː l a kʰ uː l a
fartölva	f a r̥ tʰ œ l v a
sirkon	s ɪ r̥ k ɔː n
flekkaður	f l ɛ h k a ð ʏ r
oxíð	ɔ k s iː ð
fokk	f ɔ h k
tölusetja	tʰ œː l ʏ s ɛː t j a
markalína	m a r̥ k a l iː n a
stampur	s t a m̥ p ʏ r
ákavíti	a uː k a v iː t ɪ
þérun	θ j ɛː r ʏ n
faraó	f aː r a o uː
konráðína	kʰ ɔ n r a uː ð iː n a
höfnun	h œ p n ʏ n
blástur	p l a u s t ʏ r
orðflokkur	ɔ r ð f l ɔ h k ʏ r
folafluga	f ɔː l a f l ʏː ɣ a
kornbreskur	kʰ ɔ r t n p r ɛ s k ʏ r
léttvatn	l j ɛ h t v a h t n
hjörð	ç œ r ð
þurrka	θ ʏ r̥ k a
dyngja	t i ɲ c a
kvöð	kʰ v œː ð
skema	s c ɛː m a
líffræði	l i f f r a iː ð ɪ
hóffífill	h o u v f iː v ɪ t l
rið	r ɪː ð
horaður	h ɔː r a ð ʏ r
alnet	a l n ɛː t
spánverji	s p a u n v ɛ r j ɪ
hryssingslegur	r̥ ɪ sː i ŋ k s l ɛː ɣ ʏ r
hóruhús	h o uː r ʏ h uː s
erfiðisvinna	ɛ r v ɪː ð ɪ s v ɪ nː a
skreppa	s k r ɛ h p a
beitukóngur	p e iː t ʏ kʰ o u ŋ k ʏ r
afturbeygður	a f t ʏ r p e i ɣ ð ʏ r
staða	s t aː ð a
viftureim	v ɪ f t ʏ r e iː m
orkneyjar	ɔ r̥ k n e iː j a r
skella	s c ɛ t l a
skyr	s c ɪː r
sýkn	s i h k n
gala	k aː l a
skeri	s c ɛː r ɪ
gjaldkeri	c a l t cʰ ɛː r ɪ
viðskeyti	v ɪ ð s c e iː t ɪ
þefa	θ ɛː v a
vallarsveifgras	v a t l a r s v e i v k r aː s
snarl	s t n a r t l
trissa	tʰ r ɪ sː a
smánykra	s m a uː n ɪː k r a
metan	m ɛː tʰ aː n
siglt	s ɪ ɬ t
vær	v a iː r
þýðing	θ iː ð i ŋ k
einkalykill	e i ŋ k a l ɪː c ɪ t l
morgunkorn	m ɔ r k ʏ n kʰ ɔ r t n
skurðgröftur	s k ʏ r ð k r œ f t ʏ r
flekkur	f l ɛ h k ʏ r
rekja	r ɛː c a
sárasótt	s a uː r a s o u h t
lóa	l o uː a
snækrækill	s n a iː kʰ r a iː c ɪ t l
veður	v ɛː ð ʏ r
þú	θ u
kast	kʰ a s t
dofi	t ɔː v ɪ
logri	l ɔ ɣ r ɪ
rjátla	r j a u h t l a
handbók	h a n t p o uː k
sykurmoli	s ɪː k ʏ r m ɔː l ɪ
nýtt	n i h t
júlíus	j uː l iː j ʏ s
barnalæknir	p a r t n a l a i h k n ɪ r
jórunn	j o uː r ʏ nː
höfgi	h œ v c ɪ
teygjubyssa	tʰ e iː j ʏ p ɪ sː a
glampi	k l a m̥ p ɪ
þið	θ ɪ ð
úrvinnsla	u r v ɪ n s t l a
dagur	t aː ɣ ʏ r
safn	s a p n
klókur	kʰ l o uː k ʏ r
gista	c ɪ s t a
flibbi	f l ɪ pː ɪ
kornhæna	kʰ ɔ r t n h a iː n a
grasasni	k r aː s a s t n ɪ
klúðra	kʰ l u ð r a
undirbúa	ʏ n t ɪ r p uː a
þakka	θ a h k a
fræva	f r a iː v a
eystra	e i s t r a
hvíld	xʷ i l t
ada	aː t a
hæra	h a iː r a
þessalía	θ ɛ sː a l iː j a
teinóttur	tʰ e iː n o u h t ʏ r
hljómsveit	l̥ j o u m s v e iː t
þvættingur	θ v a i h t i ŋ k ʏ r
hvelfdur	kʰ v e l v t ʏ r
standa	s t a n t a
alkul	a l kʰ ʏː l
handbolti	h a n t p ɔ l̥ t ɪ
fyrirliði	f ɪː r ɪ r l ɪː ð ɪ
höll	h œ t l
íhvolfur	iː kʰ v ɔ l v ʏ r
neyða	n e iː ð a
sjónauki	s j o uː n ø yː c ɪ
burður	p ʏ r ð ʏ r
mjór	m j o uː r
vígður	v i ɣ ð ʏ r
jafnaldri	j a p n a l t r ɪ
kleina	kʰ l e iː n a
fórinta	f o uː r ɪ n̥ t a
mögur	m œː ɣ ʏ r
deyfa	t e iː v a
hryðjuverkamaður	r̥ ɪ ð j ʏ v ɛ r̥ k a m aː ð ʏ r
grænlenskur	k r a i n l ɛ n s k ʏ r
wathne	v a h t n ɛː
dans	t a n s
frádráttur	f r a u t r a u h t ʏ r
jótland	j o uː t l a n t
tossi	tʰ ɔ sː ɪ
þægindi	θ a iː j ɪ n t ɪ
fríður	f r iː ð ʏ r
stjórnklefi	s t j o u r t n kʰ l ɛː v ɪ
bragur	p r aː ɣ ʏ r
opnunartími	ɔ h p n ʏː n aː r tʰ iː m ɪ
brjóstkassi	p r j o u s t kʰ a sː ɪ
giska	c ɪ s k a
kaffivél	kʰ a fː ɪ v j ɛː l
dröngull	t r ø y ŋ k ʏ t l
margur	m a r k ʏ r
sólarljós	s o uː l a r l j o uː s
laski	l a s c ɪ
hnappur	n̥ a h p ʏ r
gljá	k l j a uː
hroki	r̥ ɔː c ɪ
tröllatré	tʰ r œ t l a tʰ r j ɛː
fyrirsæta	f ɪː r ɪ r s a iː t a
þreifa	θ r e iː v a
móasef	m o uː a s ɛː v
hjól	ç o uː l
bylta	p ɪ l̥ t a
blóðnasir	p l o u ð n aː s ɪ r
annáll	a nː a u t l
sendill	s ɛ n t ɪ t l
orrusta	oː r ʏ s t a
laun	l ø yː n
tvinni	t v ɪ nː ɪ
mykja	m ɪː c a
reisa	r e iː s a
afríkanskur	aː f r iː kʰ a n s k ʏ r
kringja	kʰ r i ɲ c a
bæheimskur	p a iː h e i m s k ʏ r
veðja	v ɛ ð j a
hörður	h œ r ð ʏ r
kjör	cʰ œː r
rólegur	r o uː l ɛː ɣ ʏ r
kvöld	kʰ v œ l t
briskirtill	p r ɪː s cʰ ɪ r̥ t ɪ t l
kál	kʰ a uː l
hveitiklíð	xʷ e iː t ɪ kʰ l iː ð
ógna	o u k n a
þumalputtaregla	θ ʏː m a l pʰ ʏ h t a r ɛ k l a
aðalskrifstofa	aː ð a l s k r i f s t ɔː v a
landakort	l a n t a kʰ ɔ r̥ t
bera	p ɛː r a
fullkomlega	f ʏ t l̥ kʰ ɔ m l ɛː ɣ a
rekald	r ɛː k a l t
ógeðslegur	o uː c ɛ ð s l ɛː ɣ ʏ r
krosskónguló	kʰ r ɔ sː k o u ŋ k ʏ l o uː
tötrar	tʰ œː t r a r
hilla	h ɪ t l a
bóknám	p o uː k n a uː m
þörungur	θ œː r u ŋ k ʏ r
gort	k ɔ r̥ t
bókaskápur	p o uː k a s k a uː p ʏ r
innganga	ɪ nː k a u ŋ k a
hryggð	r̥ ɪ ɣ ð
handklæði	h a n t kʰ l a iː ð ɪ
eyrnapinni	e i r t n a pʰ ɪ nː ɪ
píning	pʰ iː n i ŋ k
mynd	m ɪ n t
reyfi	r e iː v ɪ
orðskviður	ɔ r ð s kʰ v ɪː ð ʏ r
miga	m ɪː ɣ a
uppdatera	ʏ h p t a tʰ ɛː r a
hjólastóll	ç o uː l a s t o u t l
vilhjálmía	v ɪ l ç a u l m iː j a
broddkrækill	p r ɔ tː kʰ r a iː c ɪ t l
visna	v ɪ s t n a
dótturdóttir	t o u h t ʏ r t o u h t ɪ r
sardinía	s a r t ɪ n iː j a
geirfríður	c e i r̥ f r iː ð ʏ r
gamansemi	k aː m a n s ɛː m ɪ
rós	r o uː s
grænn	k r a i t n
rifs	r ɪ f s
aðskilnaðarstefna	a ð s c ɪ l n aː ð a r s t ɛ p n a
gegnvirkur	c ɛ k n v ɪ r̥ k ʏ r
mjöður	m j œː ð ʏ r
klára	kʰ l a uː r a
rándýr	r a u n t iː r
ala	aː l a
rúbín	r uː p iː n
stórfenglegur	s t o u r̥ f e i ŋ k l ɛː ɣ ʏ r
ingólfur	i ŋ k o u l v ʏ r
geimskip	c e i m s c ɪː p
hómófóbía	h o uː m o uː f o uː p iː j a
bátur	p a uː t ʏ r
miðmyndarsögn	m ɪ ð m ɪ n t a r s œ k n
kæliskápur	cʰ a iː l ɪ s k aː p ʏ r
streita	s t r e iː t a
kærulaus	cʰ a iː r ʏ l ø yː s
sjónskertur	s j o u n s c ɛ r̥ t ʏ r
fataskápur	f aː t a s k a uː p ʏ r
handtaka	h a n t tʰ aː k a
festing	f ɛ s t i ŋ k
maltur	m a l̥ t ʏ r
málfræði	m a u l f r aː i ð ɪ
jensína	j ɛ n s iː n a
jakobína	j aː kʰ ɔː p iː n a
sökkva	s œ h k v a
vanalega	v aː n a l ɛː ɣ a
bylgjufall	p ɪ l c ʏ f a t l
hreinskilinn	r̥ e i n s c ɪː l ɪ nː
hverfa	kʰ v ɛ r v a
hlé	l̥ j ɛː
borð	p ɔ r ð
sæfífill	s a iː f iː v ɪ t l
skammkrækill	s k a mː kʰ r a iː c ɪ t l
skelfing	s c ɛ l v i ŋ k
mark	m a r̥ k
glæpamaður	k l a iː p a m aː ð ʏ r
teista	tʰ e i s t a
kyngja	cʰ i ɲ c a
ugga	ʏ kː a
hula	h ʏː l a
kænska	cʰ a i n s k a
bryðja	p r ɪ ð j a
núpur	n uː p ʏ r
sjóntaug	s j o u n tʰ ø yː ɣ
ráp	r a uː p
reyður	r e iː ð ʏ r
skór	s k o uː r
innkaup	ɪ nː kʰ ø yː p
áburður	a uː p ʏ r ð ʏ r
leikhús	l e iː k h uː s
flugvél	f l ʏ ɣ v j ɛː l
viskí	v ɪ s c iː
eyðsla	e i ð s t l a
kynslóð	cʰ ɪ n s t l o uː ð
dagblað	t a ɣ p l aː ð
kolvetni	kʰ ɔ l v ɛ h t n ɪ
kofa	kʰ ɔː v a
hrísla	r̥ i s t l a
eplamús	ɛ h p l a m uː s
ábyrgð	a uː p ɪ r ɣ ð
fjöllaufungur	f j œ l l ø yː v u ŋ k ʏ r
reisn	r e i s t n
fjarki	f j a r̥ c ɪ
hraðall	r̥ aː ð a t l
goðafræði	k ɔː ð a f r a iː ð ɪ
raup	r ø yː p
sekt	s ɛ x t
köggull	kʰ œ kː ʏ t l
lóð	l o uː ð
skurðstofa	s k ʏ r ð s t ɔː v a
snúðugur	s t n uː ð ʏː ʏ r
þannig	θ a nː ɪ ɣ
hálfleiðari	h a u l v l e iː ð a r ɪ
fuglahræða	f ʏ k l a r̥ a iː ð a
þumbaralegur	θ ʏ m p a r a l ɛː ɣ ʏ r
kaupandi	kʰ ø yː p a n t ɪ
sólmyrkvi	s o u l m ɪ r̥ k v ɪ
sót	s o uː t
morgunverður	m ɔ r k ʏ n v ɛ r ð ʏ r
kaþólskur	k aː θ o u l s k ʏ r
akrein	aː k r e iː n
aðgerðaáætlun	a ð c ɛ r ð aː u a i t l ʏ n
mínus	m iː n ʏ s
þvag	θ v aː ɣ
baldur	p a l t ʏ r
silungur	s ɪː l u ŋ k ʏ r
marr	m a rː
amaba	aː m aː p a
sýrland	s i r l a n t
dílaburkni	t iː l a p ʏ r̥ k n ɪ
tjákn	tʰ j a u h k n
efnahvarf	ɛ p n a kʰ v a r v
hlaða	l̥ aː ð a
haust	h ø y s t
grikki	k r ɪ h c ɪ
svindlari	s v ɪ n t l aː r ɪ
dvergsóley	t v ɛ r k s o uː l e iː
gas	k aː s
dreymandi	t r e iː m a n t ɪ
armbandsúr	a r m p a n t s uː r
fónem	f o uː n ɛː m
forskeyti	f ɔ r̥ s c e iː t ɪ
dreifilykill	t r e iː v ɪ l ɪː c ɪ t l
ýta	iː t a
fingurbjargarblóm	f i ŋ k ʏ r p j a r k a r p l o uː m
gestgjafi	c ɛ s t c aː v ɪ
bábilja	p a uː p ɪ l j a
tabú	tʰ aː p uː
péttneska	pʰ j ɛ h t n ɛ s k a
galílea	k aː l iː l ɛː a
fiskifræði	f ɪ s c ɪ f r a iː ð ɪ
gervigígur	c ɛ r v ɪ c iː ɣ ʏ r
kytra	cʰ ɪː t r a
liðhlaupi	l ɪ ð l̥ ø yː p ɪ
tryggvi	tʰ r ɪ k v ɪ
skali	s k aː l ɪ
keisari	cʰ e iː s aː r ɪ
brottför	p r ɔ h t f œː r
aðdáun	a ð t a uː ʏ n
heiði	h e iː ð ɪ
finnska	f ɪ n s k a
krumla	kʰ r ʏ m l a
afskrá	a f s k r a uː
munstur	m ʏ n s t ʏ r
gé	c ɛː
geimur	c e iː m ʏ r
kúfur	kʰ uː v ʏ r
hálíngresi	h a uː l i n k r ɛː s ɪ
hjaltína	ç a l̥ t iː n a
einbirni	e i n p ɪ r t n ɪ
helsingjaeyri	h ɛ l s ɪ ɲ c a e iː r ɪ
tígull	tʰ iː ɣ ʏ t l
sortulyng	s ɔ r̥ t ʏ l i ŋ k
eldhús	ɛ l t h uː s
búa	p uː a
hárlýja	h a u r l iː j a
rússneskur	r u sː t n ɛ s k ʏ r
þak	θ aː k
ísis	iː s ɪ s
veiklun	v e i h k l ʏ n
flón	f l o uː n
spítali	s p iː tʰ aː l ɪ
járnbrautarstöð	j a u r t n p r ø yː t a r s t œː ð
hyggja	h ɪ cː a
undirlendi	ʏ n t ɪ r l ɛ n t ɪ
ykkar	ɪ h k ɐ r
guma	k ʏː m a
kvarki	kʰ v a r̥ c ɪ
áflog	a uː f l ɔː ɣ
dyr	t ɪː r
ljónslappi	l j o u n s t l a h p ɪ
rupl	r ʏ h p l
heift	h e i f t
hermikráka	h ɛ r m ɪ kʰ r a uː k a
nóg	n o uː
járnöld	j a u r t n œ l t
rölt	r œ l̥ t
veldissproti	v ɛ l t ɪ s s p r ɔː t ɪ
blævængur	p l a iː v a i ŋ k ʏ r
unnar	ʏ nː aː r
flaski	f l a s c ɪ
líffræðingur	l i f f r a iː ð i ŋ k ʏ r
taka	tʰ aː k a
æska	a i s k a
erja	ɛ r j a
gjaldmiðill	c a l t m ɪː ð ɪ t l
seiði	s e iː ð ɪ
þjáður	θ j a uː ð ʏ r
tin	tʰ ɪː n
hnetubrjótur	n̥ ɛː t ʏ p r j o uː t ʏ r
mótun	m o uː t ʏ n
brot	p r ɔː t
borðtennis	p ɔ r ð tʰ ɛ nː ɪ s
rugl	r ʏ k l
malasía	m aː l a s iː j a
þor	θ ɔː r
bræði	p r a iː ð ɪ
prjónn	pʰ r j o u t n
legnám	l ɛ ɣ n a uː m
afgreiða	a v k r e iː ð a
aðsjáll	a ð s j a u t l
mosasteinbrjótur	m ɔː s a s t e i n p r j o uː t ʏ r
maríubjalla	m aː r iː j ʏ p j a t l a
byrði	p ɪ r ð ɪ
samþykkja	s a m θ ɪ h c a
dúskur	t u s k ʏ r
flónska	f l o u n s k a
bíða	p iː ð a
djass	t j a sː
ræma	r a iː m a
ökutæki	œː k ʏ tʰ a iː c ɪ
veldi	v ɛ l t ɪ
brak	p r aː k
lumma	l ʏ mː a
hveitikím	kʰ v e iː t ɪ kʰ iː m
lífsmark	l i f s m a r̥ k
þema	θ ɛː m a
þras	θ r aː s
dráp	t r a uː p
skíta	s c iː t a
háðung	h a uː ð u ŋ k
einfaldlega	e i n f a l t l ɛː ɣ a
stjórnmálamaður	s t j o u r t n m a uː l a m aː ð ʏ r
tylft	t ɪ l̥ f t
hind	h ɪ n t
framsöguháttur	f r a m s œː ɣ ʏ h a u h t ʏ r
orf	ɔ r v
þórður	θ o u r ð ʏ r
drjóli	t r j o uː l ɪ
samviskusamur	s a m v ɪ s k ʏ s aː m ʏ r
tröllavíðir	tʰ r œ t l a v iː ð ɪ r
grána	k r a uː n a
elja	ɛ l j a
botnfall	p ɔ h t n f a t l
svefnherbergi	s v ɛ p n h ɛ r p ɛ r c ɪ
áætlun	a uː a i h t l ʏ n
kokka	kʰ ɔ h k a
lýsa	l iː s a
snös	s n œː s
pé	pʰ j ɛː
meinbugur	m e i n p ʏː ɣ ʏ r
prótín	pʰ r o uː t iː n
þrjóskur	θ r j o u s k ʏ r
króati	kʰ r o uː aː t ɪ
öðlast	œ ð l a s t
prúðmennska	pʰ r u ð m ɛ n s k a
úð	uː ð
yfirgefa	ɪː v ɪ r c ɛː v a
rauf	r ø yː v
valtýr	v a l tʰ iː r
nörd	n œ r t
tiltaka	tʰ ɪː l tʰ aː k a
linka	l i ŋ̊ k a
ingi	i ɲ c ɪ
mön	m œː n
flasa	f l aː s a
húsbóndi	h u s p o u n t ɪ
greiða	k r e iː ð a
sökk	s œ h k
samhengi	s a m h e i ɲ c ɪ
draumlaus	t r ø y m l ø yː s
formáli	f ɔ r m a uː l ɪ
klífa	kʰ l iː v a
arndís	a r t n t iː s
blæðing	p l a iː ð i ŋ k
fótsnyrting	f o uː t s n ɪ r̥ t i ŋ k
réna	r j ɛː n a
systkin	s ɪ s t k ɪː n
svartburkni	s v a r̥ t p ʏ r̥ k n ɪ
grýlukerti	k r iː l ʏ cʰ ɛ r̥ t ɪ
framferði	f r a m f ɛ r ð ɪ
hættulegur	h a i h t ʏ l ɛː ɣ ʏ r
öskur	œ s k ʏ r
stilla	s t ɪ t l a
línuleiki	l iː n ʏ l e iː c ɪ
lyng	l i ŋ k
err	ɛ rː
rækja	r a iː c a
pysja	pʰ ɪː s j a
fyðill	f ɪː ð ɪ t l
gerandi	c ɛː r a n t ɪ
mári	m a uː r ɪ
bilbugur	p ɪ l p ʏː ɣ ʏ r
iðja	ɪ ð j a
börn	p œ r t n
hortugur	h ɔ r̥ t ʏː ɣ ʏ r
kveikjari	kʰ v e iː c a r ɪ
dólgur	t o u l k ʏ r
grey	k r e iː
skafa	s k aː v a
tárvotur	tʰ a u r v ɔː t ʏ r
hálfnótuþögn	h a u l v n o uː t ʏ θ œ k n
rakhnífur	r aː k n̥ iː v ʏ r
konur	kʰ ɔː n ʏ r
ósló	o uː s t l o uː
korpönd	kʰ ɔ r̥ p œ n t
dreitill	t r e iː t ɪ t l
þorvaldína	θ ɔ r v a l t iː n a
glas	k l aː s
zeta	s ɛː t a
eldfimur	ɛ l t f ɪː m ʏ r
móberg	m o uː p ɛ r k
lénharður	l j ɛː n h a r ð ʏ r
klæðnaður	kʰ l a i ð n aː ð ʏ r
samkynhneigð	s a m cʰ ɪ n n̥ e i ɣ ð
þvegill	θ v e iː j ɪ t l
georgína	c ɛː ɔ r c iː n a
gauti	k ø yː t ɪ
sólblóm	s o u l p l o uː m
skinna	s k ɪ nː a
héri	ç ɛː r ɪ
trójuhestur	tʰ r o uː j ʏ h ɛ s t ʏ r
ekkjumaður	ɛ h c ʏ m aː ð ʏ r
óásjálegur	o uː a uː s j a uː l ɛː ɣ ʏ r
sekur	s ɛː k ʏ r
strita	s t r ɪː t a
hljóðkerfisfræði	l̥ j o uː ð cʰ ɛ r v ɪ s f r a iː ð ɪ
hes	h ɛː s
bauð	p ø iː ð
jólaköttur	j o uː l a kʰ œ h t ʏ r
hrímtittlingur	r̥ i m tʰ ɪ h t l i ŋ k ʏ r
skapvondur	s k aː p v ɔ n t ʏ r
breidd	p r e i tː
hæla	h a iː l a
stór	s t o uː r
dollari	t ɔ lː a r ɪ
laufblað	l ø y v p l aː ð
megna	m ɛ k n a
handknattleiksþjálfari	h a n t kʰ n a h t l e i k s θ j a u l v a r ɪ
krúna	kʰ r u n a
gaman	k aː m aː n
freri	f r ɛː r ɪ
þyngdarsvið	θ i ŋ t a r s v ɪː ð
flotaforingi	f l ɔː t a f ɔː r i ɲ c ɪ
daðla	t a ð l a
slésvík	s t l j ɛː s v iː k
koma	kʰ ɔː m a
þanki	θ a u ɲ̊ c ɪ
sólbað	s o u l p aː ð
anemóna	aː n ɛ m o uː n a
rauðvingull	r ø y ð v i ŋ k ʏ t l
fés	f j ɛː s
landsvala	l a n t s v aː l a
brátt	p r a u h t
belgi	p ɛ l c ɪ
blóðappelsína	p l o uː ð a h pʰ ɛ l s i n a
móheiður	m o uː h e iː ð ʏ r
kalsi	kʰ a l s ɪ
ýja	iː j a
sandfok	s a n t f ɔː k
hjúkrunarkona	ç uː k r ʏ n a r kʰ ɔː n a
hlessa	l̥ ɛ sː a
ostabakki	ɔ s t a p a h c ɪ
kjói	cʰ o uː ɪ
mauraæta	m ø yː r a a iː t a
morfín	m ɔ r̥ f iː n
kambur	kʰ a m p ʏ r
miðja	m ɪ ð j a
kúbein	kʰ uː p e iː n
flæmskur	f l a i m s k ʏ r
margföldun	m a r k f œ l t ʏ n
bensín	p ɛ n s iː n
févíti	f j ɛː v iː t ɪ
einstefnugata	e i n s t ɛ p n ʏ k aː t a
hólmfríður	h o u l m f r iː ð ʏ r
gálgi	k a u l c ɪ
krossfiskur	kʰ r ɔ sː f ɪ s k ʏ r
branda	p r a n t a
gíll	c i t l
forsjá	f ɔ r̥ s j a uː
fnykur	f n ɪː k ʏ r
sókn	s o ʊ k n̥
georgía	c ɛː ɔ r c iː j a
fordrykkur	f ɔ r t r ɪ h k ʏ r
fjörfiskur	f j œ r f ɪ s k ʏ r
fleki	f l ɛː c ɪ
rok	r ɔː k
rússneska	r u sː n ɛ s k a
bannfæring	p a nː f a iː r i ŋ k
djúpur	t j uː p ʏ r
láð	l a uː ð
broddkúmen	p r ɔ tː kʰ uː m ɛː n
trumba	tʰ r ʏ m p a
granatepli	k r aː n aː t ɛ h p l ɪ
eff	ɛ fː
fríspark	f r iː s p a r̥ k
klaufi	kʰ l ø yː v ɪ
nautgripur	n ø yː t k r ɪː p ʏ r
messa	m ɛ sː a
rappa	r a h p a
bákn	p a u h k n
rimill	r ɪː m ɪ t l
putta	pʰ ʏ h t a
prammi	pʰ r a mː ɪ
lukka	l ʏ h k a
þvarg	θ v a r k
kakó	kʰ aː k o uː
peð	pʰ ɛː ð
minnisgripur	m ɪ nː i s k r ɪː p ʏ r
fjölgyðistrú	f j œ l k ɪː ð ɪ s t r uː
greifi	k r e iː v ɪ
íþróttahús	iː θ r o u h t a h uː s
wiium	v iː j ʏ m
refsa	r ɛ f s a
sepi	s ɛː p ɪ
serótónín	s ɛː r o uː tʰ o uː n iː n
daggarmark	t a kː a r m a r̥ k
aðvörun	a ð v œː r ʏ n
lofðungur	l ɔ v ð u ŋ k ʏ r
tékkneska	tʰ j ɛ h k n ɛ s k a
deildarfall	t e i l t a r f a t l
þungur	θ u ŋ k ʏ r
hik	h ɪː k
garmur	k a r m ʏ r
lesblinda	l ɛː s p l ɪ n t a
dauður	t ø yː ð ʏ r
plana	pʰ l aː n a
lífhimna	l i v h ɪ m n a
atferli	aː t f ɛ r t l ɪ
pensill	pʰ ɛ n s ɪ t l
sigfús	s ɪ x f uː s
nauðgun	n ø y ð k ʏ n
tætari	tʰ a iː t aː r ɪ
heilaþvottur	h e iː l a θ v ɔ h t ʏ r
foss	f ɔ sː
kolla	kʰ ɔ t l a
kjörlendi	cʰ œ r l ɛ n t ɪ
kúga	k uː a
helmingur	h ɛ l m i ŋ k ʏ r
búr	p uː r
lýsingarháttur	l iː s i ŋ k a r h a u h t ʏ r
bani	p aː n ɪ
reglustika	r ɛ k l ʏ s t ɪː k a
festa	f ɛ s t a
augntönn	ø y k n tʰ œ nː
trippi	tʰ r ɪ h p ɪ
opnun	ɔ h p n ʏ n
gauð	k ø yː ð
jöfnun	j œ p n ʏ n
vondur	v ɔ n t ʏ r
undirflokkur	ʏ n t ɪ r̥ f l ɔ h k ʏ r
sænska	s a i n s k a
raddblær	r a tː p l a iː r
engispretta	e i ɲ c ɪ s p r ɛ h t a
tjá	tʰ j a uː
fylki	f ɪ l̥ c ɪ
snörla	s n œ r t l a
svissneskur	s v ɪ sː t n ɛ s k ʏ r
bland	p l a n t
visk	v ɪ s k
flétta	f l j ɛ h t a
næstur	n a i s t ʏ r
karakter	kʰ a r a x t ɛː r
grænland	k r a i n l a n t
lúða	l uː ð a
táldraga	t a u l t r aː ɣ a
maríustakkur	m aː r iː j ʏ s t a h k ʏ r
piparsveinn	pʰ ɪː p a r s v e i t n
lega	l ɛː ɣ a
leppur	l ɛ h p ʏ r
viðtengingarháttur	v ɪ tʰ e i ɲ c i ŋ k a r h a u h t ʏ r
evklíð	ɛ v kʰ l iː ð
hagsbót	h a x s p o uː t
loðinn	l ɔː ð ɪ nː
blys	p l ɪː s
skissa	s c ɪ sː a
fælni	f a i l n ɪ
hnífur	n̥ iː v ʏ r
kös	kʰ œː s
amharíska	aː m h a r i s k a
ríkisdalur	r iː c ɪ s t aː l ʏ r
briem	p r iː m
feðgin	f ɛ ð c ɪː n
grunnur	k r ʏ nː ʏ r
broddmjólk	p r ɔ tː m j o u l̥ k
framkvæmdastjóri	f r a m kʰ v a i m t a s t j o uː r ɪ
slátra	s t l a uː t r a
feldur	f ɛ l t ʏ r
ýra	iː r a
leyfa	l e iː v a
svartur	s v a r̥ t ʏ r
fimmtudagur	f ɪ m̥ː tʰ ʏ t aː ɣ ʏ r
laska	l a s k a
trúður	tʰ r uː ð ʏ r
fúx	f u x s
páfugl	pʰ a uː f ʏ k l
þvottabjörn	θ v ɔ h t a p j œ r t n
eldast	ɛ l t a s t
vildís	v ɪ l t iː s
sigurðsson	s ɪː ɣ ʏ r ð s s ɔː n
grínisti	k r iː n ɪ s t ɪ
guðmunda	k v ʏ ð m ʏ n t a
náæta	n a uː a iː t a
kjósa	cʰ o uː s a
þerna	θ ɛ r t n a
farsími	f a r̥ s iː m ɪ
kelfing	cʰ ɛ l v i ŋ k
sól	s o uː l
lýðræði	l i ð r a iː ð ɪ
svarðmosi	s v a r ð m ɔː s ɪ
eldlilja	ɛ l t l ɪ l j a
kakkalakki	kʰ a h k a l a h c ɪ
einarína	e iː n aː r iː n a
rita	r ɪː t a
dýrahringur	t iː r a r̥ i ŋ k ʏ r
akur	aː kʰ ʏ r
ekkill	ɛ h c ɪ t l
hátterni	h a u h t ɛ r t n ɪ
vindmylla	v ɪ n t m ɪ lː a
myrkur	m ɪ r̥ k ʏ r
hlýri	l̥ iː r ɪ
erfingi	ɛ r v i ɲ c ɪ
kunna	kʰ ʏ nː a
fall	f a t l
mannvit	m a nː v ɪː t
veif	v e iː v
heimavinna	h e iː m a v ɪ nː a
lífrænn	l i v r a i t n
hörpudiskur	h œ r̥ p ʏ t ɪ s k ʏ r
sjáumst	s j aː u ʏ m̥ s t
íhald	iː h a l t
sparta	s p a r̥ t a
laginn	l a iː j ɪ nː
stefna	s t ɛ p n a
fagottleikari	f aː k ɔ h t l e iː k aː r ɪ
kempa	cʰ ɛ m̥ p a
handaband	h a n t a p a n t
tvinna	t v ɪ nː a
skeljamura	s c ɛ l j a m ʏː r a
frymi	f r ɪː m ɪ
gersemi	c ɛ r s ɛː m ɪ
methafi	m ɛː t h aː v ɪ
smurður	s m ʏ r ð ʏ r
regnhlíf	r ɛ k n l̥ iː v
þögn	θ œ k n
öryggisgler	œː r ɪ cː ɪ s k l ɛː r
vana	v aː n a
ritröð	r ɪː t r œː ð
gaur	k ø yː r
stilling	s t ɪ t l i ŋ k
andrésína	a n t r j ɛː s iː n a
dekkja	t ɛ h c a
ekkert	ɛ h c ɛ r̥ t
skvísa	s k v iː s a
spakmæli	s p aː k m a iː l ɪ
smæra	s m a iː r a
hrogn	r̥ ɔ k n
bull	p ʏ t l
kleif	kʰ l e iː v
afbrýði	a v p r iː ð ɪ
söl	s œː l
kær	cʰ a iː r
kennslubók	cʰ ɛ n s t l ʏ p o uː k
húð	h uː ð
svínakjöt	s v iː n a cʰ œː t
her	h ɛː r
æruprís	a iː r ʏ pʰ r iː s
skúlína	s k uː l iː n a
uppskurður	ʏ h p s k ʏ r ð ʏ r
yngja	i ɲ c a
gráblika	k r a u p l ɪː k a
andstæðingur	a n t s t a iː ð i ŋ k ʏ r
kynda	cʰ ɪ n t a
blundur	p l ʏ n t ʏ r
gufa	k ʏː v a
einteymingur	e i n tʰ e iː m i ŋ k ʏ r
fóður	f o uː ð ʏ r
ostsneið	ɔ s t s t n e iː ð
hafliðína	h a v l ɪː ð iː n a
meiðsl	m e i ð s t l
tvistur	tʰ v ɪ s t ʏ r
frakkar	f r a h k aː r
þórdís	θ o u r t iː s
mas	m aː s
eir	e iː r
legging	l ɛ cː i ŋ k
mislingar	m ɪ s t l i ŋ k a r
móðursystir	m o uː ð ʏ r s ɪ s t ɪ r
hjóla	ç o uː l a
tyrðill	tʰ ɪ r ð ɪ t l
kið	cʰ ɪː ð
staur	s t ø yː r
þyrnir	θ ɪ r t n ɪ r
plebbi	pʰ l ɛ pː ɪ
eðlisfræðingur	ɛ ð l ɪ s f r a iː ð i ŋ k ʏ r
lýsingarorð	l iː s i ŋ k aː r ɔ r ð
linna	l ɪ nː a
slarkari	s t l a r̥ k a r ɪ
urra	ʏ rː a
rísa	r iː s a
dragt	t r a x t
jörundína	j œː r ʏ n t iː n a
búnaður	p uː n aː ð ʏ r
völlur	v œ t l ʏ r
sekta	s ɛ x t a
lesbía	l ɛ s p iː j a
táningur	tʰ a uː n i ŋ k ʏ r
nota	n ɔː t a
félagi	f j ɛː l aː j ɪ
buxnaklauf	p ʏ x s n a k l ø yː v
sál	s a uː l
hafa	h aː v a
hiksti	h ɪ x s t ɪ
elfur	ɛ l v ʏ r
bjarnheiður	p j a r t n h e iː ð ʏ r
hunangsfluga	h ʏː n a u ŋ k s f l ʏː ɣ a
fró	f r o uː
pétursborg	pʰ j ɛː t ʏ r̥ s p ɔ r k
trefill	tʰ r ɛː v ɪ t l
þverra	θ v ɛ rː a
blálanga	p l a uː l a u ŋ k a
hlust	l̥ ʏ s t
trompet	tʰ r ɔ m̥ p ɛː t
smána	s m a uː n a
kolkrabbi	kʰ ɔ l kʰ r a pː ɪ
schram	s k r aː m
kúnni	kʰ u nː ɪ
schiöth	s c œ h t
ryk	r ɪː k
tíundi	tʰ iː j ʏ n t ɪ
mývatn	m iː v aʰ t n
nátthrafn	n a u h t r̥ a p n
klefi	kʰ l ɛː v ɪ
þrímynd	θ r iː m ɪ n t
bjargmundur	p j a r k m ʏ n t ʏ r
stígur	s t iː ɣ ʏ r
skógartoppur	s k o uː a r tʰ ɔ h p ʏ r
útskolun	uː t s k ɔː l ʏ n
hjal	ç aː l
hnot	n̥ ɔː t
vögguvísa	v œ kː ʏ v iː s a
lensutungljurt	l ɛ n s ʏ tʰ u ŋ l j ʏ r̥ t
umskera	ʏ m s c ɛː r a
kúrdíska	kʰ u r t i s k a
rafall	r aː v a t l
nauð	n ø yː ð
hjallur	ç a t l ʏ r
flokkur	f l ɔ h k ʏ r
forinta	f ɔː r ɪ n̥ t a
meðleikur	m ɛ ð l e iː k ʏ r
fjas	f j aː s
kúl	kʰ uː l
dómstóll	t o u m s t o u t l
rjóður	r j o uː ð ʏ r
líma	l iː m a
sleggja	s t l ɛ cː a
beddi	p ɛ tː ɪ
grunnendurlífgun	k r ʏ nː ɛ n t ʏ r l i v k ʏ n
gluggatjald	k l ʏ kː a tʰ j a l t
rífast	r iː v a s t
sakaskrá	s aː k a s k r a uː
rás	r a uː s
einfaldur	e i n f a l t ʏ r
gylla	c ɪ t l a
keipa	cʰ e iː p a
þrettán	θ r ɛ h t a uː n
fóstur	f o u s t ʏ r
oföndun	ɔː v œ n t ʏ n
eldjárn	ɛ l t j a u r t n
smiður	s m ɪː ð ʏ r
hraða	r̥ aː ð a
gulvíðir	k ʏ l v iː ð ɪ r
lesminni	l ɛː s m ɪ nː ɪ
áræða	a uː r a iː ð a
blístra	p l i s t r a
hreysa	r̥ e iː s a
páfagaukur	pʰ a uː v a k ø yː k ʏ r
dorma	t ɔ r m a
njósnari	n j o u s t n aː r ɪ
afleiðing	a v l e iː ð i ŋ k
aðalatriði	aː ð a l aː t r ɪː ð ɪ
þunglamalegur	θ u ŋ k l aː m a l ɛː ɣ ʏ r
vilji	v ɪ l j ɪ
víðir	v iː ð ɪ r
gremja	k r ɛ m j a
spjaldtölva	s p j a l t tʰ œ l v a
adda	a tː a
sveipa	s v e iː p a
kvörn	kʰ v œ r t n
kóf	kʰ o uː v
stoppa	s t ɔ h p a
kunnur	kʰ ʏ nː ʏ r
rólega	r o uː l ɛː ɣ a
undirbúningur	ʏ n t ɪ r p uː n i ŋ k ʏ r
togi	tʰ ɔː j ɪ
dreyrasýki	t r e iː r a s iː c ɪ
gári	k a uː r ɪ
hugmyndafræði	h ʏ ɣ m ɪ n t a f r a iː ð ɪ
hnignun	n̥ ɪ k n ʏ n
rými	r iː m ɪ
ég	j ɛ ɣ
ker	cʰ ɛː r
svandís	s v a n t iː s
hylla	h ɪ t l a
garðrækt	k a r ð r a i x t
melóna	m ɛː l o uː n a
skíri	s c iː r ɪ
slóra	s t l o uː r a
bruggari	p r ʏ kː aː r ɪ
frumstig	f r ʏ m s t ɪː ɣ
skál	s k a uː l
eyða	e iː ð a
penni	pʰ ɛ nː ɪ
berja	p ɛ r j a
lagga	l a kː a
davíð	t aː v iː ð
hvítlauksgeiri	kʰ v iː t l ø y k s c e iː r ɪ
hyrnd	h ɪ r n t
skara	s k aː r a
ráðabrugg	r a uː ð a p r ʏ kː
undanfari	ʏ n t a n f aː r ɪ
gamburmosi	k a m p ʏ r m ɔː s ɪ
enn	ɛ nː
hnaus	n̥ ø yː s
óra	o uː r a
rán	r a uː n
þorvaldur	θ ɔ r v a l t ʏ r
ungur	u ŋ k ʏ r
regnbogi	r ɛ k n p ɔː j ɪ
heimferð	h e i m f ɛ r ð
sjaldgæfur	s j a l t c a iː v ʏ r
sonardóttir	s ɔː n a r t o u h t ɪ r
týna	tʰ iː n a
kuldi	kʰ ʏ l t ɪ
velta	v ɛ l̥ t a
gómsætur	k o u m s a iː t ʏ r
guðlaugur	k v ʏ ð l ø yː ɣ ʏ r
spjalla	s p j a t l a
óhreinindi	o uː r̥ e iː n ɪ n t ɪ
heimta	h e i m̥ t a
hunang	h ʏː n a u ŋ k
eðla	ɛ ð l a
hrár	r̥ a uː r
breiddargráða	p r e i tː a r k r a uː ð a
renín	r ɛː n iː n
byrgja	p ɪ r c a
svín	s v iː n
andúð	a n t uː ð
ómur	o uː m ʏ r
sandali	s a n t a l ɪ
passa	pʰ a sː a
svil	s v ɪː l
skark	s k a r̥ k
mjólkursýra	m j o u l̥ k ʏ r s iː r a
teigur	tʰ e iː ɣ ʏ r
stína	s t iː n a
smergill	s m ɛ r c ɪ t l
agi	aː j ɪ
mannvirki	m a nː v ɪ r̥ c ɪ
æti	a iː t ɪ
grænmetisæta	k r a i n m ɛː t ɪ s a iː t a
hvá	xʷ a uː
smella	s m ɛ t l a
líffræðilegur	l i f f r a iː ð ɪ l ɛː ɣ ʏ r
framleiðandi	f r a m l e iː ð a n t ɪ
púa	pʰ uː a
orsaka	ɔ r̥ s aː k a
lúi	l uː ɪ
fara	f aː r a
lögreglustöð	l œ ɣ r ɛ k l ʏ s t œː ð
merkja	m ɛ r̥ c a
skjótur	s c o uː t ʏ r
björt	p j œ r̥ t
auglýsa	ø y ɣ l iː s a
tág	tʰ a uː
megra	m ɛ ɣ r a
tilboð	tʰ ɪ l p ɔː ð
náhvalur	n a uː kʰ v aː l ʏ r
spik	s p ɪː k
jeppi	j ɛ h p ɪ
ringulreið	r i ŋ k ʏ l r e iː ð
kæti	cʰ a iː t ɪ
brandugla	p r a n t ʏ k l a
barín	p aː r iː n
klemens	kʰ l ɛː m ɛ n s
finnur	f ɪ nː ʏ r
segulljós	s ɛː ɣ ʏ l l j o uː s
dýr	t iː r
meistari	m e i s t aː r ɪ
sáðfruma	s a u ð f r ʏː m a
skyssa	s c ɪ sː a
bygg	p ɪ kː
skjór	s c o uː r
ról	r o uː l
rámur	r a uː m ʏ r
frumskógur	f r ʏ m s k o uː ʏ r
stórólfur	s t o uː r o u l v ʏ r
þumalputti	θ ʏː m a l pʰ ʏ h t ɪ
slegill	s t l e iː j ɪ t l
skíða	s c iː ð a
kjálki	cʰ a u l̥ c ɪ
tipla	tʰ ɪ h p l a
útför	uː t f œː r
núbbi	n u pː ɪ
heimsvísa	h e i m s v iː s a
höfuð	h œː v ʏ θ
miðaftann	m ɪː ð a f t a nː
sprauta	s p r ø yː t a
smjúga	s m j uː a
frímúrari	f r iː m uː r aː r ɪ
eignarfornafn	e i k n a r f ɔ r n a p n
mannorð	m a nː ɔ r ð
millipils	m ɪ t l ɪ pʰ ɪ l s
pipar	pʰ ɪː p a r
ólöglega	o uː l œ ɣ l ɛː ɣ a
maís	m aː iː s
jú	j uː
dúkur	t uː k ʏ r
spámaður	s p a uː m aː ð ʏ r
steytill	s t e iː t ɪ t l
áræðinn	a uː r a iː ð ɪ nː
fæla	f a iː l a
slasa	s t l aː s a
flæmingi	f l a iː m i ɲ c ɪ
áreiðanleiki	a uː r e iː ð a n l e iː c ɪ
ræpa	r a iː p a
kjökra	cʰ œː k r a
guða	k v ʏː ð a
brauðhnífur	p r ø y ð n̥ iː v ʏ r
brúsi	p r u s ɪ
nóta	n o uː t a
gimsteinn	c ɪ m s t e i t n
magndís	m a k n t iː s
blogg	p l ɔ kː
barrspæta	p a rː s p a iː t a
járnbraut	j a u r t n p r ø yː t
þola	θ ɔː l a
tófugras	tʰ o uː v ʏ k r aː s
hemja	h ɛ m j a
venda	v ɛ n t a
mandla	m a n t l a
mötunautur	m œː t ʏ n ø yː t ʏ r
þröng	θ r ø y ŋ k
indland	ɪ n t l a n t
þrá	θ r a uː
gráðubogi	k r a uː ð ʏ p ɔː j ɪ
skúli	s k uː l ɪ
öfund	œː v ʏ n t
sparð	s p a r ð
seytla	s e i h t l a
geitungur	k e iː t u ŋ k ʏ r
korr	kʰ ɔ rː
elíasína	ɛː l i j aː s iː n a
hallmundur	h a t l m ʏ n t ʏ r
aukastafur	ø yː k a s t aː v ʏ r
klápur	kʰ l a uː p ʏ r
jarðsvín	j a r ð s v iː n
tengdadóttir	tʰ e i ŋ t a t o u h t ɪ r
dáinn	t a uː ɪ nː
mýkt	m i x t
ös	œː s
hrafnkell	r̥ a p n cʰ ɛ t l
manna	m a nː a
mikilmenni	m ɪː c ɪ l m ɛ nː ɪ
jóhanna	j o uː h a nː a
jörgensen	j œ r k ɛ n s ɛː nː
tattú	tʰ a h t uː
hár	h a uː r
kvilli	kʰ v ɪ t l ɪ
spöng	s p ø y ŋ k
andlag	a n t l aː ɣ
bróðursonur	p r o uː ð ʏ r̥ s ɔː n ʏ r
syrja	s ɪ r j a
megin	m e iː j ɪ n
dúkönd	t uː k œ n t
amba	a m p a
hátign	h a uː tʰ ɪ k n
hermaður	h ɛ r m aː ð ʏ r
lettneska	l ɛ h t n ɛ s k a
klútur	kʰ l uː t ʏ r
hljóðbók	l̥ o u ð p o uː k
krækill	kʰ r a iː c ɪ t l
risaeðla	r ɪː s a ɛ ð l a
laut	l ø yː t
úrferðarfall	u r̥ f ɛ r ð a r f a t l
kjólföt	kʰ j o u l f œː t
dey	t e iː
smit	s m ɪː t
kaplamjólk	kʰ a h p l a m j o u l̥ k
lækjasef	l a iː c a s ɛː v
manneskja	m a nː ɛ s c a
apamaður	aː p a m aː ð ʏ r
byssuhlaup	p ɪ sː ʏ l̥ ø yː p
strik	s t r ɪː k
áskrifandi	a uː s k r ɪː v a n t ɪ
fána	f a uː n a
ræna	r a iː n a
loforð	l ɔː v ɔ r ð
sendiherra	s ɛ n t ɪ h ɛ rː a
alúðlegur	aː l u ð l ɛː ɣ ʏ r
hverfill	kʰ v ɛ r v ɪ t l
niðji	n ɪ ð j ɪ
riis	r iː s
hólkur	h o u l̥ k ʏ r
pússa	pʰ u sː a
súld	s u l t
sykurreyr	s ɪː k ʏ r r e iː r
seinn	s e i t n
skaf	s k aː v
ljósakróna	l j o uː s a kʰ r o uː n a
kúla	kʰ uː l a
miðstig	m ɪ ð s t ɪː ɣ
bjarnharður	p j a r t n h a r ð ʏ r
vista	v ɪ s t a
fyrirlitning	f ɪː r ɪ r l ɪ h t n i ŋ k
vegarfi	v ɛː ɣ a r v ɪ
farsæld	f a r̥ s a i l t
jónas	j o uː n aː s
geysa	c e iː s a
mosalyng	m ɔː s a l i ŋ k
núningur	n uː n i ŋ k ʏ r
blettatígur	p l ɛ h t a tʰ iː ɣ ʏ r
glötun	k l œː t ʏ n
klinka	kʰ l i ŋ̊ k a
blásýra	p l a uː s iː r a
hlæja	l̥ a iː j a
óaðlaðandi	o uː a ð l aː ð a n t ɪ
veðurtungl	v ɛː ð ʏ r tʰ u ŋ l
hannesína	h a nː ɛː s iː n a
smyrill	s m ɪː r ɪ t l
líftími	l iː v tʰ iː m ɪ
sýkja	s iː c a
dökkbrúnn	t œ h k p r u t n
sandbylur	s a n t p ɪː l ʏ r
trekkja	tʰ r ɛ h c a
málbein	m a u l p e iː n
ofan	ɔː v a n
slagsmál	s t l a x s m a uː l
auglýsing	ø y ɣ l iː s i ŋ k
nútími	n uː tʰ iː m ɪ
leiður	l e iː ð ʏ r
síður	s iː ð ʏ r
lóða	l o uː ð a
hrekkja	r̥ ɛ h c a
guðmundína	k v ʏ ð m ʏ n t iː n a
geðklofi	c ɛ ð kʰ l ɔː v ɪ
klængur	kʰ l a i ŋ k ʏ r
fullur	f ʏ t ɬ ʏ r
strigaskór	s t r ɪː ɣ a s k o uː r
ölmusa	œ l m ʏː s a
örgjörvi	œ r c œ r v ɪ
geirvarta	c e i r v a r̥ t a
mana	m aː n a
kála	kʰ a uː l a
básúna	p a uː s uː n a
tif	tʰ ɪː v
landamæri	l a n t a m a iː r ɪ
útbreiddur	uː t p r e i tː ʏ r
móður	m o uː ð ʏ r
es	ɛː s
krýning	kʰ r iː n i ŋ k
loðfíll	l ɔ ð f i t l
beyki	p e iː c ɪ
dilkur	t ɪ l̥ k ʏ r
varkárni	v a r̥ kʰ a u r t n ɪ
tjón	tʰ j o uː n
japan	j aː pʰ aː n
sólskin	s o u l s k ɪː n
undrun	ʏ n t r ʏ n
inna	ɪ nː a
niður	n ɪː ð ʏ r
mý	m iː
framburður	f r a m p ʏ r ð ʏ r
rór	r o uː r
kumbaraland	kʰ ʏ m p aː r a l a n t
trésmíði	tʰ r j ɛː s m iː ð ɪ
stökkull	s t œ h k ʏ t l
braut	p r ø yː t
brauðrist	p r ø y ð r ɪ s t
kaka	kʰ aː k a
aldingarður	a l t ɪ n k a r ð ʏ r
bandingi	p a n t i ɲ c ɪ
blettur	p l ɛ h t ʏ r
stíga	s t iː ɣ a
ramba	r a m p a
aðallega	aː ð a l l ɛː ɣ a
gervill	c ɛ r v ɪ t l
varalitur	v aː r a l ɪː t ʏ r
ánamaðkur	a uː n a m a θ k ʏ r
bófi	p o uː v ɪ
eyðimörk	e iː ð ɪ m œ r̥ k
þumbari	θ ʏ m p a r ɪ
glæruvængur	k l a iː r ʏ v a i ŋ k ʏ r
dýrmundur	t i r m ʏ n t ʏ r
ljóðskáld	l j o u ð s k a u l t
skipasmiður	s c ɪː p a s m ɪː ð ʏ r
ró	r o uː
gola	k ɔː l a
gríska	k r i s k a
fjöruarfi	f j œː r ʏ a r v ɪ
guðlast	k v ʏ ð l a s t
sársauki	s a u r̥ s ø yː c ɪ
lítill	l iː t ɪ t l
eilífð	e iː l i v ð
gigt	c ɪ x t
afæta	aː v a iː t a
stífla	s t i p l a
raggeit	r a ɣ c e iː t
býr	p iː r̥
missir	m ɪ sː ɪ r
spánskur	s p a u n s k ʏ r
samheiti	s aː m h e iː t ɪ
lirfa	l ɪ r v a
orka	ɔ r̥ k a
prettvísi	pʰ r ɛ h t v iː s ɪ
flís	f l iː s
móeiður	m o uː e iː ð ʏ r
djók	t j o uː k
skot	s k ɔː t
rissa	r ɪ sː a
bjúgur	p j uː ʏ r
klunnalegur	kʰ l ʏ nː a l ɛː ɣ ʏ r
merkur	m ɛ r̥ k ʏ r
ákefð	a uː c ɛ v ð
slark	s t l a r̥ k
þinur	θ ɪː n ʏ r
veita	v e iː t a
hagur	h aː ɣ ʏ r
slarkfenginn	s t l a r̥ k f e i ŋ k ɪ nː
ofurþungur	ɔː v ʏ r θ u ŋ k ʏ r
hulda	h ʏ l t a
öfl	œ p l
loftþrýstingur	l ɔ f t θ r i s t i ŋ k ʏ r
hald	h a l t
teppi	tʰ ɛ h p ɪ
skóf	s k o uː v
eiturlyf	e iː t ʏ r l ɪː v
föndur	f œ n t ʏ r
alvöruleysi	a l v œː r ʏ l e iː s ɪ
flugbraut	f l ʏ ɣ p r ø yː t
össuría	œ sː ʏ r iː j a
málafærslumaður	m a uː l a f a i r̥ s t l ʏ m aː ð ʏ r
kirjálaland	cʰ ɪ r j a uː l a l a n t
símasamband	s iː m a s a m p a n t
rykkilín	r ɪ h c ɪ l iː n
rafeindasmásjá	r aː v e i n t a s m a uː s j a uː
herdís	h ɛ r t iː s
nasismi	n aː s ɪ s m ɪ
fullkominn	f ʏ t l̥ kʰ ɔː m ɪ nː
mjálma	m j a u l m a
djöfull	t j œː v ʏ t l
melasól	m ɛː l a s o uː l
alvarlega	a l v a r l ɛː ɣ a
girða	c ɪ r ð a
teygja	tʰ e iː j a
kvika	kʰ v ɪː k a
krá	kʰ r a uː
hlaup	l̥ ø yː p
handrit	h a n t r ɪː t
klunni	kʰ l ʏ nː ɪ
týndur	tʰ i n t ʏ r
peðra	pʰ ɛ ð r a
handahóf	h a n t a h o uː v
lofttæmi	l ɔ f t tʰ a iː m ɪ
grið	k r ɪː ð
mála	m a uː l a
skjár	s c a uː r
yfirráð	ɪː v ɪ r r a uː ð
ófreskja	o uː f r ɛ s c a
óma	o uː m a
vasabók	v aː s a p o uː k
næsta	n a i s t a
nitur	n ɪː t ʏ r
flug	f l ʏː ɣ
moldvarpa	m ɔ l t v a r̥ p a
baskamál	p a s k a m a uː l
steypa	s t e iː p a
atvinnumaður	aː t v ɪ nː ʏ m aː ð ʏ r
kyndill	cʰ ɪ n t ɪ t l
vaka	v aː k a
helgi	h ɛ l c ɪ
ísópren	iː s o uː pʰ r ɛː n
fló	f l o uː
ferilskrá	f ɛː r ɪ l s k r a uː
andarungi	a n t a r u ɲ c ɪ
persneska	pʰ ɛ r̥ s n ɛ s k a
kíló	cʰ iː l o uː
peningur	pʰ ɛː n i ŋ k ʏ r
köfnunarefni	kʰ œ p n ʏ n a r ɛ p n ɪ
aðalskáli	aː ð a l s k a uː l ɪ
patína	pʰ aː tʰ iː n a
blekkja	p l ɛ h c a
benedikt	p ɛː n ɛː t ɪ x t
marxískur	m a r̥ k s i s k ʏ r
grand	k r a n t
trésmiðja	tʰ r j ɛː s m ɪ ð j a
mjólkurmatur	m j o u l̥ k ʏ r m aː t ʏ r
drepsótt	t r ɛː p s o u h t
hvítabjörn	xʷ iː t a p j œ r t n
hamra	h a m r a
tilgangsfall	tʰ ɪ l k a u ŋ k s f a t l
meiða	m e iː ð a
svíri	s v iː r ɪ
daldís	t a l t iː s
sáta	s a uː t a
ganga	k a u ŋ k a
box	p ɔ x s
svitna	s v ɪ h t n a
vaða	v aː ð a
gnýja	k n iː j a
aðaltenging	aː ð a l tʰ e i ɲ c i ŋ k
orðhluti	ɔ r ð l̥ ʏː t ɪ
kaup	kʰ ø yː p
lífvera	l i v v ɛː r a
stephensen	s t ɛː f ɛ n s ɛ n
hártoppur	h a u r tʰ ɔ h p ʏ r
vasaljós	v aː s a l j o uː s
fleygur	f l e iː ɣ ʏ r
depra	t ɛː p r a
vaskur	v a s k ʏ r
dýragarður	t iː r a k a r ð ʏ r
fornenska	f ɔ r t n ɛ n s k a
ræða	r a iː ð a
neita	n e iː t a
harma	h a r m a
riffill	r ɪ fː ɪ t l
lemmun	l ɛ mː ʏ n
eyjólfína	e iː j o u l v iː n a
ættingi	a i h t i ɲ c ɪ
áskrift	a uː s k r ɪ f t
skriðdreki	s k r ɪ ð t r ɛː c ɪ
neitunarvald	n e iː t ʏ n a r v a l t
lesa	l ɛː s a
þjá	θ j a uː
barein	p aː r e iː n
clausen	kʰ l a uː s ɛː nː
læknisskoðun	l a i h k n ɪ s s k ɔː ð ʏ n
reykur	r e iː k ʏ r
vegasalt	v ɛː ɣ a s a l̥ t
löggjafarvald	l œ ɣ c aː v a r v a l t
herbergi	h ɛ r p ɛ r c ɪ
kvæna	kʰ v a iː n a
hlátur	l̥ a uː t ʏ r
fægja	f a iː j a
altaristafla	a l̥ t aː r ɪ s tʰ a p l a
rauðleitur	r ø y ð l e iː t ʏ r
haglabyssa	h a k l a p ɪ sː a
geirdís	c e i r t iː s
skána	s k a uː n a
randa	r a n t a
gljávíðir	k l j a uː v iː ð ɪ r
frostpinni	f r ɔ s t pʰ ɪ nː ɪ
sjófugl	s j o uː f ʏ k l
glögg	k l œ kː
kippa	cʰ ɪ h p a
undra	ʏ n t r a
stakur	s t aː k ʏ r
vanöndun	v aː n œ n t ʏ n
ef	ɛː v
geir	k e iː r
nikkel	n ɪ h k ɛ l
runnur	r ʏ nː ʏ r
skinka	s c i ŋ̊ k a
lögreglumaður	l œ ɣ r ɛ k l ʏ m aː ð ʏ r
spilling	s p ɪ t l i ŋ k
óætur	o uː a iː t ʏ r
lögregluþjónn	l œ ɣ r ɛ k l ʏ θ j o u t n
dvali	t v aː l ɪ
hjarn	ç a r t n
buski	p ʏ s c ɪ
hlemmur	l̥ ɛ mː ʏ r
humall	h ʏː m a t l
böggull	p œ kː ʏ t l
álfur	a u l v ʏ r
fjölmiðlasaga	f j œ l m ɪ ð l a s aː ɣ a
fálma	f a u l m a
áminna	a uː m ɪ nː a
vonsvikinn	v ɔ n s v ɪː c ɪ nː
skemmd	s c ɛ m t
silki	s ɪ l̥ c ɪ
úr	uː r
jarðlag	j a r ð l aː ɣ
prenta	pʰ r ɛ n̥ t a
sinnuleysi	s ɪ nː ʏ l e iː s ɪ
burst	p ʏ r̥ s t
saltkjöt	s a l̥ t cʰ œː t
fyrirlestur	f ɪː r ɪ r l ɛ s t ʏ r
gleypa	k l e iː p a
hnupl	n̥ ʏ h p l
komutími	kʰ ɔː m ʏ tʰ iː m ɪ
manni	m a nː ɪ
lúðalegur	l uː ð a l ɛː ɣ ʏ r
rotinn	r ɔː t ɪ nː
spergilkál	s p ɛ r c ɪ l kʰ a uː l
samnefndur	s a m n ɛ m t ʏ r
lukt	l ʏ x t
æla	a iː l a
mór	m o uː r
haga	h aː ɣ a
aftursæti	a f t ʏ r s a iː t ɪ
sofir	s ɔː v ɪ r
hálmur	h a u l m ʏ r
föggur	f œ kː ʏ r
feill	f e i t l
nes	n ɛː s
troða	tʰ r ɔː ð a
fjárdráttur	f j a u r t r a u h t ʏ r
eigandi	e iː ɣ a n t ɪ
kúpull	kʰ uː p ʏ t l
málvísindi	m a u l v iː s ɪ n t ɪ
mágur	m a uː ʏ r
lest	l ɛ s t
norrænn	n ɔ r r a i n
hanga	h a u ŋ k a
kinnalitur	cʰ ɪ nː a l ɪː t ʏ r
hrella	r̥ ɛ t l a
ábóti	a uː p o uː t ɪ
saltfiskur	s a l̥ t f ɪ s k ʏ r
benediktína	p ɛː n ɛː t ɪ x t iː n a
eiginnafn	e iː j ɪ n n a p n
gróp	k r o uː p
latína	l aː tʰ iː n a
kollur	kʰ ɔ t l ʏ r
mjólkurferna	m j o u l̥ k ʏ r f ɛ r t n a
áreiðanlegur	a uː r e iː ð a n l ɛː ɣ ʏ r
ísbjörn	iː s p j œ r t n
keisaraviður	cʰ e iː s aː r a v ɪː ð ʏ r
öxl	œ x s t l
horfa	h ɔ r v a
drekka	t r ɛ h k a
látbragðsleikur	l a uː t p r a ɣ ð s l e iː k ʏ r
spíri	s p iː r ɪ
forði	f ɔ r ð ɪ
málfar	m a u l f aː r
mygla	m ɪ k l a
svampur	s v a m̥ p ʏ r
sund	s ʏ n t
latur	l aː t ʏ r
lasna	l a s t n a
hulduefni	h ʏ l t ʏ ɛ p n ɪ
ganamaður	k aː n a m aː ð ʏ r
ætla	a i h t l a
hreyfa	r̥ e iː v a
hegri	h ɛ ɣ r ɪ
undirskrift	ʏ n t ɪ r s k r ɪ f t
bleia	p l e iː j a
mesópótamía	m ɛː s o uː pʰ o uː t a m iː j a
blóðfruma	p l o u ð f r ʏː m a
bergdís	p ɛ r k t iː s
danmörk	t a n m œ r̥ k
þiðna	θ ɪ ð n a
ljósmynd	l j o uː s m ɪ n t
aldinbori	a l t ɪ n p ɔː r ɪ
jöklaklukka	j œ h k l a kʰ l ʏ h k a
risna	r ɪ s t n a
bylja	p ɪ l j a
myrkvi	m ɪ r̥ k v ɪ
steindór	s t e i n t o uː r
bernharður	p ɛ r n h a r ð ʏ r
rómaborg	r o uː m a p ɔ r k
vafra	v a v r a
sæma	s a iː m a
hrekja	r̥ ɛː c a
fýluferð	f iː l ʏ f ɛ r ð
duld	t ʏ l t
lýsing	l iː s i ŋ k
skaða	s k aː ð a
tvívetni	tʰ v iː v ɛ h t n ɪ
vömb	v œ m p
vaxa	v a x s a
gryfja	k r ɪ v j a
munnharpa	m ʏ nː h a r̥ p a
þorkelína	θ ɔ r̥ cʰ ɛː l iː n a
jarðarber	j a r ð a r p ɛː r
þokki	θ ɔ h c ɪ
fjara	f j aː r a
fegurð	f ɛː ɣ ʏ r ð
flipi	f l ɪː p ɪ
bretónska	p r ɛː tʰ o u n s k a
koffort	kʰ ɔ fː ɔ r̥ t
sigurður	s ɪː ɣ ʏ r ð ʏ r
einvetni	e i n v ɛ h t n ɪ
flæða	f l a iː ð a
flygilhorn	f l ɪ j ɪ l h ɔ r t n
ástmundur	a u s t m ʏ n t ʏ r
rassvasi	r a sː v aː s ɪ
duus	d uː s
skegg	s c ɛ kː
kjaftur	cʰ a f t ʏ r
sæða	s a iː ð a
melkorka	m ɛ l kʰ ɔ r̥ k a
auðvelda	ø y ð v ɛ l t a
áhyggja	a uː h ɪ cː a
ofnæmi	ɔ v n a iː m ɪ
búrma	p u r m a
indæll	ɪ n t a i t l
alaskavíðir	aː l a s k a v iː ð ɪ r
rangstaða	r a u ŋ k s t aː ð a
rassgat	r a sː k aː t
beittur	p e i h t ʏ r
hlekkur	l̥ ɛ h k ʏ r
skurðgrafa	s k ʏ r ð k r aː v a
hnúskakrækill	n̥ u s k a kʰ r a iː c ɪ t l
melaskóli	m ɛː l a s k o uː l ɪ
skauti	s k ø yː t ɪ
gorta	k ɔ r̥ t a
þagna	θ a k n a
mata	m aː t a
sís	s iː s
greifingi	k r e iː v i ɲ c ɪ
farlama	f a r l a m a
karkari	kʰ a r̥ k a r ɪ
hirðingi	h ɪ r ð i ɲ c ɪ
hnífasmíði	n̥ iː v a s m iː ð ɪ
spergill	s p ɛ r c ɪ t l
sebrabraut	s ɛ p r a p r ø yː t
simpansi	s ɪ m̥ p a n s ɪ
sterkur	s t ɛ r̥ k ʏ r
askur	a s k ʏ r
þrældómur	θ r a i l t o uː m ʏ r
hjör	ç œː r
algyðistrú	a l c ɪ ð ɪ s tʰ r u
múr	m uː r
líking	l iː c i ŋ k
pútta	pʰ u h t a
alaska	aː l a s k a
eggfruma	ɛ kː f r ʏː m a
ofursti	ɔː f ʏ r̥ s t ɪ
rokkur	r ɔ h k ʏ r
roðasteinn	r ɔː ð a s t e i t n
blika	p l ɪː k a
maurasýra	m ø yː r a s iː r a
knippi	kʰ n ɪ h p ɪ
vegna	v ɛ k n a
beisli	p e i s t l ɪ
framvinda	f r a m v ɪ n t a
tísta	tʰ i s t a
fjandmaður	f j a n t m aː ð ʏ r
sófókles	s o uː f o uː kʰ l ɛː s
hvítkál	xʷ iː t kʰ a uː l
horfur	h ɔ r v ʏ r
albanía	a l p aː n iː j a
þenja	θ ɛ n j a
kvartil	kʰ v a r̥ t ɪ l
selja	s ɛ l j a
hæll	h a i t l
hórus	h o uː r ʏ s
hnútur	n̥ uː t ʏ r
leifar	l e iː v a r
eldvarpa	ɛ l t v a r̥ p a
salvi	s a l v ɪ
viðbrögð	v ɪ ð p r œ ɣ ð
skrúðganga	s k r u ð k a u ŋ k a
gera	c ɛː r a
luralegur	l ʏː r a l ɛː ɣ ʏ r
haltra	h a l̥ t r a
slagharpa	s t l aː ɣ h a r̥ p a
gagga	k a kː a
fógeti	f o uː c ɛː t ɪ
ljóðlist	l j o u ð l ɪ s t
meyr	m e iː r
erindi	ɛː r ɪ n t ɪ
borðstofa	p ɔ r ð s t ɔː v a
þind	θ ɪ n t
hem	h ɛː m
sess	s ɛ sː
hneggja	n̥ ɛ cː a
strompur	s t r ɔ m̥ p ʏ r
leður	l ɛː ð ʏ r
frysta	f r ɪ s t a
dökkna	t œ h k n a
bifur	p ɪː v ʏ r
stuðningur	s t ʏ ð n i ŋ k ʏ r
sprettur	s p r ɛ h t ʏ r
ratleikur	r aː t l e iː k ʏ r
hausta	h ø y s t a
drösull	t r œː s ʏ t l
aðgát	a ð k a uː t
spritt	s p r ɪ h t
snjór	s n j o uː r
konunglegur	kʰ ɔː n u ŋ k l ɛː ɣ ʏ r
dekka	t ɛ h k a
blotna	p l ɔ h t n a
hrönn	r̥ œ nː
faðir	f aː ð ɪ r
bryti	p r ɪː t ɪ
forritari	f ɔ rː ɪ t aː r ɪ
blók	p l o uː k
snípur	s t n iː p ʏ r
áreynsla	a uː r e i n s t l a
alþýðlegur	a l θ i ð l ɛː ɣ ʏ r
borða	p ɔ r ð a
fiski	f ɪ s c ɪ
frekur	f r ɛː k ʏ r
býfluga	p iː f l ʏː ɣ a
blóðskömm	p l o u ð s k œ mː
sýgill	s iː j ɪ t l
armenska	a r m ɛ n s k a
skurðpunktur	s k ʏ r ð pʰ u ŋ̊ k t ʏ r
hrista	r̥ ɪ s t a
brýni	p r iː n ɪ
krossför	kʰ r ɔ sː f œː r
orðrómur	ɔ r ð r o uː m ʏ r
gæfa	c a iː v a
disketta	t ɪ s k ɛ h t a
þys	θ ɪː s
dagmál	t a ɣ m a uː l
öreindafræði	œː r e i n t a f r a iː ð ɪ
búmaður	p uː m aː ð ʏ r
flík	f l iː k
sauðnaut	s ø y ð n ø yː t
fleyta	f l e iː t a
kennitala	cʰ ɛ nː ɪ tʰ aː l a
holt	h ɔ l̥ t
forstjóri	f ɔ r̥ s t j o uː r ɪ
plokka	pʰ l ɔ h k a
veina	v e iː n a
keisaraskurður	cʰ e iː s aː r a s k ʏ r ð ʏ r
galdrakerling	k a l t r a cʰ ɛ r t l i ŋ k
strokka	s t r ɔ h k a
samúel	s aː m uː ɛː l
páskavika	pʰ a u s k a v ɪː k a
markvörður	m a r̥ k v œ r ð ʏ r
tása	tʰ a uː s a
brauð	p r ø yː ð
geirþrúður	c e i r̥ θ r uː ð ʏ r
logn	l ɔ k n
floti	f l ɔː t ɪ
leikvangur	l e iː k v a u ŋ k ʏ r
gambri	k a m p r ɪ
ók	o uː k
jólaeyja	j o uː l a e iː j a
eyjafjallajökull	e iː j a f j a t l a j œː k ʏ t l
lýðveldi	l i ð v ɛ l t ɪ
faraldur	f aː r a l t ʏ r
bursta	p ʏ r̥ s t a
eggjarauða	ɛ cː a r ø yː ð a
lím	l iː m
geisli	c e i s t l ɪ
álit	a uː l ɪː t
sóli	s o uː l ɪ
aldinborg	a l t ɪ n p ɔ r k
senna	s ɛ nː a
ljómi	l j o uː m ɪ
gæsa	c a iː s a
lyfjabúð	l ɪ v j a p uː ð
skömm	s k œ mː
kynnir	cʰ ɪ nː ɪ r
tröllkona	tʰ r œ t l kʰ ɔː n a
bólgna	p o u l n a
steinn	s t e i t n
svefn	s v ɛ p n
spekja	s p ɛː c a
blóðmaur	p l o uː ð m ø yː r
lessa	l ɛ sː a
fitusýra	f ɪː t ʏ s iː r a
eintala	e i n tʰ aː l a
ilmvatn	ɪ l m v a h t n
framrúða	f r a m r uː ð a
þórhallur	θ o uː r h a t l ʏ r
liðveisla	l ɪ ð v e i s t l a
hnoðri	n̥ ɔ ð r ɪ
högg	h œ kː
pissuskál	pʰ ɪ sː ʏ s k a uː l
fylgd	f ɪ l t
náttúra	n a u h t uː r a
bika	p ɪː k a
erla	ɛ r t l a
smali	s m aː l ɪ
ruggustóll	r ʏ kː ʏ s t o u t l
traust	tʰ r ø y s t
hlægja	l̥ a iː j a
semball	s ɛ m p a t l
herri	h ɛ rː ɪ
fælast	f a iː l a s t
rass	r a sː
herramaður	h ɛ rː a m aː ð ʏ r
rúgur	r uː ʏ r
tryggur	tʰ r ɪ kː ʏ r
aftur	a f t ʏ r
stella	s t ɛ lː a
kaffibrauð	kʰ a fː ɪ p r ø yː ð
lauslátur	l ø yː s l a uː t ʏ r
blífur	p l iː v ʏ r
gashylki	k aː s h ɪ l̥ c ɪ
dyrgja	t ɪ r c a
ólafur	o uː l aː v ʏ r
yfirtaka	ɪː v ɪ r tʰ aː k a
eldspýta	ɛ l t s p iː t a
blæja	p l a iː j a
dýjamosi	t iː j a m ɔː s ɪ
rakki	r a h c ɪ
grá	k r a uː
hvetja	xʷ ɛː t j a
laugasef	l ø yː ɣ a s ɛː v
hrani	r̥ aː n ɪ
skækill	s c a iː c ɪ t l
skrúðhús	s k r uː ð h uː s
hálfendir	h a u l v ɛ n t ɪ r
týr	tʰ iː r
heimsfriður	h e i m s f r ɪː ð ʏ r
hirðulaus	h ɪ r ð ʏ l ø yː s
ólund	o uː l ʏ n t
vella	v ɛ t l a
ábyrgur	a uː p ɪ r k ʏ r
tréblásturshljóðfæri	tʰ r j ɛː p l a u s t ʏ r̥ s l̥ j o u ð f a iː r ɪ
útsýni	uː t s iː n ɪ
barnamosi	p a r t n a m ɔː s ɪ
forritunarmál	f ɔ rː ɪː t ʏ n a r m a uː l
endaþarmsmök	ɛ n t a θ a r m s m œː k
klippur	kʰ l ɪ h p ʏ r
fræfill	f r a iː v ɪ t l
biblía	p ɪ p l iː j a
metri	m ɛː t r ɪ
límóna	l iː m o uː n a
belgjastör	p ɛ l c a s t œː r
hedd	h ɛ tː
lengja	l e i ɲ c a
brunnur	p r ʏ nː ʏ r
baugur	p ø yː ɣ ʏ r
börur	p œː r ʏ r
nebbi	n ɛ pː ɪ
von	v ɔː n
netjuský	n ɛː t j ʏ s c iː
niðurskurður	n ɪː ð ʏ r s k ʏ r ð ʏ r
dul	t ʏː l
orðstír	ɔ r ð s tʰ iː r
hlass	l̥ a sː
edik	ɛː t ɪ k
náttmál	n a u h t m a uː l
vasi	v aː s ɪ
rasskinn	r a sː cʰ ɪ nː
látún	l a uː t uː n
öglir	œ k l ɪː r
kjötbolla	cʰ œ t p ɔ lː a
munaðarleysingjahæli	m ʏː n aː ð a r l e iː s i ɲ c a h a iː l ɪ
bali	p aː l ɪ
gráðostur	k r a uː ð ɔ s t ʏ r
aðalheiður	aː ð a l h e iː ð ʏ r
fugl	f ʏ k l
mýrdalína	m i r t aː l iː n a
spítta	s p i h t a
kíkir	cʰ iː c ɪ r
nátíð	n a uː tʰ iː ð
geimstöð	c e i m s t œː ð
gjörð	c œ r ð
símaklefi	s iː m a kʰ l ɛː v ɪ
fjúka	f j uː k a
þekja	θ ɛː c a
afbrigði	a v p r ɪ ɣ ð ɪ
afi	aː v ɪ
loða	l ɔː ð a
flygill	f l ɪː j ɪ t l
tvíbaka	tʰ v iː p aː k a
ljúga	l j uː a
græja	k r a iː j a
valhnappur	v a l n̥ a h p ʏ r
vélinda	v j ɛː l ɪ n t a
glæta	k l a iː t a
skola	s k ɔː l a
alúðlega	aː l u ð l ɛː ɣ a
lýsi	l iː s ɪ
skriða	s k r ɪː ð a
þraut	θ r ø yː t
smár	s m a uː r
kvennabósi	kʰ v ɛ nː a p o uː s ɪ
ölgerð	œ l c ɛ r ð
rasismi	r aː s ɪ s m ɪ
klípa	kʰ l iː p a
álaborg	a uː l a p ɔ r k
stirður	s t ɪ r ð ʏ r
hnoð	n̥ ɔː ð
húnn	h u t n
bjarmi	p j a r m ɪ
húðflúr	h u ð f l uː r
synjun	s ɪ n j ʏ n
kjötkveðjuhátíð	cʰ œ t kʰ v ɛ ð j ʏ h a uː tʰ iː ð
leif	l e iː v
kekkur	cʰ ɛ h k ʏ r
bótúlíneitrun	p o uː tʰ uː l iː n e iː t r ʏ n
stjörnuarfi	s t j œ r t n ʏ a r v ɪ
ingimundur	i ɲ c ɪ m ʏ n t ʏ r
skemma	s c ɛ mː a
skil	s c ɪː l
fletja	f l ɛː t j a
smíða	s m iː ð a
snæfríður	s t n a iː f r iː ð ʏ r
páskaegg	pʰ a u s k a ɛ kː
ríkisráð	r iː c ɪ s r a uː ð
dæld	t a i l t
vatnalilja	v a h t n a l ɪ l j a
fóstri	f o u s t r ɪ
húka	h uː k a
ítalska	iː tʰ a l s k a
tíður	tʰ iː ð ʏ r
þýskur	θ i s k ʏ r
rök	r œː k
reigingur	r e iː j i ŋ k ʏ r
pendúll	pʰ ɛ n t ʏ t l
afturkræfur	a f t ʏ r kʰ r a iː v ʏ r
jaðarrokk	j aː ð a r r ɔ h k
græta	k r a iː t a
gríma	k r iː m a
skæni	s c a iː n ɪ
nýsilfur	n iː s ɪ l v ʏ r
brella	p r ɛ t l a
hnéskel	n̥ j ɛː s c ɛː l
lemja	l ɛ m j a
janúar	j aː n uː aː r
beyging	p e iː j i ŋ k
sóun	s o uː ʏ n
efnisyfirlit	ɛ p n ɪ s ɪː v ɪ r l ɪː t
geðveikur	c ɛ ð v e iː k ʏ r
kæta	cʰ a iː t a
vasatölva	v aː s a tʰ œ l v a
eyja	e iː j a
gísl	c i s t l
skáld	s k a u l t
drengur	t r e i ŋ k ʏ r
letur	l ɛː t ʏ r
man	m a n
portúgalska	p ɔ r̥ t uː k a l s k a
nýting	n iː t i ŋ k
rabb	r a pː
gangráður	k a u ŋ k r a uː ð ʏ r
aldin	a l t ɪ n
fjallafura	f j a t l a f ʏː r a
rún	r uː n
skita	s c ɪː t a
ambaga	a m p aː ɣ a
hestaleiga	h ɛ s t a l e iː ɣ a
arða	a r ð a
flúr	f l uː r
læknisfræðilegur	l a i h k n ɪ s f r a iː ð ɪ l ɛː ɣ ʏ r
spæta	s p a iː t a
klukkutími	kʰ l ʏ h k ʏ tʰ iː m ɪ
orfa	ɔ r v a
beikon	p e iː kʰ ɔ n
heitur	h e iː t ʏ r
brydda	p r ɪ tː a
matseðill	m aː t s ɛː ð ɪ t l
gró	k r o uː
panta	pʰ a n̥ t a
gaukur	k ø yː k ʏ r
jaðar	j aː ð a r
starfa	s t a r v a
lestrarbók	l ɛ s t r a r p o uː k
fólínsýra	f o uː l iː n s iː r a
útlendur	uː t l ɛ n t ʏ r
straumur	s t r œ yː m ʏ r̥
blóðbað	p l o u ð p aː ð
signa	s ɪ k n a
bauk	p ø yː k
ormur	ɔ r m ʏ r
barna	p a r t n a
fangaklefi	f a u ŋ k a kʰ l ɛː v ɪ
guðríður	k v ʏ ð r iː ð ʏ r
hör	h œː r
brjósk	p r j o u s k
bónus	p o uː n ʏ s
kyrtill	cʰ ɪ r̥ t ɪ t l
velmegun	v ɛ l m ɛː ɣ ʏ n
pinkill	pʰ i ɲ̊ c ɪ t l
hundafangari	h ʏ n t a f a u ŋ k aː r ɪ
ofbirta	ɔ v p ɪ r̥ t a
sýra	s iː r a
færi	f a iː r ɪ
auli	ø yː l ɪ
flæði	f l a iː ð ɪ
kirja	cʰ ɪ r j a
beisla	p e i s t l a
áslaug	a uː s l ø yː ɣ
læri	l a iː r ɪ
snefill	s t n ɛː v ɪ t l
hornafræði	h ɔ r t n a f r a iː ð ɪ
þukl	θ ʏ h k l
ásmundur	a uː s m ʏ n t ʏ r
biðill	p ɪː ð ɪ t l
skynsemi	s c ɪ n s ɛː m ɪ
nálgunarbann	n a u l k ʏ n a r p a nː
kjörgengur	cʰ œ r c e i ŋ k ʏ r
stafa	s t aː v a
tregur	tʰ r ɛː ɣ ʏ r
hús	h uː s
bjáni	p j a uː n ɪ
þrúður	θ r uː ð ʏ r
pistasía	pʰ ɪ s t a s iː j a
uml	ʏ m l
herstígvél	h ɛ r̥ s t i ɣ v j ɛː l
bavían	p aː v iː a n
netla	n ɛ h t l a
tjull	tʰ j ʏ lː
syndga	s ɪ n t k a
bjarga	p j a r k a
falla	f a t l a
spennandi	s p ɛ nː a n t ɪ
kóreska	kʰ o uː r ɛ s k a
japanskur	j aː pʰ a n s k ʏ r
mitti	m ɪ h t ɪ
þrjóska	θ r j o u s k a
stríða	s t r iː ð a
kanadagæs	kʰ aː n a t a c a iː s
prófastur	pʰ r o uː v a s t ʏ r
starf	s t a r v
vefsíða	v ɛ f s iː ð a
bræla	p r a iː l a
húsfreyja	h uː s f r e iː j a
hliðarvasi	l̥ ɪː ð a r v aː s ɪ
birkitré	p ɪ r̥ c ɪ t r j ɛː
sjóari	s j o uː aː r ɪ
galsi	k a l s ɪ
linur	l ɪː n ʏ r
stress	s t r ɛ sː
lappland	l a h p l a n t
ás	a uː s
bugur	p ʏː ɣ ʏ r
þumlungur	θ ʏ m l u ŋ k ʏ r
ófullnægjandi	o uː f ʏ t l n a iː j a n t ɪ
serða	s ɛ r ð a
skeina	s c e iː n a
skepna	s c ɛ h p n a
fílsbein	f i l s p e iː n
rúðuborg	r uː ð ʏ p ɔ r k
björk	p j œ r̥ k
öngull	ø y ŋ k ʏ t l
leikritaskáld	l e iː k r ɪː t a s k a u l t
flengja	f l e i ɲ c a
máni	m a uː n ɪ
líkamsrækt	l iː kʰ a m s r a i x t
munaðarleysingi	m ʏː n aː ð a r l e iː s i ɲ c ɪ
ládauður	l a uː t ø yː ð ʏ r
silfurlitaður	s ɪ l v ʏ r l ɪː t a ð ʏ r
flas	f l aː s
kjarnahvarf	cʰ a r t n a kʰ v a r v
lárus	l a uː r ʏ s
töfra	tʰ œ v r a
smári	s m a uː r ɪ
tékkneskur	tʰ j ɛ h k n ɛ s k ʏ r
hjátrú	ç a uː tʰ r uː
styðja	s t ɪ ð j a
lopapeysa	l ɔː p a pʰ e iː s a
lettland	l ɛ h t l a n t
eldsvoði	ɛ l t s v ɔː ð ɪ
hengja	h e i ɲ c a
engill	e i ɲ c ɪ t l
lungnakrabbamein	l u ŋ k n a kʰ r a pː a m e iː n
frjór	f r j o uː r
teikn	tʰ e i h k n
kantmaður	kʰ a n̥ t m aː ð ʏ r
blessun	p l ɛ sː ʏ n
kúluvarp	kʰ uː l ʏ v a r̥ p
túr	tʰ uː r
fjalldrapi	f j a t l t r aː p ɪ
innkast	ɪ nː kʰ a s t
heildi	h e i l t ɪ
hrím	r̥ iː m
torveldi	tʰ ɔ r v ɛ l t ɪ
njósna	n j o u s t n a
glápa	k l a uː p a
útibú	uː t ɪ p uː
beiða	p e iː ð a
frænka	f r a i n k a
bílstjóri	p i l s t j o uː r ɪ
pálmar	pʰ a u l m a r
mannkyn	m a nː cʰ ɪː n
æra	a iː r a
minnkun	m i ŋ̊ k ʏ n
nýyrði	n iː ɪ r ð ɪ
flugstjóri	f l ʏ x s t j o uː r ɪ
hnésbót	n̥ j ɛː s p o uː t
simpill	s ɪ m̥ p ɪ t l
skelmir	s c ɛ l m ɪ r
kryppa	kʰ r ɪ h p a
kyndugur	cʰ ɪ n t ʏː ɣ ʏ r
tvímynd	tʰ v iː m ɪ n t
helín	h ɛː l iː n
rugga	r ʏ kː a
dílaskarfur	t iː l a s k a r v ʏ r
gnoð	k n ɔː ð
fjallkrækill	f j a t l kʰ r a iː c ɪ t l
milta	m ɪ l̥ t a
aðaláhrif	aː ð aː l a uː r̥ ɪː v
uppgerð	ʏ h p c ɛ r ð
fífa	f iː v a
túlkur	tʰ u l̥ k ʏ r
sylgja	s ɪ l c a
hræsni	r̥ a i s t n ɪ
kastali	kʰ a s t aː l ɪ
krydd	kʰ r ɪ tː
bakpoki	p aː k pʰ ɔː c ɪ
kínasi	cʰ iː n aː s ɪ
rjúfa	r j uː v a
hráki	r̥ a uː c ɪ
kynna	cʰ ɪ nː a
stafur	s t aː v ʏ r
maí	m a iː
minjagripur	m ɪ n j a k r ɪː p ʏ r
ístra	i s t r a
einn	e i t n
bogna	p ɔ k n a
drit	t r ɪː t
þuríður	θ ʏː r iː ð ʏ r
toga	tʰ ɔː ɣ a
sifji	s ɪ v j ɪ
ginning	c ɪ nː i ŋ k
stytta	s t ɪ h t a
ívar	iː v aː r
órólegur	o uː r o uː l ɛː ɣ ʏ r
lama	l aː m a
athöfn	aː t h œ p n
bágur	p a uː ʏ r
tálvon	tʰ a u l v ɔː n
skvass	s k v a sː
kjóll	cʰ o u t l
brynjólfína	p r ɪ n j o u l v iː n a
gætinn	c a iː t ɪ nː
kristinn	kʰ r ɪ s t ɪ nː
spenntur	s p ɛ n̥ t ʏ r
halldór	h a l t o uː r
olga	ɔ l k a
lærleggur	l a i r l ɛ kː ʏ r
dæla	t a iː l a
séríslenskur	s j ɛː r i s t l ɛ n s k ʏ r
lafði	l a v ð ɪ
hnökri	n̥ œː k r ɪ
dís	t iː s
vita	v ɪː t a
þverflauta	θ v ɛ r̥ f l ø yː t a
butur	p ʏː t ʏ r
spönn	s p œ nː
látbragð	l a uː t p r a ɣ ð
verndari	v ɛ r n t aː r ɪ
tékkland	t j ɛ h k l a n t
minningargripur	m ɪ nː i ŋ k a r k r ɪː p ʏ r
ný	n iː
senda	s ɛ n t a
þorlákína	θ ɔ r l a uː c iː n a
bytta	p ɪ h t a
met	m ɛː t
erfðafræði	ɛ r v ð a f r a iː ð ɪ
brennsla	p r ɛ n s t l a
díll	t i t l
né	n j ɛː
hundur	h ʏ n t ʏ r
ójafna	o uː j a p n a
obláta	ɔ p l a uː t a
vilhjálmína	v ɪ l ç a u l m iː n a
skríða	s k r iː ð a
hvati	kʰ v aː t ɪ
prússland	pʰ r u s t l a n t
amma	a mː a
forsæla	f ɔ r̥ s a iː l a
smokks	s m ɔ h k s
gæra	c a iː r a
sjóveiki	s j o uː v e iː c ɪ
melda	m ɛ l t a
skjól	s c o uː l
emm	ɛ mː
smjörhnífur	s m j œ r n̥ iː v ʏ r
mæðgin	m a i ð c ɪː n
reyta	r e iː t a
ökkli	œ h k l ɪ
samanburður	s aː m a n p ʏ r ð ʏ r
hnegg	n̥ ɛ kː
orkugjafi	ɔ r̥ k ʏ c aː v ɪ
arnar	a r t n aː r
heyra	h e iː r a
erkibiskup	ɛ r̥ c ɪ p ɪ s k ʏ p
framlag	f r a m l aː ɣ
frekna	f r ɛ h k n a
fjölbreytni	f j œ l p r e i h t n ɪ
runa	r ʏː n a
þátíð	θ a uː tʰ iː ð
nærmynd	n a i r m ɪ n t
stund	s t ʏ n t
róteind	r o uː t e i n t
mæði	m a iː ð ɪ
sigurdís	s ɪː ɣ ʏ r t iː s
lykkja	l ɪ h c a
lækjasóley	l a iː c a s o uː l e iː
hiti	h ɪː t ɪ
heygja	h e iː j a
sveipur	s v e iː p ʏ r
vitni	v ɪ h t n ɪ
vafi	v aː v ɪ
úði	uː ð ɪ
tunga	tʰ u ŋ k a
þýskaland	θ i s k a l a n t
vepja	v ɛː p j a
jarðarbúi	j a r ð a r p uː ɪ
gluggi	k l ʏ cː ɪ
hengi	h e i ɲ c ɪ
tefla	tʰ ɛ p l a
draumur	t r ø yː m ʏ r̥
rabarbari	r aː p a r p aː r ɪ
bæsa	p a iː s a
lávarður	l a uː v a r ð ʏ r
mörður	m œ r ð ʏ r
axhæra	a x s h a iː r a
leysir	l e iː s ɪ r
knörr	kʰ n œ rː
dvergur	t v ɛ r k ʏ r
auðveldur	ø y ð v ɛ l t ʏ r
stutt	s t ʏ h t
sút	s uː t
gæsahúð	c a iː s a h uː ð
lotsveifgras	l ɔː t s v e i v k r aː s
stríðni	s t r i ð n ɪ
pípetta	pʰ iː p ɛ h t a
brass	p r a sː
botnlangabólga	p ɔ h t n l a u ŋ k a p o u l k a
samþykkt	s a m θ ɪ x t
kafari	kʰ aː v a r ɪ
kynhneigð	cʰ ɪ n n̥ e i ɣ ð
eldiviður	ɛ l t ɪ v ɪː ð ʏ r
bunga	p u ŋ k a
minna	m ɪ nː a
morkill	m ɔ r̥ c ɪ t l
dymbilvika	t ɪ m p ɪ l v ɪː k a
skraf	s k r aː v
dreggjar	t r ɛ cː a r
móðurborð	m o uː ð ʏ r p ɔ r ð
glöggur	k l œ kː ʏ r
kundur	kʰ ʏ n t ʏ r
dómur	t o uː m ʏ r
ára	a uː r a
viða	v ɪː ð a
þróa	θ r o uː a
skrýða	s k r iː ð a
hrökkva	r̥ œ h k v a
spítt	s p i h t
harðlífi	h a r ð l iː v ɪ
léttur	l j ɛ h t ʏ r
steinþór	s t e i n θ o uː r
blýantur	p l iː a n t ʏ r
fulltrúi	f ʏ t l̥ tʰ r uː ɪ
systursonur	s ɪ s t ʏ r̥ s ɔː n ʏ r
fjallastör	f j a t l a s t œː r
leiðrétting	l e i ð r j ɛ h t i ŋ k
himna	h ɪ m n a
biðvarsla	p ɪ ð v a r s t l a
komma	kʰ ɔ mː a
vog	v ɔː ɣ
urð	ʏ r ð
sjöa	s j œː a
nopi	n ɔː p ɪ
þríleikur	θ r iː l e iː k ʏ r
séra	s j ɛː r a
guðspjallamaður	k v ʏ ð s p j a t l a m aː ð ʏ r
fulltingi	f ʏ t l̥ tʰ i ɲ c ɪ
ljósabekkur	l j o uː s a p ɛ h k ʏ r
stöng	s t ø y ŋ k
ráðgáta	r a u ð k a uː t a
kjassa	cʰ a sː a
grænukorn	k r a iː n ʏ kʰ ɔ r t n
fíkill	f iː c ɪ t l
biðröð	p ɪ ð r œː ð
mat	m aː t
hraun	r̥ ø yː n
herra	h ɛ rː a
bjakk	p j a h k
postuli	pʰ ɔ s t ʏː l ɪ
hengill	h e i ɲ c ɪ t l
hvirfilvindur	xʷ ɪ r v ɪ l v ɪ n t ʏ r
tinda	tʰ ɪ n t a
fréttastofa	f r j ɛ h t a s t ɔː v a
soð	s ɔː ð
svíða	s v iː ð a
hræðilega	r̥ a iː ð ɪ l ɛː ɣ a
fljúga	f l j uː a
doði	t ɔː ð ɪ
fjölbýlishús	f j œ l p iː l ɪ s h uː s
ægir	a iː j ɪ r
hljóma	l̥ j o uː m a
vídalín	v iː t a l iː n
hefta	h ɛ f t a
teygjudýr	tʰ e iː j ʏ t iː r
finsen	f ɪ n s ɛː nː
tékki	tʰ j ɛ h c ɪ
svið	s v ɪː ð
sitkagreni	s ɪː t k a k r ɛː n ɪ
hæfa	h a iː v a
skunkur	s k u ŋ̊ k ʏ r
gyðingur	c ɪː ð i ŋ k ʏ r
annar	a nː a r
hirðir	h ɪ r ð ɪ r
eftirlíking	ɛ f t ɪ r l iː c i ŋ k
svæfill	s v a iː v ɪ t l
kórea	kʰ o uː r ɛː a
hefna	h ɛ p n a
gisting	c ɪ s t i ŋ k
skír	s c iː r
sker	s c ɛː r
líra	l iː r a
kíghósti	kʰ iː ɣ h o u s t ɪ
eista	e i s t a
bylgjulengd	p ɪ l c ʏ l e i ŋ k t
forrit	f ɔ r r ɪː t
heimskingi	h e i m s c i ɲ c ɪ
karlfauskur	kʰ a r t l f ø y s k ʏ r
kóða	kʰ o uː ð a
bylting	p ɪ l̥ t i ŋ k
guðdís	k v ʏ ð t iː s
læknisfræði	l a i h k n ɪ s f r a iː ð ɪ
geipa	c e iː p a
tað	tʰ aː ð
snjallur	s t n j a t l ʏ r
efja	ɛ v j a
snær	s n a iː r
önd	œ n t
fagurgæs	f aː ɣ ʏ r c a iː s
brandur	p r a n t ʏ r
hryssingur	r̥ ɪ sː i ŋ k ʏ r
allsgáður	a l s k a uː ð ʏ r
skotvopn	s k ɔː t v ɔ h p n
lýður	l iː ð ʏ r
frí	f r iː
ilmur	ɪ l m ʏ r
hrak	r̥ aː k
tau	tʰ ø yː
barkakýli	p a r̥ k a cʰ iː l ɪ
járnsmiður	j a u r t n s m ɪː ð ʏ r
kýta	cʰ iː t a
krisma	kʰ r ɪ s m a
rekaviður	r ɛː k a v ɪː ð ʏ r
friðarbogi	f r ɪː ð a r p ɔː j ɪ
rúmenska	r uː m ɛ n s k a
erlendína	ɛ r l ɛ n t iː n a
buxur	p ʏ x s ʏ r
eistneska	e i s t n ɛ s k a
verk	v ɛ r̥ k
ljúka	l j uː k a
karate	kʰ aː r a t ɛː
grallari	k r a t l aː r ɪ
ræðismaður	r a iː ð ɪ s m aː ð ʏ r
storma	s t ɔ r m a
hórdómur	h o u r t o uː m ʏ r
skruna	s k r ʏː n a
aukasetning	ø yː k a s ɛ h t n i ŋ k
gróður	k r o uː ð ʏ r
ívera	iː v ɛː r a
kveikur	kʰ v e iː k ʏ r
binda	p ɪ n t a
olnbogi	ɔ l n p ɔː j ɪ
vilma	v ɪ l m a
dylgja	t ɪ l c a
jöstur	j œ s t ʏ r
músareyra	m uː s a r e iː r a
vika	v ɪː k a
fínn	f i t n
hlaðborð	l̥ a ð p ɔ r ð
skera	s c ɛː r a
gátt	k a u h t
girni	c ɪ r t n ɪ
bæli	p a iː l ɪ
glæra	k l a iː r a
mestur	m ɛ s t ʏ r
rangeygður	r a u ŋ k e i ɣ ð ʏ r
skaut	s k ø yː t
þolfall	θ ɔ l f a t l
frímerki	f r iː m ɛ r̥ c ɪ
eign	e i k n
tryggja	tʰ r ɪ cː a
mar	m aː r
leiðsögn	l e i ð s œ k n
bára	p a uː r a
þingmaður	θ i ŋ k m aː ð ʏ r
strimill	s t r ɪː m ɪ t l
scheving	s c ɛː v i ŋ
repja	r ɛː p j a
fullyrða	f ʏ t l ɪ r ð a
söngkona	s ø y ŋ k kʰ ɔː n a
varp	v a r̥ p
þræla	θ r a iː l a
vagn	v a k n
naddur	n a tː ʏ r
plógur	pʰ l o uː ʏ r
leiðni	l e i ð n ɪ
hjartastillir	ç a r̥ t a s t ɪ t l ɪ r
djamm	t j a mː
sínus	s iː n ʏ s
kvenhatur	kʰ v ɛ n h aː t ʏ r
skýr	s c iː r
morgunfrú	m ɔ r k ʏ n f r uː
mótetta	m o uː tʰ ɛ h t a
frauð	f r ø yː ð
persónufornafn	pʰ ɛ r̥ s o uː n ʏ f ɔ r n a p n
einkenni	e i n cʰ ɛ nː ɪ
held	h ɛ l t
jafn	j a p n
tálkn	tʰ a u l̥ k n
keipur	cʰ e iː p ʏ r
námsbraut	n a u m s p r ø yː t
fórn	f o u r t n
veiða	v e iː ð a
til	tʰ ɪː l
lambagras	l a m p a k r aː s
eldmóður	ɛ l t m o uː ð ʏ r
leiðindi	l e iː ð ɪ n t ɪ
neitun	n e iː t ʏ n
firð	f ɪ r ð
spænskur	s p a i n s k ʏ r
kyssa	cʰ ɪ sː a
hæstiréttur	h a i s t ɪ r j ɛ h t ʏ r
hringja	r̥ i ɲ c a
partí	pʰ a r̥ t i
salerni	s aː l ɛ r t n ɪ
steinefni	s t e iː n ɛ p n ɪ
samúelína	s aː m uː ɛː l iː n a
sminka	s m i ŋ̊ k a
hökull	h œː k ʏ t l
stóla	s t o uː l a
bendill	p ɛ n t ɪ t l
steik	s t e iː k
fús	f uː s
raf	r aː v
ríkidæmi	r iː c ɪ t a iː m ɪ
handbremsubeygja	h a n t p r ɛ m s ʏ p e iː j a
hníga	n̥ iː ɣ a
hlýðni	l̥ i ð n ɪ
silfraður	s ɪ l v r aː ð ʏ r
storkur	s t ɔ r̥ k ʏ r
þamba	θ a m p a
hel	h ɛː l
afturfótur	a f t ʏ r f o uː t ʏ r
forlát	f ɔ r l a uː t
hluttekning	l̥ ʏː t t ɛ h k n i ŋ k
víkingur	v iː c i ŋ k ʏ r
höfrungur	h œ v r u ŋ k ʏ r
hollenska	h ɔ l l ɛ n s k a
tvisvar	tʰ v ɪː s v aː r
ómerkilegur	o u m ɛ r̥ c ɪ l ɛː ɣ ʏ r
nál	n a uː l
kvöl	kʰ v œː l
blautur	p l ø yː t ʏ r
refill	r ɛː v ɪ t l
afganistan	a v k aː n ɪ s t aː n
stuðlun	s t ʏ ð l ʏ n
goshver	k ɔː s kʰ v ɛː r
krol	kʰ r ɔː l
eyrnalokkur	e i r t n a l ɔ h k ʏ r
esóp	ɛː s o uː p
hallgrímína	h a t l k r iː m iː n a
eipa	e iː p a
vænir	v a iː n ɪ r
harka	h a r̥ k a
biggi	p ɪ cː ɪ
leví	l ɛː v iː
þúfutittlingur	θ uː v ʏ tʰ ɪ h t l i ŋ k ʏ r
valur	v aː l ʏ r
hnísa	n̥ iː s a
jóhannesína	j o uː h a nː ɛː s iː n a
huggun	h ʏ kː ʏ n
einangrari	e iː n a u ŋ k r aː r ɪ
kristjánssandur	kʰ r ɪ s t j a u n s s a n t ʏ r
appelsínugulur	a h p ɛ l s iː n ʏ k ʏː l ʏ r
áhersluatviksorð	a uː h ɛ r̥ s t l ʏ aː t v ɪ k s ɔ r ð
fjölga	f j œ l k a
stíll	s t i t l
íhaldssamur	iː h a l t s s aː m ʏ r
salvadori	s a l v a t ɔː r ɪ
hámark	h a uː m a r̥ k
aðgerð	a ð c ɛ r ð
bið	p ɪː ð
lögreglukona	l œ ɣ r ɛ k l ʏ k ɔː n a
hindurvitni	h ɪ n t ʏ r v ɪ h t n ɪ
birna	p ɪ r t n a
síma	s iː m a
afburður	a v p ʏ r ð ʏ r
siða	s ɪː ð a
þóroddur	θ o uː r ɔ tː ʏ r
fegra	f ɛ ɣ r a
skógarfura	s k o uː a r f ʏː r a
símgreiðsla	s i m k r e i ð s t l a
tungumál	tʰ u ŋ k ʏ m a uː l
óendanleiki	o uː ɛ n t a n l e iː c ɪ
gerð	c ɛ r ð
körfuknattleikur	kʰ œ r v ʏ kʰ n a h t l e iː k ʏ r
fennikka	f ɛ nː ɪ h k a
skruma	s k r ʏː m a
hríð	r̥ iː ð
klapp	kʰ l a h p
púki	pʰ uː c ɪ
lítt	l i h t
slóð	s t l o uː ð
völ	v œː l
innheimta	ɪ nː h e i m̥ t a
póstkort	pʰ o u s t kʰ ɔ r̥ t
ferhyrndur	f ɛː r h ɪ r n t ʏ r
kringumstæður	kʰ r i ŋ k ʏ m s t a iː ð ʏ r
bein	p e iː n
stríð	s t r iː ð
spakur	s p aː k ʏ r
vallhæra	v a t l h a iː r a
uppfæra	ʏ h p f a iː r a
heilnóta	h e i l n o uː t a
forseti	f ɔ r̥ s ɛː t ɪ
þiggja	θ ɪ cː a
umla	ʏ m l a
undirlag	ʏ n t ɪ r l aː ɣ
leifa	l e iː v a
kvabb	kʰ v a pː
kvap	kʰ v aː p
ríða	r iː ð a
huglaus	h ʏ ɣ l ø yː s
lífsþróttur	l i f s θ r o u h t ʏ r
tögl	tʰ œ k l
sökkull	s œ h k ʏ t l
dægurlag	t a iː ɣ ʏ r l aː ɣ
þerra	θ ɛ rː a
aðild	aː ð ɪ l t
miðill	m ɪː ð ɪ t l
sagnfræði	s a k n f r a iː ð ɪ
hjálmtýr	ç a u l m tʰ iː r
skordýr	s k ɔ r t iː r
lús	l uː s
glópagull	k l o uː p a k ʏ t l
hljómplata	l̥ j o u m pʰ l aː t a
hey	h e iː
portúgali	pʰ ɔ r̥ t u k aː l ɪ
dalla	t a t l a
þil	θ ɪː l
flugvöllur	f l ʏ ɣ v œ t l ʏ r
þylja	θ ɪ l j a
pönk	pʰ ø y ŋ̊ k
stáss	s t a u sː
athuga	aː t h ʏː ɣ a
leikur	l e iː k ʏ r
fæ	f a iː
virka	v ɪ r̥ k a
yðar	ɪː ð a r
einmanaleiki	e i n m aː n a l e iː c ɪ
hraustur	r̥ ø y s t ʏ r
kórall	kʰ o uː r a t l
heimsyfirráð	h e i m s ɪː v ɪ r r a uː ð
boltaíþrótt	p ɔ l̥ t a iː θ r o u h t
kynleysi	cʰ ɪ n l e iː s ɪ
rengja	r e i ɲ c a
könguló	kʰ ø y ŋ k ʏ l o uː
kynngi	cʰ i ɲ c ɪ
verða	v ɛ r ð a
duglaus	t ʏ ɣ l ø yː s
kardináli	kʰ a r t ɪ n a uː l ɪ
fjallnykra	f j a t l n ɪː k r a
elding	ɛ l t i ŋ k
moska	m ɔ s k a
op	ɔ p
hirða	h ɪ r ð a
hækill	h a i cː ɪ t l
ítreka	iː tʰ r ɛː k a
smekklegur	s m ɛ h k l ɛː ɣ ʏ r
lífdagar	l i v t aː ɣ a r
framreiða	f r a m r e iː ð a
skinn	s c ɪ nː
eggjastokkur	ɛ cː a s t ɔ h k ʏ r
mát	m a uː t
krepja	kʰ r ɛː p j a
ark	a r̥ k
ferðataska	f ɛ r ð a tʰ a s k a
sturla	s t ʏ r t l a
ímynd	iː m ɪ n t
för	f œː r
fylgirit	f ɪ l c ɪ r ɪː t
púma	pʰ uː m a
þvinga	θ v i ŋ k a
litningur	l ɪ h t n i ŋ k ʏ r
klofna	kʰ l ɔ p n a
heflaður	h ɛ p l aː ð ʏ r
púrtvín	pʰ u r̥ t v iː n
sýkna	s i h k n a
lánsþýðing	l a u n s θ iː ð i ŋ k
munu	m ʏː n ʏ
þúsundblaðarós	θ uː s ʏ n t p l aː ð a r o uː s
dögun	t œː ɣ ʏ n
kalsít	kʰ a l s iː t
póstur	pʰ o u s t ʏ r
veila	v e iː l a
bora	p ɔː r a
starfsemi	s t a r v s ɛː m ɪ
banna	p a nː a
styggð	s t ɪ ɣ ð
claessen	kʰ l a sː ɛ n
lykill	l ɪː c ɪ t l
dúkkuhús	t u h k ʏ h uː s
afturbatapíka	a f tʰ ʏ r p aː tʰ a pʰ iː kʰ a
skapa	s k aː p a
nafarsrauf	n aː v a r̥ s r ø yː v
tröll	tʰ r œ t l
haka	h aː k a
je	j ɛː
valdís	v a l t iː s
atorka	aː t ɔ r̥ k a
klettasalat	kʰ l ɛ h t a s aː l a t
hlér	l̥ j ɛː r
njálgur	n j a u l k ʏ r
hebreska	h ɛː p r ɛ s k a
fagurfífill	f aː ɣ ʏ r f iː v ɪ t l
limgerði	l ɪ m c ɛ r ð ɪ
almennilegur	a l m ɛ nː ɪ l ɛː ɣ ʏ r
haarde	h ɔ r t ɛː
þekking	θ ɛ h c i ŋ k
steinselja	s t e i n s ɛ l j a
dansa	t a n s a
vafsúra	v a v s uː r a
fúinn	f uː ɪ nː
flagg	f l a kː
hljóð	l̥ j o uː ð
frjóhnappur	f r j o uː n̥ a h p ʏ r
efnaskipti	ɛ p n a s c ɪ f t ɪ
láfi	l a uː v ɪ
fjórðungur	f j o u r ð u ŋ k ʏ r
ananas	aː n aː n a s
blómsef	p l o u m s ɛː v
jötunuxi	j œː tʰ ʏ n ʏ x s ɪ
fjallagrös	f j a t l a k r œː s
ostakaka	ɔ s t a kʰ aː k a
minnisgóður	m ɪ nː ɪ s k o uː ð ʏ r
skyn	s c ɪː n
héðan	ç ɛː ð a n
byrstur	p ɪ r̥ s t ʏ r
ata	aː t a
mulningur	m ʏ l n i ŋ k ʏ r
skítugur	s c iː t ʏː ɣ ʏ r
litningsendi	l ɪ h t n i ŋ k s ɛ n t ɪ
stjörnuspekingur	s t j œ r t n ʏ s p ɛː c i ŋ k ʏ r
söðull	s œː ð ʏ t l
birgir	p ɪ r c ɪ r
barbari	p a r p aː r ɪ
píla	pʰ iː l a
más	m a uː s
örvun	œ r v ʏ n
viðar	v ɪː ð aː r
kremja	kʰ r ɛ m j a
hreindýr	r̥ e i n t iː r
hjáguð	ç a u k v ʏː ð
leikmynd	l e iː k m ɪ n t
heita	h e iː t a
funa	f ʏː n a
hattari	h a h t aː r ɪ
prússneskur	pʰ r u sː t n ɛ s k ʏ r
lífsspursmál	l i f s s p ʏ r̥ s m a uː l
frakki	f r a h c ɪ
bókfinka	p o uː k f i ŋ̊ k a
jarðskjálfti	j a r ð s c a u l̥ t ɪ
snepill	s t n ɛː p ɪ t l
bæla	p a iː l a
nippill	n ɪ h p ɪ t l
handsnyrting	h a n t s t n ɪ r̥ t i ŋ k
slímugur	s t l iː m ʏː ɣ ʏ r
sæmundína	s a iː m ʏ n t iː n a
eftirmáli	ɛ f t ɪ r m a uː l ɪ
gráhvalur	k r a uː kʰ v aː l ʏ r
tölvuleikur	tʰ œ l v ʏ l e iː k ʏ r
rauðgreni	r ø y ð k r ɛː n ɪ
gal	k aː l
tyrkland	t ɪ r̥ k l a n t
agalega	aː ɣ a l ɛː ɣ a
bragliður	p r a ɣ l ɪː ð ʏ r
handfylli	h a n t f ɪ t l ɪ
taugakerfi	tʰ ø yː ɣ a cʰ ɛ r v ɪ
hnappstör	n̥ a h p s t œː r
nía	n iː j a
geimferð	c e i m f ɛ r ð
óþægindi	o uː θ a iː j ɪ n t ɪ
blaðra	p l a ð r a
hana	h aː n a
aðalbygging	aː ð a l p ɪ cː i ŋ k
sin	s ɪː n
góa	k o uː a
vökva	v œː k v a
ætiþistill	a iː t ɪ θ ɪ s t ɪ t l
snarka	s n a r̥ k a
norn	n ɔ r t n
fylking	f ɪ l̥ c i ŋ k
gunndís	k ʏ nː t iː s
bjartsýni	p j a r̥ t s iː n ɪ
hross	r̥ ɔ sː
far	f aː r
mót	m o uː t
iðunn	ɪː ð ʏ nː
hnupla	n̥ ʏ h p l a
djúp	t j uː p
hjörtína	ç œ r̥ t iː n a
freisting	f r e i s t i ŋ k
snóker	s t n o uː k ɛ r
kort	kʰ ɔ r̥ t
kollhnís	kʰ ɔ t l n̥ iː s
geiri	c e iː r ɪ
apa	aː p a
lesandi	l ɛː s a n t ɪ
gráta	k r a uː t a
reigja	r e iː j a
eiginhandaráritun	e iː j ɪ n h a n t a r a uː r ɪː t ʏ n
sinni	s ɪ nː ɪ
hjálp	ç a u l̥ p
blekking	p l ɛ h k i ŋ k
ansa	a n s a
biðminni	p ɪ ð m ɪ nː ɪ
árósar	a uː r o uː s a r
fallbyssa	f a t l p ɪ sː a
afrískur	aː f r i s k ʏ r
greining	k r e iː n i ŋ k
svigna	s v ɪ k n a
kosta	kʰ ɔ s t a
dýrafræði	t iː r a f r a iː ð ɪ
hlána	l̥ a uː n a
dreifing	t r e iː v i ŋ k
séní	s j ɛː n iː
glæða	k l a iː ð a
þórshöfn	θ o u r̥ s h œ p n
hrópa	r̥ o uː p a
hnakkur	n̥ a h k ʏ r
fluga	f l ʏː ɣ a
dugleysi	t ʏ ɣ l e iː s ɪ
þjóðverji	θ j o u ð v ɛ r j ɪ
tröllaukinn	tʰ r œ t l ø yː c ɪ n
zoëga	s o uː ɛː k aː
slitur	s t l ɪː t ʏ r
ristill	r ɪ s t ɪ t l
efi	ɛː v ɪ
rakvél	r aː k v j ɛː l
veifa	v e iː v a
þjónustustúlka	θ j o uː n ʏ s t ʏ s t u l̥ k a
sippuband	s ɪ h p ʏ p a n t
ferill	f ɛː r ɪ t l
staðhæfa	s t a ð h a iː v a
bassetthorn	p a sː ɛ h t h ɔ r t n
höfuðverkur	h œː v ʏ ð v ɛ r̥ k ʏ r
gjóla	c o uː l a
júdea	j uː t ɛː a
hreppur	r̥ ɛ h p ʏ r
þrándheimur	θ r a u n t h e iː m ʏ r
burstajafni	p ʏ r̥ s t a j a p n ɪ
arabískur	aː r a p i s k ʏ r
lauga	l ø yː ɣ a
rafgas	r a v k aː s
heimsmethafi	h e i m s m ɛː t h aː v ɪ
hjólbörur	ç o uː l p œː r ʏ r
ávarpa	a uː v a r̥ p a
dynja	t ɪ n j a
svarthol	s v a r̥ t h ɔː l
greip	k r e iː p
grunnsævi	k r ʏ nː s a iː v ɪ
spegill	s p e iː j ɪ t l
atviksorð	aː t v ɪ k s ɔ r ð
svæla	s v a iː l a
prýði	pʰ r iː ð ɪ
spendýr	s p ɛ n t iː r
ölgerðarhús	œ l c ɛ r ð a r h uː s
happdrætti	h a h p t r a i h t ɪ
krossfeldi	kʰ r ɔ sː f ɛ l t ɪ
sæbjúga	s a iː p j uː a
prestastefna	pʰ r ɛ s t a s t ɛ p n a
stjarna	s t j a r t n a
rosti	r ɔ s t ɪ
dýrgripur	t i r k r ɪː p ʏ r
lélegur	l j ɛː l ɛː ɣ ʏ r
dalía	t aː l iː j a
luma	l ʏː m a
ending	ɛ n t i ŋ k
garðakornblóm	k a r ð a kʰ ɔ r t n p l o uː m
rifsber	r ɪ f s p ɛː r
rif	r ɪː v
raust	r ø y s t
þel	θ ɛː l
hjalli	ç a t l ɪ
dráttarvél	t r a u h t a r v j ɛː l
kiðlingur	cʰ ɪ ð l i ŋ k ʏ r
heiðingi	h e iː ð i ɲ c ɪ
næði	n a iː ð ɪ
afsökun	a f s œː k ʏ n
dökkvíðir	t œ h k v iː ð ɪ r
pönkari	pʰ ø y ŋ̊ k aː r ɪ
geð	c ɛː ð
drama	t r aː m a
jóndís	j o u n t iː s
engi	e i ɲ c ɪ
náða	n a uː ð a
óákveðinn	o uː a uː kʰ v ɛː ð ɪ nː
láta	l a uː t a
kræla	kʰ r a iː l a
edrú	ɛː t r uː
trega	tʰ r ɛː ɣ a
leggur	l ɛ kː ʏ r
gedda	k ɛ tː a
vinalegur	v ɪː n a l ɛː ɣ ʏ r
flatbaka	f l a t p aː k a
rennibraut	r ɛ nː ɪ p r ø yː t
pólskur	pʰ o u l s k ʏ r
smjatt	s m j a h t
kona	kʰ ɔː n a
toppur	tʰ ɔ h p ʏ r
skermur	s c ɛ r m ʏ r
indriðína	ɪ n t r ɪː ð iː n a
mótgerð	m o uː t c ɛ r ð
hugmynd	h ʏ ɣ m ɪ n t
nepal	n ɛː pʰ aː l
flautuleikari	f l ø yː t ʏ l e iː k aː r ɪ
hrókur	r̥ o uː k ʏ r
sverrir	s v ɛ rː ɪ r
sköddun	s k œ tː ʏ n
skvetta	s k v ɛ h t a
káka	kʰ a uː k a
norðdahl	n ɔ r ð t aː l
dimma	t ɪ mː a
leigubíll	l e iː ɣ ʏ p i t l
lykja	l ɪː c a
iðulega	ɪː ð ʏ l ɛː ɣ a
diskur	t ɪ s k ʏ r
skynjun	s c ɪ n j ʏ n
arabía	aː r a p iː j a
pamfíll	pʰ a m f i t l
djús	t j uː s
aðgætni	a ð c a i h t n ɪ
mólýbden	m o uː l i p t ɛː n
karst	kʰ a r̥ s t
skran	s k r aː n
rell	r ɛ t l
hólmganga	h o u l m k a u ŋ k a
þig	θ ɪː ɣ
aukaspyrna	ø yː k a s p ɪ r t n a
rör	r œː r
stæla	s t a iː l a
hrekkur	r̥ ɛ h k ʏ r
grenja	k r ɛ n j a
hrappur	r̥ a h p ʏ r
hráolía	r̥ a uː ɔː l i j a
retta	r ɛ h t a
jarðarför	j a r ð a r f œː r
agn	a k n
kjarni	cʰ a r t n ɪ
fuglafræði	f ʏ k l a f r a iː ð ɪ
gangbraut	k a u ŋ k p r ø yː t
rykkur	r ɪ h k ʏ r
fern	f ɛ r t n
blása	p l a uː s a
vinstur	v ɪ n s t ʏ r
áfall	a uː f a t l
framkvæma	f r a m kʰ v a iː m a
andstyggilega	a n t s t ɪ cː ɪ l ɛː ɣ a
krabbamein	kʰ r a pː a m e iː n
tal	tʰ aː l
kusa	kʰ ʏː s a
írland	i r l a n t
indverskur	ɪ n t v ɛ r̥ s k ʏ r
eggjárn	ɛ kː j a u r t n
röskun	r œ s k ʏ n
hefndarþorsti	h ɛ m t a r θ ɔ r̥ s t ɪ
klauf	kʰ l ø yː v
mánajurt	m a uː n a j ʏ r̥ t
hóta	h o uː t a
graslendi	k r aː s l ɛ n t ɪ
flaka	f l aː k a
kufl	kʰ ʏ p l
hefð	h ɛ v ð
hjólhýsi	ç o u l h iː s ɪ
frímerkjasafnari	f r iː m ɛ r̥ c a s a p n aː r ɪ
tíra	tʰ iː r a
spaug	s p ø yː ɣ
höfði	h œ v ð ɪ
akurarfi	aː k ʏ r a r v ɪ
strákur	s t r a uː k ʏ r
própan	pʰ r o uː pʰ a n
læra	l a iː r a
meðfram	m ɛ ð f r aː m
grund	k r ʏ n t
sýkill	s iː c ɪ t l
félag	f j ɛː l aː ɣ
grannur	k r a nː ʏ r
semja	s ɛ m j a
vígja	v iː j a
fappa	f a h p a
tjarnastör	tʰ j a r t n a s t œː r
streða	s t r ɛː ð a
harpa	h a r̥ p a
götun	k œː t ʏ n
fagurfræði	f aː ɣ ʏ r f r a iː ð ɪ
metta	m ɛ h t a
hæsi	h a iː s ɪ
pípa	pʰ iː p a
bergmann	p ɛ r k m a nː
bíldrusla	p i l t r ʏ s t l a
ábendingarfornafn	a uː p ɛ n t i ŋ k a r f ɔ r n a p n
kúlulega	kʰ uː l ʏ l ɛː ɣ a
funda	f ʏ n t a
alin	aː l ɪ n
rápa	r a uː p a
blómavasi	p l o uː m a v aː s ɪ
klak	kʰ l aː k
sofi	s ɔː v ɪ
guðlegur	k v ʏ ð l ɛː ɣ ʏ r
faðirvor	f aː ð ɪ r v ɔː r
ketill	cʰ ɛː t ɪ t l
nafar	n aː v a r
lífeðlisfræði	l iː v ɛ ð l ɪ s f r a iː ð ɪ
frétt	f r j ɛ h t
pepperóní	pʰ ɛ h p ɛ r o uː n iː
prentsmiðja	pʰ r ɛ n̥ t s m ɪ ð j a
lystarstol	l ɪ s t a r s t ɔː l
bruni	p r ʏː n ɪ
nískur	n i s k ʏ r
blá	p l a uː
pokabjörn	pʰ ɔː k a p j œ r t n
keila	cʰ e iː l a
svefnpoki	s v ɛ p n pʰ ɔː c ɪ
beygla	p e i k l a
kvittur	kʰ v ɪ h t ʏ r
óskhyggja	o u s k h ɪ cː a
hlera	l̥ ɛː r a
reitur	r e iː t ʏ r
skrímsli	s k r i m s t l ɪ
skjóta	s c o uː t a
deiling	t e iː l i ŋ k
lamb	l a m p
hróný	r̥ o uː n iː
ríbónúkleasi	r iː p o uː n uː kʰ l ɛː aː s ɪ
bergsóley	p ɛ r k s o uː l e iː
ljótunn	l j o uː t ʏ nː
saddur	s a tː ʏ r
endastöð	ɛ n t a s t œː ð
upp	ʏ h p
lund	l ʏ n t
baun	p ø yː n
vein	v e iː n
stæði	s t a iː ð ɪ
hrossakjöt	r̥ ɔ sː a cʰ œː t
víf	v iː v
jurt	j ʏ r̥ t
góla	k o uː l a
milljónamæringur	m ɪ l j o uː n a m a iː r i ŋ k ʏ r
jarðfræði	j a r ð f r a iː ð ɪ
vestra	v ɛ s t r a
vinda	v ɪ n t a
svíi	s v iː ɪ
skáti	s k a uː t ɪ
reið	r e iː ð
verja	v ɛ r j a
hemill	h ɛː m ɪ t l
andfélagslegur	a n t f j ɛː l a x s l ɛː ɣ ʏ r
prófessor	pʰ r o uː f ɛ sː ɔ r
eplatré	ɛ h p l a t r j ɛː
samför	s a m f œː r
fingurbjörg	f i ŋ k ʏ r p j œ r k
lagni	l a k n ɪ
varnaður	v a r t n aː ð ʏ r
jafntefli	j a p n tʰ ɛ p l ɪ
kelta	cʰ ɛ l̥ t a
bakki	p a h c ɪ
glitfífill	k l ɪː t f iː v ɪ t l
gestur	c ɛ s t ʏ r
reynsla	r e i n s t l a
níðingur	n iː ð i ŋ k ʏ r
liggja	l ɪ cː a
flundra	f l ʏ n t r a
hleifur	l̥ e iː v ʏ r
mæðraveldi	m a i ð r a v ɛ l t ɪ
ráð	r a uː ð
alræði	a l r a iː ð ɪ
trélitur	tʰ r j ɛː l ɪː t ʏ r
bláhrafn	p l a uː r̥ a p n
blámaður	p l a uː m aː ð ʏ r
niðurlægja	n ɪː ð ʏ r l a iː j a
sótthreinsa	s o u h t r̥ e i n s a
greipaldin	k r e iː p a l t ɪ n
hvítmaðra	kʰ v iː t m a ð r a
afgangur	a v k a u ŋ k ʏ r
löngun	l ø y ŋ k ʏ n
stinga	s t i ŋ k a
saffran	s a fː r a n
bambus	p a m p ʏ s
kennaratyggjó	cʰ ɛ nː aː r a tʰ ɪ cː o uː
tyrkjasól	tʰ ɪ r̥ c a s o uː l
kapall	kʰ aː p a t l
riðla	r ɪ ð l a
hopp	h ɔ h p
hlutverk	l̥ ʏː t v ɛ r̥ k
hefill	h ɛː v ɪ t l
kirkja	cʰ ɪ r̥ c a
kaf	kʰ aː v
peyi	pʰ e iː j ɪ
anda	a n t a
sjóður	s j o uː ð ʏ r
biðlari	p ɪ ð l aː r ɪ
varmur	v a r m ʏ r
samhaldssamur	s a m h a l t s s aː m ʏ r
taut	tʰ ø yː t
frumbyggi	f r ʏ m p ɪ cː ɪ
okkarína	ɔ h k a r iː n a
sagnorð	s a k n ɔ r ð
æstur	a i s t ʏ r
knall	kʰ n a lː
svipur	s v ɪː p ʏ r
greiðsla	k r e i ð s t l a
gerjun	c ɛ r j ʏ n
líkur	l iː k ʏ r
frú	f r uː
brennisóley	p r ɛ nː ɪ s o uː l e iː
fíkinn	f iː c ɪ nː
nafnháttur	n a p n h a u h t ʏ r
erítrea	ɛː r iː tʰ r ɛː a
njáll	n j a u t l
óvinátta	o uː v ɪː n a u h t a
guðrún	k v ʏ ð r uː n
hreyta	r̥ e iː t a
kukl	kʰ ʏ h k l
kindugur	cʰ ɪ n t ʏː ɣ ʏ r
jarðhiti	j a r ð h ɪː t ɪ
meðvitaður	m ɛ ð v ɪː t aː ð ʏ r
hjú	ç uː
kúlupenni	kʰ uː l ʏ pʰ ɛ nː ɪ
sirkus	s ɪ r̥ k ʏ s
nothæfur	n ɔː t h a iː v ʏ r
nemi	n ɛː m ɪ
erfiði	ɛ r v ɪː ð ɪ
ferðaáætlun	f ɛ r ð a a uː a i h t l ʏ n
þyrla	θ ɪ r t l a
jarðsprengja	j a r ð s p r e i ɲ c a
sköp	s k œː p
naggrís	n a ɣ k r iː s
nytsamur	n ɪː t s aː m ʏ r
aðalból	aː ð a l p o uː l
fiðrildi	f ɪ ð r ɪ l t ɪ
polli	pʰ ɔ lː ɪ
dóná	t o uː n a uː
frilla	f r ɪ t l a
þrymskviða	θ r ɪ m s kʰ v ɪː ð a
tæma	tʰ a iː m a
farmiði	f a r m ɪː ð ɪ
hvatberi	kʰ v a t p ɛː r ɪ
flærð	f l a i r ð
rúmföt	r u m f œː t
tón	tʰ o uː n
kenning	cʰ ɛ nː i ŋ k
skriðnablóm	s k r ɪ ð n a p l o uː m
brynjólfur	p r ɪ n j o u l v ʏ r
markaður	m a r̥ k a ð ʏ r
kynni	cʰ ɪ nː ɪ
bú	p uː
gunnarína	k ʏ nː aː r iː n a
hluti	l̥ ʏː t ɪ
vagga	v a kː a
skíma	s c iː m a
feykja	f e iː c a
þvæla	θ v a iː l a
ferstrendingur	f ɛ r̥ s t r ɛ n t i ŋ k ʏ r
slanga	s t l a u ŋ k a
kjartan	cʰ a r̥ t a n
botnlangaskurður	p ɔ h t n l a u ŋ k a s k ʏ r ð ʏ r
krossgáta	kʰ r ɔ sː k a uː t a
brjóst	p r j o u s t
teikna	tʰ e i h k n a
niðurstaða	n ɪː ð ʏ r s t aː ð a
möppudýr	m œ h p ʏ t iː r
áræði	a uː r a iː ð ɪ
bræðsla	p r a i ð s t l a
afbrot	a v p r ɔː t
atkvæði	aː t kʰ v a iː ð ɪ
fótboltafélag	f o uː t p ɔ l̥ t a f j ɛː l aː ɣ
öryggisbrestur	œː r ɪ cː ɪ s b r ɛ s t ʏ r
lágmark	l a u ɣ m a r̥ k
thoroddsen	tʰ o uː r ɔ tː s ɛ nː
dugnaður	t ʏ ɣ n aː ð ʏ r
volga	v ɔ l k a
fitfugl	f ɪ t f ʏ k l
slúta	s t l uː t a
hóra	h o uː r a
borgarstjóri	p ɔ r k a r s t j o uː r ɪ
hróðný	r̥ o u ð n iː
búðareigandi	p uː ð a r e iː ɣ a n t ɪ
hlíðaburkni	l̥ iː ð a p ʏ r̥ k n ɪ
aðsókn	a ð s o u h k n
fita	f ɪː t a
pedall	pʰ ɛː t a t l
gat	k aː t
hækka	h a i h k a
hliðarlína	l̥ ɪː ð a r l iː n a
vistvænn	v ɪ s t v a i t n
vís	v iː s
mikki	m ɪ h c ɪ
melding	m ɛ l t i ŋ k
sortna	s ɔ r̥ t n a
kolsýra	kʰ ɔ l s iː r a
port	pʰ ɔ r̥ t
ástaróbó	a u s t a r o uː p o uː
henda	h ɛ n t a
gjarn	c a r t n
oddviti	ɔ tː v ɪ t ɪ
ræðinn	r a iː ð ɪ n
sumar	s ʏː m aː r
svaf	s v aː v
gunnlaug	k ʏ nː l ø yː ɣ
úlfur	u l v ʏ r
egna	ɛ k n a
mjöl	m j œː l
hæfni	h a i p n ɪ
víma	v iː m a
kæla	cʰ a iː l a
meingjörð	m e i n c œ r ð
hvína	xʷ iː n a
þumalína	θ ʏː m aː l iː n a
brauðmoli	p r ø y ð m ɔː l ɪ
smakka	s m a h k a
sónatína	s o uː n a tʰ iː n a
átti	a u h t ɪ
mala	m aː l a
mannvirðing	m a nː v ɪ r ð i ŋ k
klumpur	kʰ l ʏ m̥ p ʏ r
dósent	t o uː s ɛ n t
júdit	j uː t ɪː t
tágamura	tʰ a uː ɣ a m ʏː r a
seyði	s e iː ð ɪ
stjarneðlisfræði	s t j a r t n ɛ ð l ɪ s f r a iː ð ɪ
vináttuleikur	v ɪː n a u h t ʏ l e iː k ʏ r
heimboð	h e i m p ɔː ð
músvákur	m uː s v a uː k ʏ r
fosfór	f ɔ s f o uː r
steikarhnífur	s t e iː k a r n̥ iː v ʏ r
krikket	kʰ r ɪ h c ɛ t
klúður	kʰ l uː ð ʏ r
fjallavíðir	f j a t l a v iː ð ɪ r
sveifla	s v e i p l a
baðkar	p a ð kʰ aː r
franska	f r a n s k a
vinka	v i ŋ̊ k a
átthyrningur	a u h t h ɪ r t n i ŋ k ʏ r
seyta	s e iː t a
sprunga	s p r u ŋ k a
ferhyrningur	f ɛ r h ɪ r t n i ŋ k ʏ r
skriðlíngresi	s k r ɪ ð l i n k r ɛː s ɪ
ríkisborgari	r iː c ɪ s p ɔ r k a r ɪ
gæfur	c a iː v ʏ r
meyjarhaft	m e iː j a r h a f t
auðmýkt	ø y ð m i x t
trefjasóley	tʰ r ɛ v j a s o uː l e iː
stak	s t aː k
kaðlín	kʰ a ð l iː n
viðskiptavinur	v ɪ ð s k ɪ f t a v ɪː n ʏ r
hrafnaklukka	r̥ a p n a kʰ l ʏ h k a
júkki	j u h c ɪ
eignarhaldsfélag	e i k n a r h a l t s f j ɛː l aː ɣ
dökkhæra	t œ h k h a iː r a
tónn	tʰ o u t n
barátta	p aː r a u h t a
orðhlutafræði	ɔ r ð l̥ ʏː t a f r a iː ð ɪ
dósahnífur	t o uː s a n̥ iː v ʏ r
depill	t ɛː p ɪ t l
ellefu	ɛ t l ɛ v ʏ
bókastoð	p o uː k a s t ɔː ð
beitilyng	p e iː t ɪ l i ŋ k
kjörfursti	cʰ œ r̥ f ʏ r̥ s t ɪ
ræfill	r a iː v ɪ t l
birgja	p ɪ r c a
níl	n iː l
hjúkra	ç uː k r a
lepja	l ɛː p j a
fastmæli	f a s t m a iː l ɪ
tindur	tʰ ɪ n t ʏ r
massi	m a sː ɪ
sver	s v ɛː r
gagnrýni	k a k n r iː n ɪ
baðmullarsvunta	p a ð m ʏ t l a r s v ʏ n̥ t a
depla	t ɛ h p l a
alvörulaus	a l v œː r ʏ l ø yː s
kjöt	kʰ j œː t
nafnfræði	n a p n f r a iː ð ɪ
rafgeymir	r a v c e iː m ɪ r
nýlega	n iː l ɛː ɣ a
hné	n̥ j ɛː
blágresi	p l a uː k r ɛː s ɪ
basi	p aː s ɪ
hreindýrakjöt	r̥ e i n t iː r a cʰ œː t
breytni	p r e i h t n ɪ
orðfræði	ɔ r ð f r a iː ð ɪ
hlunkur	l̥ u ŋ̊ k ʏ r
stirðna	s t ɪ r t n a
dramb	t r a m p
hnykkur	n̥ ɪ h k ʏ r
útlönd	uː t l œ n t
blóðfrumnamyndun	p l o u ð f r ʏ m n a m ɪ n t ʏ n
rannsóknarstofa	r a nː s o u h k n a r s t ɔː v a
flækja	f l a iː c a
standpína	s t a n t pʰ iː n a
hurð	h ʏ r ð
pexa	pʰ ɛ x s a
árdís	a u r t iː s
hvirfilbylur	kʰ v ɪ r v ɪ l p ɪː l ʏ r
smjörlauf	s m j œ r l ø yː v
eiður	e iː ð ʏ r
springa	s p r i ŋ k a
pottur	pʰ ɔ h t ʏ r
yllir	ɪ t l ɪ r
riddari	r ɪ tː a r ɪ
kynfruma	c ɪ n f r ʏː m a
kína	cʰ iː n a
lána	l a uː n a
stærð	s t a i r ð
syrta	s ɪ r̥ t a
hetta	h ɛ h t a
nár	n a uː r
kólesteról	kʰ o uː l ɛ s t ɛ r o uː l
votur	v ɔː t ʏ r
persía	pʰ ɛ r̥ s iː j a
samkeppni	s a m cʰ ɛ h p n ɪ
körfuboltaþjálfari	kʰ œ r v ʏ p ɔ l̥ t a θ j a u l v a r ɪ
ásþrúður	a uː s θ r uː ð ʏ r
altari	a l̥ t a r ɪ
múta	m uː t a
helluhnoðri	h ɛ t l ʏ n̥ ɔ ð r ɪ
hrasa	r̥ aː s a
saumur	s ø yː m ʏ r
forneskja	f ɔ r t n ɛ s c a
bank	p a u ŋ̊ k
regla	r ɛ k l a
hrafn	r̥ a p n
kafald	kʰ aː v a l t
kviðslit	kʰ v ɪ ð s t l ɪː t
orð	ɔ r ð
söngvari	s ø y ŋ k v aː r ɪ
kroppur	kʰ r ɔ h p ʏ r
fell	f ɛ t l
sveinn	s v e i t n
sérstaklega	s j ɛ r̥ s t aː k l ɛː ɣ a
jaki	j aː c ɪ
afríkufíll	aː f r iː k ʏ f i t l
dós	t o uː s
efli	ɛ p l ɪ
farteski	f a r̥ tʰ ɛ s c ɪ
jór	j o uː r
serbókróatíska	s ɛ r p o u kʰ r o uː a tʰ i s k a
vefja	v ɛ v j a
blíða	p l iː ð a
gráölur	k r a uː œː l ʏ r
forsíða	f ɔ r̥ s iː ð a
greindur	k r e i n t ʏ r
dagrenning	t a ɣ r ɛ nː i ŋ k
hola	h ɔː l a
valmynd	v a l m ɪ n t
kaldhæðni	kʰ a l t h a i ð n ɪ
nauðgari	n ø y ð k aː r ɪ
edinborg	ɛː t ɪ n p ɔ r k
aðeins	aː ð e i n s
loðna	l ɔ ð n a
lækjagrýta	l a iː c a k r iː t a
tuldur	tʰ ʏ l t ʏ r
órans	o uː r a n s
sláttur	s t l a u h t ʏ r
öryggisfyrirtæki	œː r ɪ cː ɪ s f ɪː r ɪ r tʰ a iː c ɪ
torveldur	tʰ ɔ r v ɛ l t ʏ r
raðtala	r a ð tʰ aː l a
ómþýður	o u m θ iː ð ʏ r
laus	l ø yː s
puða	pʰ ʏː ð a
andlit	a n t l ɪː t
dverglilja	t v ɛ r k l ɪ l j a
sviði	s v ɪː ð ɪ
dreifa	t r e iː v a
kvöldverður	kʰ v œ l t v ɛ r ð ʏ r
doðrantur	t ɔ ð r a n̥ t ʏ r
dynkur	t i ŋ̊ k ʏ r
miðjumaður	m ɪ ð j ʏ m aː ð ʏ r
peli	pʰ ɛː l ɪ
sellerí	s ɛ lː ɛː r iː
beinn	p e i t n
hnjúkur	n̥ j uː k ʏ r
flikki	f l ɪ h c ɪ
rigna	r ɪ k n a
hóll	h o u t l
bretti	p r ɛ h t ɪ
byssukúla	p ɪ sː ʏ kʰ uː l a
foringi	f ɔː r i ɲ c ɪ
stærðfræði	s t a i r ð f r a iː ð ɪ
blágrænn	p l a uː k r a i t n
íkorni	iː kʰ ɔ r t n ɪ
tía	tʰ iː j a
narta	n a r̥ t a
skræfa	s k r a iː v a
vísifingur	v iː s ɪ f i ŋ k ʏ r
malbik	m a l p ɪː k
nepja	n ɛː p j a
halda	h a l t a
kelda	cʰ ɛ l t a
skýla	s c iː l a
jólagjöf	j o uː l a c œː v
minnka	m i ŋ̊ k a
torvelda	tʰ ɔ r v ɛ l t a
kjalta	cʰ a l̥ t a
prúður	pʰ r uː ð ʏ r
kal	kʰ aː l
flýja	f l iː j a
hilling	h ɪ t l i ŋ k
nagli	n a k l ɪ
símaskrá	s iː m a s k r a uː
tína	tʰ iː n a
strangi	s t r a u ɲ c ɪ
jarðvegur	j a r ð v ɛː ɣ ʏ r
gáski	k a u s c ɪ
kristjana	k r ɪ s t j aː n a
hreindís	r̥ e i n t iː s
ásýnd	a uː s i n t
frystir	f r ɪ s t ɪ r
kopar	kʰ ɔː p a r
tilraun	t ɪ l r ø yː n
tagga	tʰ a kː a
svengd	s v e i ŋ t
skála	s k a uː l a
tæfa	tʰ a iː v a
hlébarði	l̥ ɛː p a r ð ɪ
sáð	s a uː ð
skýrsla	s c i r̥ s t l a
nafli	n a p l ɪ
gunnólfur	k ʏ nː o u l v ʏ r
pára	pʰ a uː r a
lakka	l a h k a
bastarður	p a s t a r ð ʏ r
tara	tʰ aː r a
inngangur	ɪ nː k a u ŋ k ʏ r
fabúla	f aː p uː l a
raka	r aː k a
risi	r ɪː s ɪ
þynna	θ ɪ nː a
eggleg	ɛ kː l ɛː ɣ
sakna	s a h k n a
ból	p o uː l
helsingi	h ɛ l s i ɲ c ɪ
samsæta	s a m s a iː t a
rönd	r œ n t
braggi	p r a cː ɪ
djúprista	t j uː p r ɪ s t a
tugabrot	tʰ ʏː ɣ a p r ɔː t
ari	aː r ɪ
steðji	s t ɛ ð j ɪ
kyrrseta	cʰ ɪ r s ɛː t a
ferningur	f ɛ r t n i ŋ k ʏ r
framhaldsskóli	f r a m h a l s s k o uː l ɪ
kaggi	kʰ a cː ɪ
barr	p a rː
lotning	l ɔ h t n i ŋ k
mosi	m ɔː s ɪ
kærasti	cʰ a iː r a s t ɪ
hvalkjöt	xʷ a l cʰ œː t
bjúgstör	p j u ɣ s t œː r
norræna	n ɔ r r a iː n a
lilja	l ɪ l j a
votlendi	v ɔː t l ɛ n d ɪ
tyrkneskur	tʰ ɪ r̥ k n ɛ s k ʏ r
fellafífill	f ɛ t l a f iː v ɪ t l
kóngur	kʰ o u ŋ k ʏ r
bæklingur	p a i h k l i ŋ k ʏ r
aðgangur	a ð k a u ŋ k ʏ r
naut	n ø yː t
kviður	kʰ v ɪː ð ʏ r
bólstraberg	p o u l s t r a p ɛ r k
fyrirgefning	f ɪː r ɪ r c ɛ p n i ŋ k
hrat	r̥ aː t
klósettpappír	kʰ l o uː s ɛ h t pʰ a h p iː r
kommi	kʰ ɔ mː ɪ
mynddiskur	m ɪ n t t ɪ s k ʏ r
mattur	m a h t ʏ r
reglugerð	r ɛ k l ʏ c ɛ r ð
tíu	t iː ʏ
maður	m aː ð ʏ r
fjötur	f j œː t ʏ r
reyr	r e iː r
ryðja	r ɪ ð j a
þökk	θ œ h k
trésmiður	tʰ r j ɛː s m ɪː ð ʏ r
dökkasef	t œ h k a s ɛː v
sútun	s uː t ʏ n
beinagrind	p e iː n a k r ɪ n t
kökkur	kʰ œ h k ʏ r
réttlæti	r j ɛ h t l a iː t ɪ
misjafn	m ɪː s j a p n
for	f ɔː r
þýður	θ iː ð ʏ r
púður	pʰ uː ð ʏ r
systir	s ɪ s t ɪ r
dæmi	t a iː m ɪ
rís	r iː s
stikla	s t ɪ h k l a
internet	ɪ n̥ t ɛ r n ɛː t
forsetningarliður	f ɔ r̥ s ɛ h t n i ŋ k a r l ɪː ð ʏ r
knútur	kʰ n uː t ʏ r
gjarna	c a r t n a
málfrelsi	m a u l f r ɛ l s ɪ
leikvöllur	l e iː k v œ t l ʏ r
fýla	f iː l a
armband	a r m p a n t
daðra	t a ð r a
skánn	s k a u t n
páskadagur	pʰ a u s k a t aː ɣ ʏ r
kvef	kʰ v ɛː v
prósenta	pʰ r o uː s ɛ n̥ t a
gerði	c ɛ r ð ɪ
strjáll	s t r j a u t l
fok	f ɔː k
kyrrþeyr	cʰ ɪ r θ e iː r
hávella	h a uː v ɛ t l a
fenómen	f ɛː n o uː m ɛː n
rófubein	r o uː v ʏ p e iː n
regndropi	r ɛ k n t r ɔː p ɪ
uppi	ʏ h p ɪ
hamur	h aː m ʏ r
hugleysingi	h ʏ ɣ l e iː s i ɲ c ɪ
kóríander	kʰ o uː r iː j a n t ɛː r
listmálari	l ɪ s t m a uː l a r ɪ
tæpur	tʰ a iː p ʏ r
hagl	h a k l
sinfónía	s ɪ n f o uː n iː j a
bóla	p o uː l a
blána	p l a uː n a
útvarp	uː t v a r̥ p
ráðning	r a u ð n i ŋ k
atlot	aː t l ɔː t
rella	r ɛ t l a
granda	k r a n t a
aldrei	a l t r e iː
stuðull	s t ʏː ð ʏ t l
snurða	s t n ʏ r ð a
rósmarín	r o uː s m a r iː n
agúrka	aː k u r̥ k a
gyðja	c ɪ ð j a
afturelding	a f t ʏ r ɛ l t i ŋ k
grímkell	k r i m cʰ ɛ t l
blessa	p l ɛ sː a
ameríka	aː m ɛː r iː k a
kirkjuendir	cʰ ɪ r̥ k j ʏ ɛ n t ɪ r
fornnorræna	f ɔ r t n n ɔ r r a iː n a
rægja	r a iː j a
karlfugl	kʰ a r t l f ʏ k l
púl	pʰ uː l
þyrnóttur	θ ɪ r t n o u h t ʏ r
ógn	o u k n
hamagangur	h aː m a k a u ŋ k ʏ r
kör	kʰ œː r
gestína	c ɛ s t iː n a
brengla	p r e i ŋ l a
síða	s iː ð a
fresta	f r ɛ s t a
kári	kʰ a uː r ɪ
tog	tʰ ɔː ɣ
hræsnari	r̥ a i s t n a r ɪ
kall	kʰ a t l
svigi	s v ɪː j ɪ
styrkleiki	s t ɪ r̥ k l e iː c ɪ
tjarga	tʰ j a r k a
stulta	s t ʏ l̥ t a
nútíð	n uː tʰ iː ð
dani	t aː n ɪ
íri	iː r ɪ
droll	t r ɔ t l
kjörbúð	cʰ œ r p uː ð
athygli	aː t h ɪ k l ɪ
liðsforingi	l ɪ ð s f ɔː r i ɲ c ɪ
frímannía	f r iː m a nː iː j a
skjal	s c aː l
poki	pʰ ɔː c ɪ
prins	pʰ r ɪ n s
gullkorn	k ʏ t l kʰ ɔ r t n
namibía	n aː m ɪ p iː j a
símonía	s iː m ɔː n iː j a
fjöldi	f j œ l t ɪ
má	m a uː
heyja	h e iː j a
hlýðinn	l̥ iː ð ɪ nː
vændi	v a i n d ɪ
teðja	tʰ ɛ ð j a
berg	p ɛ r k
gel	c ɛː l
hlíð	l̥ iː ð
fjarverufall	f j a r v ɛː r ʏ f a t l
gráelri	k r a uː ɛ l r ɪ
rýtingur	r iː t i ŋ k ʏ r
karrí	kʰ a rː iː
at	aː t
gervigreind	c ɛ r v ɪ k r e i n d
túnvingull	tʰ u n v i ŋ k ʏ t l
hreyfill	r̥ e iː v ɪ t l
ferna	f ɛ r t n a
rafali	r aː v aː l ɪ
vínviður	v i n v ɪː ð ʏ r
sífelldur	s iː f ɛ l t ʏ r
tigl	tʰ ɪ k l
klessa	kʰ l ɛ sː a
saxland	s a x s l a n t
ryðönd	r ɪː ð œ n t
kvenmaður	kʰ v ɛ n m aː ð ʏ r
laxerolía	l a x s ɛ r ɔː l i j a
skoppa	s k ɔ h p a
læknir	l a i h k n ɪ r
dingl	t i ŋ l
ljósmóðir	l j o uː s m o uː ð ɪ r
kviða	kʰ v ɪː ð a
gígja	c iː j a
stía	s t iː j a
slá	s t l a uː
fjáður	f j a uː ð ʏ r
hrúður	r̥ uː ð ʏ r
gefa	c ɛː v a
alda	a l t a
mæri	m a iː r ɪ
verðmæti	v ɛ r ð m a iː t ɪ
snurðulaus	s t n ʏ r ð ʏ l ø yː s
platónskur	pʰ l aː tʰ o u n s k ʏ r
sjúss	s j u sː
rökkur	r œ h k ʏ r
þrenning	θ r ɛ nː i ŋ k
þátttaka	θ a u h t tʰ aː k a
gjörla	c œ r t l a
lundi	l ʏ n t ɪ
eldur	ɛ l t ʏ r
rakna	r a h k n a
launahækkun	l ø yː n a h a i h k ʏ n
megn	m ɛ k n
kappi	kʰ a h p ɪ
durtur	t ʏ r̥ t ʏ r
korkur	kʰ ɔ r̥ k ʏ r
mistilteinn	m ɪ s t ɪ l tʰ e i t n
strútur	s t r uː t ʏ r
les	l ɛː s
þórduna	θ o u r t ʏː n a
félagaskiptagluggi	f j ɛː l aː ɣ a s c ɪ f t a k l ʏ cː ɪ
ljósastör	l j o uː s a s t œː r
karlkyn	kʰ a r t l̥ cʰ ɪː n
heimskautanótt	h e i m s k ø yː t a n o u h t
tíkarsonur	tʰ iː k a r s ɔː n ʏ r
pardus	pʰ a r t ʏ s
flagasef	f l aː ɣ a s ɛː v
bindi	p ɪ n t ɪ
eiginkona	e iː j ɪ n kʰ ɔː n a
niðurlægjandi	n ɪː ð ʏ r l a iː j a n t ɪ
andlagsfall	a n t l a x s f a t l
háll	h a u t l
landráð	l a n t r a uː ð
lauslæti	l ø yː s l a iː t ɪ
herðablað	h ɛ r ð a p l aː ð
gervigras	c ɛ r v ɪ k r aː s
tjalli	tʰ j a lː ɪ
atarna	a tʰ a r t n a
þeir	θ e iː r
göngutúr	k ø y ŋ k ʏ tʰ uː r
krakkaskömm	kʰ r a h k a s k œ mː
grín	k r iː n
maðkur	m a θ k ʏ r
snjóa	s n j o uː a
málmey	m a u l m e iː
klórópren	kʰ l o uː r o uː pʰ r ɛː n
rak	r aː k
lyst	l ɪ s t
afturhaldsstefna	a f t ʏ r h a l t s s t ɛ p n a
sleikur	s t l e iː k ʏ r
þurrkur	θ ʏ r̥ k ʏ r
langnykra	l a u ŋ k n ɪː k r a
thorlacius	tʰ ɔ r l a s iː j ʏ s
möndull	m œ n t ʏ t l
ský	s c iː
sagnfylling	s a k n f ɪ t l i ŋ k
krossfari	kʰ r ɔ sː f aː r ɪ
kaupunautur	kʰ ø yː p ʏ n ø yː t ʏ r
karta	kʰ a r̥ t a
leir	l e iː r
skítur	s c iː t ʏ r
áki	a uː c ɪ
seiður	s e iː ð ʏ r
útgáfa	uː t k a uː v a
úkraína	uː kʰ r aː iː n a
geislamaðra	c e i s t l a m a ð r a
pungbindi	pʰ u ŋ k p ɪ n t ɪ
svengja	s v e i ɲ c a
mappa	m a h p a
reiður	r e iː ð ʏ r
mjólk	m j o u l̥ k
háfur	h a uː v ʏ r
siglutoppur	s ɪ k l ʏ tʰ ɔ h p ʏ r
leiði	l e iː ð ɪ
emja	ɛ m j a
sigmundína	s ɪ ɣ m ʏ n t iː n a
skelkur	s c ɛ l̥ k ʏ r
konungshöll	kʰ ɔː n u ŋ k s h œ t l
heiðarleiki	h e iː ð a r l e iː c ɪ
stilkur	s t ɪ l̥ k ʏ r
árna	a u r t n a
aðdáandi	a ð t a uː a n t ɪ
smjör	s m j œː r
jóhann	j o uː h a nː
snyrting	s t n ɪ r̥ t i ŋ k
akkeri	a h k ɛː r ɪ
hof	h ɔː v
plata	pʰ l aː t a
birki	p ɪ r̥ c ɪ
framleiða	f r a m l e iː ð a
rökkvi	r œ h k v ɪ
dill	t ɪ lː
sannfærandi	s a nː f a iː r a n t ɪ
naga	n aː ɣ a
meðan	m ɛː ð a n
athæfi	aː t h a iː v ɪ
skápur	s k a uː p ʏ r
snupra	s n ʏː p r a
þó	θ o uː
gildi	c ɪ l t ɪ
segulsvið	s ɛː ɣ ʏ l s v ɪː ð
slakur	s t l aː k ʏ r
vígvöllur	v i ɣ v œ t l ʏ r
herðar	h ɛ r ð a r
hnykkja	n̥ ɪ h c a
knattspyrnufélag	kʰ n a h t s p ɪ r t n ʏ f j ɛː l aː ɣ
búðarkassi	p uː ð a r kʰ a sː ɪ
heimild	h e iː m ɪ l t
skemmta	s c ɛ m̥ t a
leiðsögumaður	l e i ð s œː ɣ ʏ m aː ð ʏ r
prúðmenni	pʰ r u ð m ɛ nː ɪ
hakk	h a h k
ánægja	a uː n a iː j a
dvelja	t v ɛ l j a
etja	ɛː t j a
klæði	kʰ l a iː ð ɪ
drift	t r ɪ f t
buxnadragt	p ʏ x s n a t r a x t
þorbjörg	θ ɔ r p j œ r k
kínverska	cʰ i n v ɛ r̥ s k a
endurreisn	ɛ n t ʏ r r e i s t n
stofn	s t ɔ p n
stjörnufræði	s t j œ r t n ʏ f r a iː ð ɪ
dirfð	t ɪ r v ð
réttindi	r j ɛ h t ɪ n t ɪ
hvítblæði	xʷ iː t p l a iː ð ɪ
kolefni	kʰ ɔː l ɛ p n ɪ
gaffall	k a fː a t l
faðmur	f a ð m ʏ r
fimleikar	f ɪ m l e iː k a r
huggulegur	h ʏ kː ʏ l ɛː ɣ ʏ r
lakkrís	l a h k r iː s
pissa	pʰ ɪ sː a
almannatengsl	a l m a n n a tʰ e i ŋ k s t l
hvalveiði	kʰ v a l v e iː ð ɪ
kameldýr	kʰ aː m ɛ l t iː r
þykkja	θ ɪ h c a
sifjar	s ɪ v j a r
klóra	kʰ l o uː r a
tryggvína	tʰ r ɪ k v iː n a
jóhannes	j o uː h a nː ɛː s
börkur	p œ r̥ k ʏ r
innyfli	ɪ nː ɪ p l ɪ
skoskur	s k ɔ s k ʏ r
einvígi	e i n v iː j ɪ
ólöglegur	o uː l œ ɣ l ɛː ɣ ʏ r
gildur	c ɪ l t ʏ r
lautinant	l ø yː tʰ ɪ n a n̥ t
skutur	s k ʏː t ʏ r
þeytari	θ e iː t a r ɪ
góður	k o uː ð ʏ r
undanfarinn	ʏ n t a n f aː r ɪ nː
kristni	kʰ r ɪ s t n ɪ
glundur	k l ʏ n t ʏ r
perú	pʰ ɛː r uː
gervitunglamynd	c ɛ r v ɪ tʰ u ŋ l a m ɪ n t
ljós	l j o uː s
atvik	aː t v ɪː k
áfergja	a uː f ɛ r c a
lindasef	l ɪ n t a s ɛː v
ráða	r a uː ð a
bílskúr	p i l s k uː r
arnþrúður	a r t n θ r uː ð ʏ r
marmennill	m a r m ɛ nː ɪ t l
byggja	p ɪ cː a
gos	k ɔː s
fræðigrein	f r a iː ð ɪ k r e iː n
hvel	kʰ v ɛː l
laugaskarð	l ø yː ɣ a s k a r ð
stofnun	s t ɔ p n ʏ n
lind	l ɪ n t
brimill	p r ɪː m ɪ t l
munkur	m u ŋ̊ k ʏ r
bókrolla	p o uː k r ɔ t l a
lögga	l œ kː a
tokkata	tʰ ɔ h k aː t a
karp	kʰ a r̥ p
fet	f ɛː t
bensínstöð	p ɛ n s i n s t œː ð
forrita	f ɔ rː ɪː t a
millibil	m ɪ t l ɪ p ɪː l
föl	f œː l
lindifura	l ɪ n t ɪ f ʏː r a
þána	θ a uː n a
ótrúr	o uː t r uː r
gagnagrunnur	k a k n a k r ʏ nː ʏ r
stýrikerfi	s t iː r ɪ cʰ ɛ r v ɪ
dæma	t a iː m a
blóðmura	p l o u ð m ʏː r a
bókasafn	p o uː k a s a p n
smalamaður	s m aː l a m aː ð ʏ r
lútur	l uː t ʏ r
tólúen	tʰ o uː l uː ɛː n
hvap	kʰ v aː p
mysa	m ɪː s a
rödd	r œ tː
gamall	k aː m a t l
töluverður	tʰ œː l ʏ v ɛ r ð ʏ r
eplasafi	ɛ h p l a s aː v ɪ
mysuostur	m ɪː s ʏ ɔ s t ʏ r
hjúpa	ç uː p a
app	a h p
teskeið	tʰ ɛː s k e iː ð
gerill	c ɛː r ɪ t l
kónguló	kʰ o u ŋ k ʏ l o uː
greind	k r e i n t
meinafræði	m e iː n a f r a iː ð ɪ
blíður	p l iː ð ʏ r
svella	s v ɛ t l a
hagsæld	h a x s a i l t
elta	ɛ l̥ t a
snerra	s n ɛ rː a
sigmundur	s ɪ ɣ m ʏ n t ʏ r
manntal	m a nː tʰ aː l
hrotti	r̥ ɔ h t ɪ
kafli	kʰ a p l ɪ
sigg	s ɪ kː
þrábiðja	θ r a uː p ɪ ð j a
popp	pʰ ɔ h p
grameðla	k r aː m ɛ ð l a
greinir	k r e iː n ɪ r
niðjatal	n ɪ ð j a tʰ aː l
tvenna	tʰ v ɛ nː a
fjarstýring	f j a r̥ s t iː r i ŋ k
klóelfting	kʰ l o uː ɛ l̥ʷ t i ŋ k
kapítuli	kʰ aː p i tʰ ʏː l ɪ
vínberjalögur	v i n p ɛ r j a l œː ɣ ʏ r
hljóðeind	l̥ j o uː ð e i n t
klekkja	kʰ l ɛ h c a
hindra	h ɪ n t r a
orðaforði	ɔ r ð a f ɔ r ð ɪ
bang	p a u ŋ k
laukur	l ø yː k ʏ r
hjálparsagnorð	ç a u l̥ p a r s a k n ɔ r ð
anúbis	aː n uː p ɪ s
stál	s t a uː l
mænudeyfing	m a iː n ʏ t e iː v i ŋ k
mærð	m a i r ð
tíðka	tʰ i θ k a
tár	tʰ a uː r
plægja	pʰ l a iː j a
unnur	ʏ nː ʏ r
meðstjórnandi	m ɛ ð s t j o u r t n a n t ɪ
hræring	r̥ a iː r i ŋ k
brúða	p r uː ð a
damjan	t a m j a n
torfi	tʰ ɔ r v ɪ
fasani	f aː s aː n ɪ
makki	m a h c ɪ
salat	s aː l aː t
bóka	p o uː k a
sannleikur	s a nː l e iː k ʏ r
móðga	m o u ð k a
frísneskur	f r iː s n ɛ s k ʏ r
raula	r ø yː l a
túrmerik	tʰ u r m ɛː r ɪ k
hljóðfæri	l̥ j o u ð f a iː r ɪ
túnsúra	tʰ u n s uː r a
loki	l ɔː c ɪ
afríka	aː f r iː k a
organisti	ɔ r k a n ɪ s t ɪ
mýrastör	m iː r a s t œː r
spauga	s p ø yː ɣ a
mella	m ɛ t l a
morð	m ɔ r ð
gelta	c ɛ l̥ t a
hálfbróðir	h a u l v p r o uː ð ɪ r
bæjarstjóri	p a iː j a r s t j o uː r ɪ
þrunginn	θ r u ɲ c ɪ nː
mura	m ʏː r a
gifs	c ɪ f s
hörn	h œ r t n
tyrkneska	tʰ ɪ r̥ k n ɛ s k a
samvistarfall	s a m v ɪ s t a r f a t l
stigi	s t ɪ iː j ɪ
þorna	θ ɔ r t n a
deyða	t e iː ð a
diljá	t ɪ l j a uː
ufsi	ʏ f s ɪ
hneppi	n̥ ɛ h p ɪ
fornafn	f ɔ r n a p n
hamborg	h a m p ɔ r k
kyrja	cʰ ɪ r j a
grænlenska	k r a i n l ɛ n s k a
skila	s c ɪː l a
krakki	kʰ r a h c ɪ
geislabaugur	c e i s t l a p ø yː ɣ ʏ r
fága	f a uː a
vasaúr	v aː s a uː r
hlymja	l̥ ɪ m j a
barnagæla	p a r t n a c a iː l a
auðnutittlingur	ø y ð n ʏ tʰ ɪ h t l i ŋ k ʏ r
dýrð	t i r ð
rúta	r uː t a
kyn	cʰ ɪː n
mikið	m ɪː c ɪ ð
maskari	m a s k aː r i
friggjarlykill	f r ɪ cː a r l ɪː c ɪ t l
hjarðmaður	ç a r ð m aː ð ʏ r
kontrafagott	kʰ ɔ n̥ t r a f aː k ɔ h t
reim	r e iː m
blómstra	p l o u m s t r a
barþjónn	p a r θ j o u t n
þrefa	θ r ɛː v a
smetti	s m ɛ h t ɪ
sár	s a uː r
gáfa	k a uː v a
vínarborg	v iː n a r p ɔ r k
mí	m iː
glaumgosi	k l ø y m k ɔː s ɪ
markmaður	m a r̥ k m aː ð ʏ r
frelsingi	f r ɛ l s i ɲ c ɪ
lerki	l ɛ r̥ c ɪ
kussari	kʰ ʏ sː a r ɪ
þrugl	θ r ʏ k l
bjarki	p j a r̥ c ɪ
skotland	s k ɔː t l a n t
frækinn	f r a iː c ɪ nː
kvos	kʰ v ɔː s
belgía	p ɛ l c i j a
hrukka	r̥ ʏ h k a
efnasamband	ɛ p n a s a m p a n t
kjölur	cʰ œː l ʏ r
af	aː v
árlegur	a uː r l ɛ ɣ ʏ r
fljót	f l j o uː t
köngull	kʰ ø y ŋ k ʏ t l
enda	ɛ n t a
spil	s p ɪː l
lara	l aː r a
hræll	r̥ a i t l
tól	tʰ o uː l
kengur	cʰ e i ŋ k ʏ r
olla	ɔ lː a
eðalsteinn	ɛː ð a l s t e i t n
bresta	p r ɛ s t a
leiðtogi	l e i ð tʰ ɔː j ɪ
safnheiti	s a p n h e iː t ɪ
hvelatengsl	xʷ ɛː l a tʰ e i ŋ s t l
láki	l a uː c ɪ
norska	n ɔ r̥ s k a
blóðbogi	p l o uː ð p ɔː j ɪ
alklæddur	aː l kʰ l a i tː ʏ r
vaff	v a fː
vettlingur	v ɛ h t l i ŋ k ʏ r
bloti	p l ɔː t ɪ
þéra	θ j ɛː r a
vafagepill	v aː v a c ɛː p ɪ t l
koss	kʰ ɔ sː
ráðríkur	r a u ð r iː k ʏ r
fræða	f r a iː ð a
kúrín	kʰ uː r iː n
hagfræði	h a x f r a iː ð ɪ
skarpur	s k a r̥ p ʏ r
nenna	n ɛ nː a
kynkirtill	cʰ ɪː n cʰ ɪ r̥ t ɪ t l
orki	ɔ r̥ c ɪ
sælgæti	s a i l c a iː t ɪ
hermundur	h ɛ r m ʏ n t ʏ r
fes	f ɛː s
grein	k r e iː n
brennuvargur	p r ɛ nː ʏ v a r k ʏ r
nit	n ɪː t
labb	l a pː
grímur	k r iː m ʏ r
varpasveifgras	v a r̥ p a s v e i v k r aː s
taumur	tʰ ø yː m ʏ r
orðasafn	ɔ r ð a s a p n
drengskapur	t r e i ŋ k s k aː p ʏ r
atgeir	aː t k e iː r
skammur	s k a mː ʏ r
leppalúði	l ɛ h p a l uː ð ɪ
kópur	kʰ o uː p ʏ r
fúi	f uː ɪ
böðull	p œː ð ʏ t l
hrygla	r̥ ɪ k l a
húsnæði	h uː s n a iː ð ɪ
strauja	s t r ø yː j a
gott	k ɔ h t
dýptarleit	t i f t a r l e iː t
guðleysingi	k v ʏ ð l e iː s i ɲ c ɪ
þjark	θ j a r̥ k
holdsveiki	h ɔ l t s v e iː c ɪ
tækla	tʰ a i h k l a
dökkur	t œ h k ʏ r
boðflenna	p ɔ ð f l ɛ nː a
staðhæfing	s t a ð h a iː v i ŋ k
pennahnífur	pʰ ɛ nː a n̥ iː v ʏ r
aristóteles	aː r ɪ s t o uː tʰ ɛː l ɛː s
natrín	n aː t r iː n
heill	h e i t l
skýli	s c iː l ɪ
vík	v iː k
mylla	m ɪ lː a
sníkja	s n iː c a
föt	f œː t
téténía	tʰ j ɛ tʰ j ɛː n iː j a
kvelja	kʰ v ɛ l j a
forstofa	f ɔ r̥ s t ɔː v a
vara	v aː r a
kotra	kʰ ɔː t r a
þrílaufungur	θ r iː l ø yː v ʏ ŋ k ʏ r
skytta	s c ɪ h t a
laug	l ø yː ɣ
ingibjörg	i ɲ c ɪ p j œ r k
frumuhimna	f r ʏː m ʏ h ɪ m n a
jónatan	j o uː n a tʰ aː n
sperðileitrun	s p ɛ r ð ɪ l e iː t r ʏ n
óska	o u s k a
óðinsvé	o uː ð ɪ n s v j ɛː
herkúles	h ɛ r̥ k uː l ɛː s
kefli	cʰ ɛ p l ɪ
útskýring	uː t s c iː r i ŋ k
eplamauk	ɛ h p l a m ø yː k
fanga	f a u ŋ k a
júlímánuður	j uː l iː m a uː n ʏ ð ʏ r
skuggi	s k ʏ cː ɪ
einvaldur	e i n v a l t ʏ r
poka	pʰ ɔː k a
hreðka	r̥ ɛ θ k a
hyski	h ɪ s c ɪ
furða	f ʏ r ð a
framan	f r aː m a n
pláneta	pʰ l a uː n ɛː t a
góðæri	k o uː ð a iː r ɪ
blygðun	p l ɪ ɣ ð ʏ n
tæki	tʰ a iː c ɪ
léttmjólk	l j ɛ h t m j o u l̥ k
pöntun	pʰ œ n̥ t ʏ n
stjórnleysi	s t j o u r t n l e iː s ɪ
árekstur	a uː r ɛ x s t ʏ r
fíkja	f iː c a
samlandi	s a m l a n t ɪ
torfa	tʰ ɔ r v a
ljósapera	l j o uː s a pʰ ɛː r a
krjúpa	kʰ r j uː p a
bræða	p r a iː ð a
helgidagur	h ɛ l c ɪ t aː ɣ ʏ r
dirfska	t ɪ r v s k a
malmquist	m a l m kʰ v ɪ s t
járnbrautarlest	j a u r t n p r ø yː t a r l ɛ s t
eyðni	e i ð n ɪ
aðskilja	a ð s c ɪ l j a
skrið	s k r ɪː ð
glampa	k l a m̥ p a
djöfladýrkun	t j œ p l a t i r̥ k ʏ n
hobbiti	h ɔ pː ɪː t ɪ
heildun	h e i l t ʏ n
læmingi	l a iː m i ɲ c ɪ
áhugi	a uː h ʏ j ɪ
telja	tʰ ɛ l j a
mýta	m iː t a
kvikasilfur	kʰ v ɪː k a s ɪ l v ʏ r
útdráttur	uː t t r a u h t ʏ r
hnýta	n̥ iː t a
bæjasvala	p a iː j a s v aː l a
strengja	s t r e i ɲ c a
hnyttinn	n̥ ɪ h t ɪ nː
kunta	kʰ ʏ n̥ t a
merja	m ɛ r j a
lögfræði	l œ ɣ f r a iː ð ɪ
blýglans	p l iː k l a n s
búrka	p u r̥ k a
orðatiltæki	ɔ r ð a tʰ ɪ l̥ tʰ a iː c ɪ
formæling	f ɔ r m a iː l i ŋ k
bardagalist	p a r t aː ɣ a l ɪ s t
nýr	n iː r
eftirmynd	ɛ f t ɪ r m ɪ n t
andlangur	a n t l a u ŋ k ʏ r
sætta	s a i h t a
holtsetaland	h ɔ l̥ t s ɛː t a l a n t
fordómur	f ɔ r t o uː m ʏ r
æja	a iː j a
kaldur	kʰ a l t ʏ r
helsingjaborg	h ɛ l s i ɲ c a p ɔ r k
tilvísunarfornafn	tʰ ɪ l v iː s ʏː n a r f ɔ r n a p n
hyskni	h ɪ s k n ɪ
hér	ç ɛː r
kalksteinn	kʰ a l̥ k s t e i t n
endaþarmsop	ɛ n t a θ a r m s ɔː p
líta	l iː t a
prófa	pʰ r o uː v a
klúr	kʰ l uː r
pils	pʰ ɪ l s
heilla	h e i t l a
brautryðjandi	p r ø yː t r ɪ ð j a n t ɪ
klæða	kʰ l a iː ð a
hrís	r̥ iː s
gautaborg	k ø yː t a p ɔ r k
lita	l ɪː t a
skadda	s k a tː a
hefla	h ɛ p l a
taug	tʰ ø yː ɣ
sigur	s ɪː ɣ ʏ r
dólgslegur	t o u l k s l ɛː ɣ ʏ r
dauðakippur	t ø yː ð a cʰ ɪ h p ʏ r
flaska	f l a s k a
fitna	f ɪ h t n a
sonur	s ɔː n ʏ r
tagl	tʰ a k l
boðháttur	p ɔː ð h a u h t ʏ r
kollekta	kʰ ɔ lː ɛ x t a
framhjáhlaup	f r a m ç a uː l̥ ø yː p
ferskja	f ɛ r̥ s c a
traf	tʰ r aː v
ástríður	a u s t r iː ð ʏ r
arsen	a r̥ s ɛ n
einhyrningur	e i n h ɪ r t n i ŋ k ʏ r
marxisti	m a r̥ k s ɪ s t ɪ
kvenhylli	kʰ v ɛ n h ɪ t l ɪ
menntastofnun	m ɛ n̥ t a s t ɔ p n ʏ n
gruna	k r ʏː n a
hóf	h o uː v
selur	s ɛː l ʏ r
sendinn	s ɛ n t ɪ nː
einær	e iː n a iː r
slútta	s t l u h t a
ísmoli	iː s m ɔː l ɪ
melgresi	m ɛ l k r ɛː s ɪ
ítali	iː tʰ aː l ɪ
tökuþýðing	tʰ œː k ʏ θ iː ð i ŋ k
hörund	h œː r ʏ n t
basl	p a s t l
bæ	p a iː
helgisiður	h ɛ l c ɪ s ɪː ð ʏ r
kampavín	kʰ a m̥ p a v iː n
samhljóð	s a m l̥ j o uː ð
hylli	h ɪ t l ɪ
hjara	ç aː r a
safamikill	s aː v a m ɪː c ɪ t l
nekt	n ɛ x t
ragnar	r a k n aː r
víg	v iː ɣ
legkaka	l ɛ ɣ kʰ aː k a
skræla	s k r a iː l a
skaplyndi	s k aː p l ɪ n t ɪ
aðalmerki	aː ð a l m ɛ r̥ c ɪ
dvöl	t v œː l
óhuggulegur	o uː h ʏ kː ʏ l ɛː ɣ ʏ r
kvíða	kʰ v iː ð a
list	l ɪ s t
okkar	ɔ h k ɐ r
mars	m a r̥ s
sparnaður	s p a r t n aː ð ʏ r
minning	m ɪ nː i ŋ k
sprikla	s p r ɪ h k l a
stama	s t aː m a
markstöng	m a r̥ k s t ø y ŋ k
hafri	h a v r ɪ
hjálparsögn	ç a u l̥ p a r s œ k n
orðaleikur	ɔ r ð a l e iː k ʏ r
efedrín	ɛː f ɛː t r iː n
axlabönd	a x s t l a p œ n t
hringur	r̥ i ŋ k ʏ r
hæna	h a iː n a
október	ɔ x t o uː p ɛː r
slakna	s t l a h k n a
gæluverkefni	c a iː l ʏ v ɛ r̥ k ɛ p n ɪ
sítrónusýra	s iː tʰ r o uː n ʏ s iː r a
rökhenda	r œː k h ɛ n t a
grafall	k r aː v a t l
dagskrá	t a x s k r a uː
víngarður	v i n k a r ð ʏ r
tuldra	tʰ ʏ l t r a
helgur	h ɛ l k ʏ r
eldpipar	ɛ l t p ɪː p a r
aumingi	ø yː m i ɲ c ɪ
múslimi	m u s t l ɪː m ɪ
kvaðratrót	kʰ v a ð r aː t r o uː t
hólf	h o u l v
mótherji	m o uː t h ɛ r j ɪ
argur	a r k ʏ r
tryggð	tʰ r ɪ ɣ ð
djarfur	t j a r v ʏ r
joð	j ɔː ð
flag	f l aː ɣ
deigur	t e iː ɣ ʏ r
fallegur	f a t l ɛː ɣ ʏ r
þegja	θ e iː j a
mórauður	m o uː r ø yː ð ʏ r
nælon	n a iː l ɔː n
fótbolti	f o uː t p ɔ l̥ t ɪ
imbakassi	ɪ m p a kʰ a sː ɪ
ofn	ɔ p n
rista	r ɪ s t a
thorarensen	tʰ o uː r aː r ɛ n s ɛ nː
nýjabrum	n iː j a p r ʏː m
baul	p ø yː l
píra	pʰ iː r a
kafna	kʰ a p n a
beygingardæmi	p e iː j i ŋ k a r t a iː m ɪ
lasinn	l aː s ɪ nː
bender	p ɛ n d ɛː r
lag	l aː ɣ
tegra	tʰ ɛ ɣ r a
kaupstefna	kʰ ø y p s t ɛ p n a
tigna	tʰ ɪ k n a
vodka	v ɔ t kʰ a
heigull	h e iː ɣ ʏ t l
skiljanlega	s c ɪ l j a n l ɛː ɣ a
fortíðarþrá	f ɔ r̥ tʰ iː ð a r θ r a uː
dyflinn	t ɪ p l ɪ nː
bifreið	p ɪ v r e iː ð
þrennur	θ r ɛ nː ʏ r
mylsna	m ɪ l s t n a
vefur	v ɛː v ʏ r
miðbaugur	m ɪ ð p ø yː ɣ ʏ r
bálkur	p a u l̥ k ʏ r
fár	f a uː r
flóajurt	f l o uː a j ʏ r̥ t
pækill	pʰ a iː c ɪ t l
kryfja	kʰ r ɪ v j a
ljóður	l j o uː ð ʏ r
aspas	a s p a s
alls	a l s
vá	v a uː
dvergkráka	t v ɛ r k kʰ r a uː k a
kirsuber	cʰ ɪ r̥ s ʏ p ɛː r
flámæli	f l a uː m a iː l ɪ
hnýfill	n̥ iː v ɪ t l
taugafræði	tʰ ø yː ɣ a f r a iː ð ɪ
keppinautur	cʰ ɛ h p ɪ n ø yː t ʏ r
bæt	p a iː t
páll	pʰ a u t l
matreiðslubók	m aː t r e i ð s t l ʏ p o uː k
brennisteinn	p r ɛ nː ɪ s t e i t n
skynugur	s c ɪː n ʏː ɣ ʏ r
afkvæmi	a v kʰ v a iː m ɪ
trúlofa	tʰ r uː l ɔ v a
deyfð	t e i v ð
strá	s t r a uː
merki	m ɛ r̥ c ɪ
útbreiða	uː t p r e iː ð a
lipurð	l ɪː p ʏ r ð
endurlífgun	ɛ n t ʏ r l i v k ʏ n
hamingjusamur	h aː m i ɲ c ʏ s aː m ʏ r
blokkflauta	p l ɔ h k f l ø yː t a
bókaútgáfa	p o uː k a uː t k a uː v a
benín	p ɛː n iː n
jöklasóley	j œ h k l a s o uː l e iː
legill	l e iː j ɪ t l
rimma	r ɪ mː a
kúpa	kʰ uː p a
búretta	p uː r ɛ h t a
tak	tʰ aː k
rafhlaða	r a v l̥ aː ð a
eykt	e i x t
selkjöt	s ɛ l cʰ œː t
bjartsýnn	p j a r̥ t s i t n
skott	s k ɔ h t
hlykkur	l̥ ɪ h k ʏ r
húsgagn	h uː s k a k n
putti	pʰ ʏ h t ɪ
kíví	kʰ iː v i
bringubein	p r i ŋ k ʏ p e iː n
flissa	f l ɪ sː a
fullnusta	f ʏ t l n ʏ s t a
knattspyrna	kʰ n a h t s p ɪ r t n a
vasapeningar	v aː s a pʰ ɛː n i ŋ k a r
smóking	s m o uː cʰ i ŋ k
sveigur	s v e iː ɣ ʏ r
harður	h a r ð ʏ r
rukka	r ʏ h k a
kol	kʰ ɔː l
íverufall	iː v ɛː r ʏ f a t l
þórgunnur	θ o u r k ʏ nː ʏ r
flog	f l ɔː ɣ
ferskur	f ɛ r̥ s k ʏ r
bati	p aː t ɪ
blálilja	p l a uː l ɪ l j a
marsering	m a r̥ s ɛː r i ŋ k
skartgripasali	s k a r̥ t k r ɪː p a s aː l ɪ
hekk	h ɛ h k
lok	l ɔː k
spjör	s p j œː r
vélfræðingur	v j ɛː l f r a iː ð i ŋ k ʏ r
gap	k aː p
erill	ɛː r ɪ t l
þrugla	θ r ʏ k l a
innstunga	ɪ n s t u ŋ k a
betlari	p ɛ h t l aː r ɪ
afskráning	a f s k r a uː n i ŋ k
gírstöng	c iː r̥ s t ø y ŋ k
næringarfræðingur	n a iː r i ŋ k a r f r a iː ð i ŋ k ʏ r
morgunhani	m ɔ r k ʏ n h aː n ɪ
erfiða	ɛ r v ɪː ð a
haf	h aː v
perla	pʰ ɛ r t l a
ingólfína	i ŋ k o u l v iː n a
sýning	s iː n i ŋ k
prentduft	pʰ r ɛ n̥ t t ʏ f t
vísigreifi	v iː s ɪ k r e iː v ɪ
guðvaldína	k v ʏ ð v a l t iː n a
skeyti	s c e iː t ɪ
raun	r ø yː n
hagskælingur	h a x s c a i l i ŋ k ʏ r
tilkynning	tʰ ɪ l cʰ ɪ nː i ŋ k
heiti	h e iː t ɪ
punda	pʰ ʏ n t a
melablóm	m ɛː l a p l o uː m
fjórir	f j o uː r i r
fróa	f r o uː a
synja	s ɪ n j a
fæða	f a iː ð a
bjúga	p j uː a
tafla	tʰ a p l a
síróp	s iː r o uː p
fundur	f ʏ n t ʏ r
kaffihús	kʰ a fː ɪ h uː s
hamborgari	h a m p ɔ r k a r ɪ
fjandi	f j a n t ɪ
mettur	m ɛ h t ʏ r
basla	p a s t l a
loðvíðir	l ɔ ð v iː ð ɪ r
bretland	p r ɛː t l a n t
prófsumma	pʰ r o u f s ʏ mː a
hrútspungur	r̥ u t s pʰ u ŋ k ʏ r
mannasiður	m a nː a s ɪː ð ʏ r
kné	kʰ n j ɛː
skelkaður	s c ɛ l̥ k a ð ʏ r
beygingarlýsing	p e iː j i ŋ k a r l iː s i ŋ k
farði	f a r ð ɪ
nögl	n œ k l
skírisskógur	s c iː r ɪ s s k o uː ʏ r
rýna	r iː n a
hugsa	h ʏ x s a
bakskaut	p aː k s k ø yː t
hýjungur	h iː j u ŋ k ʏ r
ólafína	o uː l aː v iː n a
framræsla	f r a m r a i s t l a
vettugi	v ɛ h t ʏ j ɪ
æð	a iː ð
boðorð	p ɔː ð ɔ r ð
danska	t a n s k a
ruðningur	r ʏ ð n i ŋ k ʏ r
gúrka	k u r̥ k a
pasta	pʰ a s t a
auðvald	ø y ð v a l t
slarksamur	s t l a r̥ k s aː m ʏ r
össurína	œ sː ʏ r iː n a
lystauki	l ɪ s t ø yː c ɪ
verndun	v ɛ r n t ʏ n
dissa	t ɪ sː a
afbrigðilegur	a v p r ɪ ɣ ð ɪ l ɛː ɣ ʏ r
menga	m e i ŋ k a
derhúfa	t ɛ r h uː v a
hvítvín	xʷ iː t v iː n
laglína	l a ɣ l iː n a
serbi	s ɛ r p ɪ
sakleysi	s aː k l e iː s ɪ
súra	s uː r a
stefni	s t ɛ p n ɪ
brjóstvasi	p r j o u s t v aː s ɪ
frískur	f r i s k ʏ r
markspyrna	m a r̥ k s p ɪ r t n a
afsaka	a f s aː k a
kuðungur	kʰ ʏː ð u ŋ k ʏ r
svara	s v aː r a
hrygna	r̥ ɪ k n a
drottning	t r ɔ h t n i ŋ k
þágufall	θ a uː ʏ f a t l
óratóría	o uː r a tʰ o uː r iː j a
hrafnastör	r̥ a p n a s t œː r
nafnorð	n a p n ɔ r ð
öld	œ l t
rækta	r a i x t a
róður	r o uː ð ʏ r
bolsi	p ɔ l s ɪ
hneta	n̥ ɛː t a
kartafla	k a r̥ t a p l a
stuttur	s t ʏ h t ʏ r
rauðrófa	r ø y ð r o uː v a
morðingi	m ɔ r ð i ɲ c ɪ
tí	tʰ iː
vé	v j ɛː
hreyfing	r̥ e iː v i ŋ k
haukur	h ø yː k ʏ r
traustur	tʰ r ø y s t ʏ r
grobba	k r ɔ pː a
böllur	p œ t l ʏ r
einustu	e iː n ʏ s t ʏ
karsi	kʰ a r̥ s ɪ
mildur	m ɪ l t ʏ r
hornblendi	h ɔ r t n p l ɛ n t ɪ
dýraspítali	t iː r a s p iː t aː l ɪ
óbeinn	o uː p e i t n
sítrónusafi	s iː tʰ r o uː n ʏ s aː v ɪ
gunnþórunn	k ʏ n θ o uː r ʏ nː
hani	h aː n ɪ
juða	j ʏː ð a
hundrað	h ʏ n t r aː ð
endurtaka	ɛ n t ʏ r tʰ aː k a
fjör	f j œː r
jiddíska	j ɪ tː i s k a
bravó	p r aː v o uː
kúld	kʰ u l t
fasismi	f aː s ɪ s m ɪ
fúlmár	f u l m a uː r
fengur	f e i ŋ k ʏ r
kvenkyn	kʰ v ɛ n cʰ ɪː n
hrúga	r̥ uː a
bogastrengur	p ɔː ɣ a s t r e i ŋ k ʏ r
kífa	cʰ iː v a
bý	p iː
leyna	l e iː n a
eruð	ɛː r ʏ ð
fylgi	f ɪ l c ɪ
hnakki	n̥ a h c ɪ
opna	ɔ h p n a
kýli	cʰ iː l ɪ
mæta	m a iː t a
krista	kʰ r ɪ s t a
svo	s v ɔː
aukafallsliður	ø yː k a f a l s l ɪː ð ʏ r
fælinn	f a iː l ɪ nː
kassi	kʰ a sː ɪ
athugasemd	aː t h ʏː ɣ a s ɛ m t
sáttur	s a u h t ʏ r
raul	r ø yː l
tillit	tʰ ɪ l l ɪː t
þverhníptur	θ v ɛ r n̥ i f t ʏ r
fallorð	f a t l ɔ r ð
þrasa	θ r aː s a
illur	ɪ t l ʏ r
frændhygli	f r a i n t h ɪ k l ɪ
hræsnistár	r̥ a i s t n ɪ s tʰ a uː r
ólífa	o uː l iː v a
tímarit	tʰ iː m a r ɪː t
tönn	tʰ œ nː
franskbrauð	f r a n s k p r ø yː ð
kelfa	cʰ ɛ l v a
bolti	p ɔ l̥ t ɪ
tárakirtill	tʰ a uː r a kʰ ɪ r̥ t ɪ t l
sýna	s iː n a
hornspyrna	h ɔ r t n s p ɪ r t n a
umkringja	ʏ m kʰ r i ɲ c a
smáorð	s m a uː ɔ r ð
misþyrming	m ɪː s θ ɪ r m i ŋ k
túnfífill	tʰ u n f iː v ɪ t l
virki	v ɪ r̥ c ɪ
rammi	r a mː ɪ
alvara	a l v aː r a
svaladrykkur	s v aː l a t r ɪ h k ʏ r
möl	m œː l
galdramaður	k a l t r a m aː ð ʏ r
línarfi	l iː n a r v ɪ
bréfaklemma	p r j ɛː v a kʰ l ɛ mː a
aðventa	a ð v ɛ n̥ t a
sag	s aː ɣ
sykurpúði	s ɪː k ʏ r pʰ uː ð ɪ
geisla	c e i s t l a
sía	s iː j a
þúsund	θ uː s ʏ n t
höfuðbúnaður	h œː v ʏ ð p uː n aː ð ʏ r
heimska	h e i m s k a
ver	v ɛː r
kvittun	kʰ v ɪ h t ʏ n
lán	l a uː n
pera	pʰ ɛː r a
kompa	kʰ ɔ m̥ p a
æskja	a i s c a
drykkur	t r ɪ h k ʏ r
gyrðir	c ɪ r ð ɪ r
annars	a nː a r̥ s
vakt	v a x t
rykfalla	r ɪː k f a t l a
fart	f a r̥ t
öndun	œ n t ʏ n
sálmabók	s a u l m a p o uː k
brjóstsviði	p r j o u s t s v ɪː ð ɪ
húm	h uː m
eiga	e iː ɣ a
lónasóley	l o uː n a s o uː l e iː
bílaleiga	p iː l a l e iː ɣ a
tangi	tʰ a u ɲ c ɪ
gjall	c a t l
hreinsun	r̥ e i n s ʏ n
konráð	kʰ ɔ n r a uː ð
dama	t aː m a
grind	k r ɪ n t
svali	s v aː l ɪ
greina	k r e iː n a
hneppa	n̥ ɛ h p a
mía	m iː j a
búkur	p uː k ʏ r
lófatölva	l o uː v a tʰ œ l v a
flekklaus	f l ɛ h k l ø yː s
klarínetta	kʰ l aː r iː n ɛ h t a
gráspör	k r a uː s p œː r
brautargengi	p r ø yː t a r c e i ɲ c ɪ
baðherbergi	p aː ð h ɛ r p ɛ r c ɪ
gáfaður	k a uː v a ð ʏ r
helluhraun	h ɛ t l ʏ r̥ ø yː n
hrafntinna	r̥ a p n tʰ ɪ nː a
grefill	k r ɛː v ɪ t l
jóskur	j o u s k ʏ r
íferðarfall	iː f ɛ r ð a r f a t l
fótasár	f o uː t a s a uː r
kínaskák	cʰ iː n a s k a uː k
fæll	f a i t l
rampur	r a m̥ p ʏ r
blóð	p l o uː ð
hvæs	kʰ v a iː s
áhrifssögn	a uː r̥ i f s s œ k n̥
viðbragð	v ɪ ð p r a ɣ ð
móðurmál	m o uː ð ʏ r m a uː l
bjarma	p j a r m a
hríspappír	r̥ iː s pʰ a h p iː r
haförn	h aː v œ r t n
ákveðinn	a uː kʰ v ɛː ð ɪ nː
brjóstamjólk	p r j o u s t a m j o u l̥ k
tígrisdýr	tʰ iː k r ɪ s t iː r
vernda	v ɛ r n t a
demantur	t ɛː m a n̥ t ʏ r
blómvöndur	p l o u m v œ n t ʏ r
flaggskip	f l a kː s c ɪː p
kló	kʰ l o uː
hildigunnur	h ɪ l t ɪ k ʏ nː ʏ r
rækt	r a i x t
stjúpsonur	s t j uː p s ɔː n ʏ r
marsera	m a r̥ s ɛː r a
neysla	n e i s t l a
ná	n a uː
orgía	ɔ r c iː j a
freknóttur	f r ɛ h k n o u h t ʏ r
túba	tʰ uː p a
hótel	h o uː t ɛ l
eftirsókn	ɛ f t ɪ r s o u h k n
fljóð	f l j o uː ð
geðlæknir	c ɛ ð l a i h k n ɪ r
sjá	s j a uː
skurfa	s k ʏ r v a
ryksuga	r ɪ k s ʏː ɣ a
flytja	f l ɪː t j a
bíti	p iː t ɪ
karbónat	kʰ a r p o uː n aː t
þegn	θ ɛ k n
marksúla	m a r̥ k s uː l a
vegur	v ɛː ɣ ʏ r
raftur	r a f t ʏ r
óbó	o uː p o uː
alþingi	a l θ i ŋ c ɪ
súrkál	s u r̥ kʰ a uː l
hérna	ç ɛ r t n a
færiband	f a iː r ɪ p a n t
smurostur	s m ʏː r ɔ s t ʏ r
tollskýrsla	tʰ ɔ t l̥ s c i r̥ s t l a
júní	j uː n iː
hót	h o uː t
flugmaður	f l ʏ ɣ m aː ð ʏ r
eftirminnilegur	ɛ f t ɪ r m ɪ nː ɪ l ɛː ɣ ʏ r
stelkur	s t ɛ l̥ k ʏ r
kanína	kʰ aː n iː n a
nýrun	n iː r ʏ n
gifta	c ɪ f t a
konungsríki	kʰ ɔː n u ŋ k s r iː c ɪ
vöðvi	v œ ð v ɪ
mólendi	m o uː l ɛ n t ɪ
ingimundína	i ŋ c ɪ m ʏ n t iː n a
rák	r a uː k
verðlaun	v ɛ r ð l ø yː n
dvergtré	t v ɛ r k t r j ɛː
jarðepli	j a r ð ɛ h p l ɪ
teygjanleiki	tʰ e iː j a n l e iː c ɪ
ísrael	iː s r aː ɛː l
kverk	kʰ v ɛ r̥ k
bikkja	p ɪ h c a
nielsen	n i l s ɛ nː
tál	tʰ a uː l
biðstofa	p ɪ ð s t ɔː v a
týsfjóla	tʰ iː s f j o uː l a
fjallaljón	f j a t l a l j o uː n
kaaber	kʰ ɔː p ɛ r
bylgja	p ɪ l c a
leturborð	l ɛː t ʏ r p ɔ r ð
moskítófluga	m ɔ s c iː t o uː f l ʏː ɣ a
barrtré	p a rː t r j ɛː
gríð	k r iː ð
funi	f ʏː n ɪ
kökuhnífur	kʰ œː k ʏ n̥ iː v ʏ r
bernhöft	p ɛ r n h œ f t
ljúfra	l j u v r a
eisti	e i s t ɪ
hnúfubakur	n̥ uː v ʏ p aː k ʏ r
æsa	a iː s a
ör	œː r
barti	p a r̥ t ɪ
kyrkja	cʰ ɪ r̥ c a
vitlaus	v ɪ h t l ø yː s
þráðlaus	θ r a u ð l ø yː s
súkkulaði	s u h k ʏ l aː ð ɪ
lögg	l œ kː
ægja	a iː j a
fargjald	f a r c a l t
sálmur	s a u l m ʏ r
úkraínskur	uː kʰ r a i n s k ʏ r
stjarfur	s t j a r v ʏ r
yfirlit	ɪː v ɪ r l ɪː t
feyja	f e iː j a
óvarkárni	o uː v a r̥ kʰ a u r t n ɪ
gígur	c iː ɣ ʏ r
einlægni	e i n l a i k n ɪ
naðra	n a ð r a
sáðrás	s a u ð r a u s
svæfi	s v a iː v ɪ
andi	a n t ɪ
romm	r ɔ mː
vilja	v ɪ l j a
laugamaðra	l ø yː ɣ a m a ð r a
ásta	a u s t a
orkudrykkur	ɔ r̥ k ʏ t r ɪ h k ʏ r
höggormur	h œ kː ɔ r m ʏ r
blek	p l ɛː k
kjartanía	cʰ a r̥ t a n iː j a
hristingur	r̥ ɪ s t i ŋ k ʏ r
heimþrá	h e i m θ r a uː
náttúruval	n a u h t uː r ʏ v aː l
vonandi	v ɔː n a n t ɪ
rusl	r ʏ s t l
grávíðir	k r a uː v iː ð ɪ r
hrafndís	r̥ a p n t iː s
rauðvín	r ø y ð v iː n
kaðlari	kʰ a ð l a r ɪ
bergmundur	p ɛ r k m ʏ n t ʏ r
flísatöng	f l iː s a tʰ ø y ŋ k
fæðing	f a iː ð i ŋ k
svilkona	s v ɪ l kʰ ɔː n a
völva	v œ l v a
hófskegg	h o u v s c ɛ kː
spjótkast	s p j o uː t kʰ a s t
sameina	s aː m e iː n a
lindi	l ɪ n t ɪ
básúnuleikari	p a uː s uː n ʏ l e iː k aː r ɪ
lesandabréf	l ɛː s a n t a p r j ɛː v
skríll	s k r i t l
gönguleið	k ø y ŋ k ʏ l e iː ð
þjálfun	θ j a u l v ʏ n
mosadýr	m ɔː s a t iː r
áhrif	a uː r̥ ɪː v
baga	p aː ɣ a
atburður	aː t p ʏ r ð ʏ r
poppa	pʰ ɔ h p a
eyrnamergur	e i r t n a m ɛ r k ʏ r
frasi	f r aː s ɪ
púði	pʰ uː ð ɪ
par	pʰ aː r
broddfura	p r ɔ tː f ʏː r a
auðna	ø y ð n a
dyggð	t ɪ ɣ ð
heiður	h e iː ð ʏ r
herkvaðning	h ɛ r̥ kʰ v a ð n i ŋ k
slóvakía	s t l o uː v a cʰ iː j a
rot	r ɔː t
sog	s ɔː ɣ
linnur	l ɪ nː ʏ r
þröstur	θ r œ s t ʏ r
glúmur	k l uː m ʏ r
glott	k l ɔ h t
sjötti	s j œ h t ɪ
kúrbítur	kʰ u r p iː t ʏ r
hjóm	ç o uː m
þögull	θ œː ɣ ʏ t l
radar	r aː t a r
svunta	s v ʏ n̥ t a
át	a uː t
gneggja	k n ɛ cː a
gíraffi	c iː r a fː ɪ
mannréttindi	m a nː r j ɛ h t ɪ n t ɪ
grípa	k r iː p a
pýþagóras	pʰ iː θ a k o uː r aː s
brons	p r ɔ n s
forðafræði	f ɔ r ð a f r a iː ð ɪ
drómedari	t r o uː m ɛː t aː r ɪ
fiskur	f ɪ s k ʏ r
blágreni	p l a uː k r ɛː n ɪ
framtíðarfræði	f r a m t iː ð a r f r a iː ð ɪ
lefsa	l ɛ f s a
undur	ʏ n t ʏ r
stika	s t ɪː k a
kennari	cʰ ɛ nː aː r ɪ
stykkja	s t ɪ h c a
guðbjörg	k v ʏ ð p j œ r k
breiddarleit	p r e i tː a r l e iː t
sandstormur	s a n t s t ɔ r m ʏ r
ögmundína	œ ɣ m ʏ n t iː n a
kyrravika	cʰ ɪ rː a v ɪː k a
leikmaður	l e iː k m aː ð ʏ r
gorma	k ɔ r m a
pat	pʰ aː t
hrokafullur	r̥ ɔː k a f ʏ t ɬ ʏ r
flakka	f l a h k a
heimsálfa	h e i m s a u l v a
gráði	k r a uː ð ɪ
spjald	s p j a l t
nágrenni	n a uː k r ɛ nː ɪ
litaröð	l ɪː t a r œː ð
líf	l iː v
kærasta	cʰ a iː r a s t a
hjaðna	ç a ð n a
skokka	s k ɔ h k a
heiðindómur	h e iː ð ɪ n t o uː m ʏ r
lausnarhraði	l ø y s t n a r r̥ aː ð ɪ
kútur	kʰ uː t ʏ r
daníel	t aː n i j ɛː l
heiðarlegur	h e iː ð a r l ɛː ɣ ʏ r
nægja	n a iː j a
afar	aː v a r
þankastrik	θ a u ŋ̊ k a s t r ɪː k
hinstur	h ɪ n s t ʏ r
pallur	pʰ a t l ʏ r
ferskjutré	f ɛ r̥ s c ʏ t r j ɛː
rjómaostur	r j o uː m a ɔ s t ʏ r
raska	r a s k a
höfuðsmaður	h œː v ʏ ð s m aː ð ʏ r
mátun	m a uː t ʏ n
andvari	a n t v aː r ɪ
arabíska	aː r a p i s k a
hugi	h ʏː j ɪ
teningur	tʰ ɛː n i ŋ k ʏ r
rögnvaldína	r œ k n v a l t iː n a
klár	kʰ l a uː r
hindartré	h ɪ n t a r t r j ɛː
sjávarfugl	s j a uː v a r f ʏ k l
fis	f ɪː s
kanslari	kʰ a n s t l a r ɪ
hringl	r̥ i ŋ l
múgæsing	m uː a iː s i ŋ k
aftaka	a v tʰ aː k a
loppa	l ɔ h p a
djörfung	t j œ r v u ŋ k
indverji	ɪ n t v ɛ r j ɪ
kísill	cʰ iː s ɪ t l
hollur	h ɔ t l ʏ r
snjall	s t n j a t l
aur	ø yː r
innan	ɪ nː a n
skaðlegur	s k a ð l ɛː ɣ ʏ r
páhæna	pʰ a uː h a iː n a
tæla	tʰ a iː l a
mótbára	m o uː t p a uː r a
háttur	h a u h t ʏ r
brasilía	p r aː s ɪ l iː j a
undrabarn	ʏ n t r a p a r t n
hádegi	h a uː t e iː j ɪ
helta	h ɛ l̥ t a
þoka	θ ɔː k a
korpa	kʰ ɔ r̥ p a
belgja	p ɛ l c a
arnmundur	a r t n m ʏ n t ʏ r
rófa	r o uː v a
miðasala	m ɪː ð a s aː l a
áhrifaríkur	a uː r̥ ɪː v a r iː k ʏ r
úlpa	u l̥ p a
skýra	s c iː r a
rúmenía	r uː m ɛː n iː j a
kljúfa	kʰ l j uː v a
metorð	m ɛː t ɔ r ð
eldgos	ɛ l t k ɔː s
atgervi	aː t c ɛ r v ɪ
heimspekingur	h e i m s p ɛː c i ŋ k ʏ r
sverðfiskur	s v ɛ r ð f ɪ s k ʏ r
ólafssúra	o uː l a f s s uː r a
áhersla	a uː h ɛ r̥ s t l a
ildi	ɪ l t ɪ
legunautur	l ɛː ɣ ʏ n ø yː t ʏ r
fregna	f r ɛ k n a
sámsey	s a u m s e iː
forhúð	f ɔː r h uː ð
maríutása	m aː r iː j ʏ tʰ a uː s a
afturbati	a f t ʏ r p aː t ɪ
heit	h e iː t
blóm	p l o uː m
firring	f ɪ rː i ŋ k
heimilisfang	h e iː m ɪ l ɪ s f a u ŋ k
gatari	k aː t aː r ɪ
blátoppastör	p l a uː tʰ ɔ h p a s t œː r
stækka	s t a i h k a
háhyrningur	h a u h ɪ r t n i ŋ k ʏ r
beitiland	p e iː t ɪ l a n t
fyrirferð	f ɪː r ɪ r f ɛ r ð
snjallsími	s t n j a t l s iː m ɪ
klappa	k l a h p a
dylja	t ɪ l j a
sjálf	s j a u l v
auðmjúkur	ø y ð m j uː k ʏ r
afkomandi	a v kʰ ɔː m a n t ɪ
krækja	kʰ r a iː c a
vöndull	v œ n t ʏ t l
vörumerki	v œː r ʏ m ɛ r̥ c ɪ
þjóð	θ j o uː ð
fas	f aː s
imbi	ɪ m p ɪ
ósannur	o uː s a nː ʏ r
kiljan	cʰ ɪ l j a n
kjölfar	cʰ œ l f aː r
álka	a u l̥ k a
fagurblár	f aː ɣ ʏ r p l a uː r
skurðarborð	s k ʏ r ð a r p ɔ r ð
hnigna	n̥ ɪ k n a
erítreskur	ɛː r iː tʰ r ɛ s k ʏ r
elías	ɛː l iː j a s
jórdan	j o u r t aː n
hætta	h a i h t a
gnægð	k n a i ɣ ð
gumi	k ʏː m ɪ
stígvél	s t i ɣ v j ɛː l
rýr	r iː r
þörf	θ œ r v
kennarasleikja	cʰ ɛ nː a r a s t l e iː c a
silfur	s ɪ l v ʏ r
fróður	f r o uː ð ʏ r
borði	b ɔ r ð ɪ
fyrirgjöra	f ɪː r ɪ r c œː r a
dagbók	t a ɣ p o uː k
frónskur	f r o u n s k ʏ r
blómkál	p l o u m kʰ a uː l
bilun	p ɪː l ʏ n
brestur	p r ɛ s t ʏ r
minnimáttarkennd	m ɪ nː ɪ m a u h t a r cʰ ɛ n t
vignir	v ɪ k n ɪ r
ómögulegur	o uː m œː ɣ ʏ l ɛː ɣ ʏ r
kalín	kʰ aː l iː n
langhlið	l a u ŋ k l̥ ɪː ð
andvaka	a n t v aː k a
ögn	œ k n
eð	ɛː ð
aðferð	a ð f ɛ r ð
dúfa	t uː v a
bíta	p iː t a
hörpuskel	h œ r̥ p ʏ s c ɛː l
silja	s ɪ l j a
hnappaborð	n̥ a h p a p ɔ r ð
dóni	t o uː n ɪ
skógarkerfill	s k o uː a r cʰ ɛ r v ɪ t l
brúskur	p r u s k ʏ r
sæla	s a iː l a
málmblanda	m a u l m p l a n t a
finni	f ɪ nː ɪ
ölkelduvatn	œ l cʰ ɛ l t ʏ v a h t n
pósthús	pʰ o u s t h uː s
evklíðskur	ɛ v kʰ l i ð s k ʏ r
barmmerki	p a r m m ɛ r̥ c ɪ
eldhúshnífur	ɛ l t h uː s n̥ iː v ʏ r
óður	o uː ð ʏ r
dýrslegur	t i r̥ s l ɛː ɣ ʏ r
flaggdúkur	f l a kː t uː k ʏ r
díli	t iː l ɪ
mosavaxinn	m ɔː s a v a x s ɪ nː
kvarta	kʰ v a r̥ t a
auðveldlega	ø y ð v ɛ l t l ɛː ɣ a
brydding	p r ɪ tː i ŋ k
árós	a uː r o uː s
ostahnífur	ɔ s t a n̥ iː v ʏ r
hálfviti	h a u l v v ɪː t ɪ
arnór	a r t n o uː r
djákni	t j a u h k n ɪ
appelsínusafi	a h p ɛ l s iː n ʏ s aː v ɪ
smyrsl	s m ɪ r̥ s t l
eggjaskurn	ɛ cː a s k ʏ r t n
fjarlægja	f j a r l a iː j a
gómur	k o uː m ʏ r
játa	j a uː t a
hattur	h aʰ t ʏ r
afturhald	a f t ʏ r h a l t
varta	v a r̥ t a
hnúðkál	n̥ u ð kʰ a uː l
sívalur	s iː v aː l ʏ r
hljómlist	l̥ j o u m l ɪ s t
dvergtungljurt	t v ɛ r k tʰ u ŋ l j ʏ r̥ t
ákaflega	a uː kʰ a v l ɛː ɣ a
fylgsni	f ɪ l k s t n ɪ
lunga	l u ŋ k a
pistill	pʰ ɪ s t ɪ t l
ísakína	iː s aː k iː n a
þrykkja	θ r ɪ h c a
brottvísun	p r ɔ h t v iː s ʏ n
leifturstríð	l e i f t ʏ r s t r iː ð
und	ʏ n t
bur	p ʏː r
álft	a u l f t
slatti	s t l a h t ɪ
veðurfræði	v e ɛ̯ ð ʏ r f r a i̯ ð ɪ
burnirót	p ʏ r t n ɪ r o uː t
hvirfill	xʷ ɪ r v ɪ t l
okkur	ɔ h k ʏ r
korsíka	kʰ ɔ r̥ s iː k a
hjaltested	ç a l̥ t ɛː s t ɛː ð
olsen	o u l s ɛ nː
fortíð	f ɔ r̥ tʰ iː ð
hettupeysa	h ɛ h t ʏ pʰ e iː s a
verkefni	v ɛ r̥ k ɛ p n ɪ
jakkaföt	j a h k a f œː t
sulla	s ʏ t l a
reykháfur	r e iː k h a uː v ʏ r
hvorugkyn	xʷ ɔː r ʏ ɣ cʰ ɪː n
búðarborð	p uː ð a r p ɔ r ð
skjálfa	s c a u l v a
sléttur	s t l j ɛ h t ʏ r
eistland	e i s t l a n t
múrbrjótur	m u r p r j o uː t ʏ r
hártogun	h a u r̥ tʰ ɔː ɣ ʏ n
verulega	v ɛː r ʏ l ɛː ɣ a
skeið	s c e iː ð
jónasína	j o uː n aː s iː n a
hálfnóta	h a u l v n o uː t a
pantur	pʰ a n̥ t ʏ r
tælenska	tʰ a iː l ɛ n s k a
stjarneðlisfræðingur	s t j a r t n ɛ ð l ɪ s f r a iː ð i ŋ k ʏ r
vinnukona	v ɪ nː ʏ kʰ ɔː n a
geta	c ɛː t a
lampi	l a m̥ p ɪ
húðsjúkdómafræði	h uː ð s j u k t o uː m a f r a iː ð ɪ
breti	p r ɛː t ɪ
ásamt	a uː s a m̥ t
karma	kʰ a r m a
sjóli	s j o uː l ɪ
fyrstur	f ɪ r̥ s t ʏ r
sprengja	s p r e i ɲ c a
garg	k a r k
greiðslukort	k r e i ð s t l ʏ kʰ ɔ r̥ t
ástand	a uː s t a n t
lasanja	l a s a n j a
einar	e iː n a r
skeggburkni	s c ɛ kː p ʏ r̥ k n ɪ
fiseind	f ɪː s e i n t
tarfur	tʰ a r v ʏ r
eyland	e iː l a n t
deyfing	t e iː v i ŋ k
fýra	f iː r a
einir	e iː n ɪ r
dörslag	t œ r s t l aː ɣ
galdra	k a l t r a
teygjanlegur	tʰ e iː j a n l ɛː ɣ ʏ r
tregða	tʰ r ɛ ɣ ð a
gáleysi	k a uː l e iː s ɪ
bragfræði	p r a x f r a iː ð ɪ
kenna	cʰ ɛ nː a
ódýr	o uː t iː r
hreiður	r̥ e iː ð ʏ r
keppni	cʰ ɛ h p n ɪ
hugsanlegur	h ʏ x s a n l ɛː ɣ ʏ r
neitunarháttur	n e iː t ʏ n a r h a u h t ʏ r
þangað	θ a u ŋ k aː ð
horn	h ɔ r t n
malli	m a lː ɪ
röskur	r œ s k ʏ r
gjóstur	c o u s t ʏ r
fasteign	f a s t e i k n
fremja	f r ɛ m j a
ergja	ɛ r c a
skjálfti	s c a u l̥ t ɪ
arnheiður	a r t n h e iː ð ʏ r
gjögur	c œː ɣ ʏ r
svangur	s v a u ŋ k ʏ r
tittlingur	tʰ ɪ h t l i ŋ k ʏ r
drusla	t r ʏ s t l a
heimill	h e iː m ɪ t l
varanlegur	v aː r a n l ɛː ɣ ʏ r
bókstafur	p o uː k s t aː v ʏ r
pempía	pʰ ɛ m̥ p iː j a
stafróf	s t a v r o uː v
byssustingur	p ɪ sː ʏ s t i ŋ k ʏ r
skolli	s k ɔ t l ɪ
órækja	o uː r a iː c a
vatn	v aʰ t n
dyggur	t ɪ kː ʏ r
ey	e iː
puð	pʰ ʏː ð
fjórðapartsnóta	f j o u r ð a pʰ a r̥ t s n o uː t a
ok	ɔː k
stefanía	s t ɛː f aː n iː j a
hnúi	n̥ uː ɪ
hafmey	h a v m e iː
skiljanlegur	s c ɪ l j a n l ɛː ɣ ʏ r
hátíð	h a uː tʰ iː ð
okra	ɔː k r a
klína	kʰ l iː n a
tollera	tʰ ɔ lː ɛː r a
klæindi	kʰ l a iː j ɪ n t ɪ
botnlanganám	p ɔ h t n l a u ŋ k a n a uː m
bankaútibú	p a u ŋ̊ k a uː t ɪ p uː
birta	p ɪ r̥ t a
sagnbeyging	s a k n p e iː j i ŋ k
ugla	ʏ k l a
dá	t a uː
eymundur	e iː m ʏ n t ʏ r
koffín	kʰ ɔ fː iː n
kýrauga	cʰ iː r ø yː ɣ a
hyggjuvit	h ɪ cː ʏ v ɪː t
dreyra	t r e iː r a
landsvæði	l a n t s v a iː ð ɪ
bagall	p aː ɣ a t l
skop	s k ɔ p
feitur	f e iː t ʏ r
poppkorn	pʰ ɔ h p kʰ ɔ r t n
serbneskur	s ɛ r p n ɛ s k ʏ r
gröf	k r œː v
höggva	h œ kː v a
lifandi	l ɪː v a n t ɪ
náladofi	n a uː l a t ɔː v ɪ
fýldur	f i l t ʏ r
snið	s t n ɪː ð
sagreb	s aː k r ɛː p
skollakambur	s k ɔ t l a kʰ a m p ʏ r
glyðra	k l ɪ ð r a
skiptavinur	s k ɪ f t a v ɪː n ʏ r
stafafura	s t aː v a f ʏː r a
samvinna	s a m v ɪ nː a
flórgoði	f l o u r k ɔː ð ɪ
klóna	kʰ l o uː n a
hallgerður	h a t l c ɛ r ð ʏ r
bólivía	p o uː l ɪ v iː j a
búi	p uː ɪ
notandi	n ɔː t a n t ɪ
þriðjudagur	θ r ɪ ð j ʏ t aː ɣ ʏ r
þórfríður	θ o u r̥ f r iː ð ʏ r
rispa	r ɪ s p a
grunur	k r ʏː n ʏ r
einkum	e i n̥ k ʏ m
klór	kʰ l o uː r
þolandi	θ ɔː l a n t ɪ
synd	s ɪ n t
bruðl	p r ʏ ð l
út	uː t
þrífa	θ r iː v a
kenjóttur	cʰ ɛ n j o u h t ʏ r
grimmur	k r ɪ mː ʏ r
aðalendir	aː ð a l ɛ n t ɪ r
túrbína	tʰ u r p iː n a
strý	s t r iː
hlaupa	l̥ ø yː p a
heimsmet	h e i m s m ɛː t
drykkja	t r ɪ h c a
buna	p ʏː n a
temja	tʰ ɛ m j a
fjölkynngi	f j œ l cʰ i ɲ c ɪ
búlgaría	p u l k a r iː j a
venus	v ɛː n ʏ s
víns	v i n s
þrýsta	θ r i s t a
lögregla	l œ ɣ r ɛ k l a
stjörnuspá	s t j œ r t n ʏ s p a uː
lyf	l ɪː v
aðili	aː ð ɪː l ɪ
langreyður	l a u ŋ k r e iː ð ʏ r
blý	p l iː
elí	ɛː l iː
gullmura	k ʏ t l m ʏː r a
tyggjó	tʰ ɪ cː o uː
kýr	cʰ iː r
heilsa	h e i l s a
framkoma	f r a m kʰ ɔː m a
skeggsandi	s c ɛ kː s a n t ɪ
hrísgrjón	r̥ iː s k r j o uː n
bergþrúður	p ɛ r k θ r uː ð ʏ r
vilmundur	v ɪ l m ʏ n t ʏ r
orðsifjafræði	ɔ r ð s ɪ v j a f r a iː ð ɪ
hranalegur	r̥ aː n a l ɛː ɣ ʏ r
týtulíngresi	tʰ iː t ʏ l i n k r ɛː s ɪ
bútur	p uː t ʏ r
gleraugu	k l ɛː r ø yː ɣ ʏ
tognun	tʰ ɔ k n ʏ n
hjalti	ç a l̥ t ɪ
fimbulvetur	f ɪ m p ʏ l v ɛː t ʏ r
klisja	kʰ l ɪː s j a
mær	m a iː r
örvamælir	œ r v a m a iː l ɪ r
göndull	k œ n t ʏ t l
mjölnir	m j œ l n ɪ r
vanda	v a n t a
flóastör	f l o uː a s t œː r
pí	pʰ iː
heilalaus	h e iː l a l ø yː s
félagshyggja	f j ɛː l a x s h ɪ cː a
verður	v ɛ r ð ʏ r
leka	l ɛː k a
endurvekja	ɛ n t ʏ r v ɛː c a
boli	p ɔː l ɪ
fylgja	f ɪ l c a
vernd	v ɛ r n t
melting	m ɛ l̥ t i ŋ k
trúfélag	tʰ r uː f j ɛː l aː ɣ
náðhús	n a u ð h uː s
grúi	k r uː ɪ
keðja	cʰ ɛ ð j a
appelsína	a h p ɛ l s iː n a
kleppur	kʰ l ɛ h p ʏ r
menntun	m ɛ n̥ t ʏ n
gormur	k ɔ r m ʏ r
álandseyjar	a uː l a n t s e iː j a r
jafnvægi	j a p n v a iː j ɪ
geispi	c e i s p ɪ
nestisbox	n ɛ s t ɪ s p ɔ x s
æringi	a iː r i ɲ c ɪ
láglendi	l a u ɣ l ɛ n t ɪ
siðvenja	s ɪ ð v ɛ n j a
sveittur	s v e i h t ʏ r
laslegur	l aː s l ɛː ɣ ʏ r
bötnun	p œ h t n ʏ n
blöðruhálskirtill	p l œ ð r ʏ h a u l s cʰ ɪ r̥ t ɪ t l
hata	h aː t a
gáta	k a uː t a
markúsartorg	m a r̥ k uː s a r tʰ ɔ r k
frjóþráður	f r j o uː θ r a uː ð ʏ r
hlíta	l̥ iː t a
hrynja	r̥ ɪ n j a
borðhnífur	p ɔ r ð n̥ iː v ʏ r
bæti	p a iː t ɪ
lærdómur	l a i r t o uː m ʏ r
goggur	k ɔ kː ʏ r
loftárás	l ɔ f t a uː r a uː s
gallalaus	k a t l a l ø yː s
unndís	ʏ nː t iː s
hjúpur	ç uː p ʏ r
páfi	pʰ a uː v ɪ
hór	h o uː r
drekkja	t r ɛ h c a
krani	kʰ r aː n ɪ
freðmýri	f r ɛ ð m iː r ɪ
hugur	h ʏː ɣ ʏ r
blöndal	p l œ n t aː l
krossfesting	kʰ r ɔ sː f ɛ s t i ŋ k
við	v ɪ ð
jökulhlaup	j œː k ʏ l l̥ ø yː p
blóðflaga	p l o u ð f l aː ɣ a
páskar	p a u s k a r
búfé	p uː f j ɛː
jæja	j a iː j a
streð	s t r ɛː ð
kantur	kʰ a n̥ t ʏ r
mjókka	m j o u h k a
varpi	v a r̥ p ɪ
þarfaþing	θ a r v a θ i ŋ k
garn	k a r t n
ríkur	r iː k ʏ r
happ	h a h p
lausn	l ø y s t n
afstæði	a f s t a iː ð ɪ
sneddí	s t n ɛ tː i
bókasafnsfræðingur	p o uː k a s a p n s f r a iː ð i ŋ k ʏ r
ríki	r iː c ɪ
frásögn	f r a uː s œ k n
draugur	t r ø yː ɣ ʏ r
gjalda	c a l t a
fóstra	f o u s t r a
málmur	m a u l m ʏ r
magapína	m aː ɣ a pʰ iː n a
bursti	p ʏ r̥ s t ɪ
fimmti	f ɪ m̥ t ɪ
heimasími	h e iː m a s iː m ɪ
tryppanál	tʰ r ɪ h p a n a uː l
bárujárn	p a uː r ʏ j a u r t n
endurræsa	ɛ n t ʏ r r a iː s a
balsamedik	p a l s aː m ɛː t i k
hjördís	ç œ r t iː s
nýfæddur	n iː f a i tː ʏ r
göng	k ø y ŋ k
leigja	l e iː j a
frón	f r o uː n
verma	v ɛ r m a
andefni	a n t ɛ p n ɪ
vetur	v ɛː t ʏ r
skartgripur	s k a r̥ t k r ɪː p ʏ r
líka	l iː k a
bitur	p ɪː t ʏ r
deig	t e iː ɣ
fréttablað	f r j ɛ h t a p l aː ð
hrollur	r̥ ɔ t l ʏ r
færa	f a iː r a
saga	s aː ɣ a
stjórnarbylting	s t j o u r t n a r p ɪ l̥ t i ŋ k
byssa	p ɪ sː a
kreista	kʰ r e i s t a
ratsjá	r aː t s j a uː
andvarp	a n t v a r̥ p
skortur	s k ɔ r̥ t ʏ r
treysta	tʰ r e i s t a
hersveit	h ɛ r̥ s v e i t
iða	ɪː ð a
pólska	pʰ o u l s k a
beila	p e iː l a
þvarga	θ v a r k a
blásveifgras	p l a uː s v e i v k r aː s
sónötuform	s o uː n œː t ʏ f ɔ r m
gnarr	k n a rː
eftirmiðdagur	ɛ f t ɪ r m ɪ ð t aː ɣ ʏ r
þarmur	θ a r m ʏ r
lungnaberklar	l u ŋ k n a p ɛ r̥ k l a r
læða	l a iː ð a
valhneta	v a l n̥ ɛː t a
nagladekk	n a k l a t ɛ h k
fregn	f r ɛ k n
kvak	kʰ v aː k
minnisspil	m ɪ nː ɪ s s p ɪː l
feiti	f e iː t ɪ
beltisstaður	p ɛ l̥ t ɪ s s t aː ð ʏ r
brokk	p r ɔ h k
lyfjagras	l ɪ v j a k r aː s
þroski	θ r ɔ s c ɪ
sláttarstöðvun	s t l a u h t a r s t œ ð v ʏ n
sög	s œː ɣ
verkur	v ɛ r̥ k ʏ r
ásdís	a uː s t iː s
geirfugl	c e i r f ʏ k l
vor	v ɔː r
perlumóðir	pʰ ɛ r t l ʏ m o uː ð ɪ r
sjö	s j ø
klausa	kʰ l ø yː s a
frjósemi	f r j o uː s ɛː m ɪ
númera	n uː m ɛː r a
hnjóta	n̥ j o uː t a
samur	s aː m ʏ r
veski	v ɛ s c ɪ
efnahagur	ɛ p n a h aː ɣ ʏ r
reima	r e iː m a
hæfur	h a iː v ʏ r
hjartarfi	ç a r̥ t a r v ɪ
ástfríður	a u s t f r iː ð ʏ r
hafdís	h a v t iː s
réttritun	r j ɛ h t r ɪː t ʏ n
ermi	ɛ r m ɪ
kjökur	cʰ œː k ʏ r
veðurtunglamynd	v ɛː ð ʏ r tʰ u ŋ l a m ɪ n t
ljósberi	l j o uː s p ɛː r ɪ
baula	p ø yː l a
strigi	s t r ɪː j ɪ
ölva	œ l v a
grautur	k r ø yː t ʏ r
skin	s c ɪː n
blakkneskur	p l a h k n ɛ s k ʏ r
samlyndi	s a m l ɪ n t ɪ
kvíði	kʰ v iː ð ɪ
jerúsalem	j ɛː r uː s aː l ɛː m
garpur	k a r̥ p ʏ r
ótt	o u h t
malajíska	m aː l a iː j i s k a
dýpt	t i f t
hækkun	h a i h k ʏ n
húsdýr	h uː s t iː r
feigð	f e i ɣ ð
rotta	r ɔ h t a
skrafa	s k r aː v a
óreglulegur	o uː r ɛ k l ʏ l ɛː ɣ ʏ r
kringlóttur	kʰ r i ŋ l o u h t ʏ r
merkúr	m ɛ r̥ kʰ uː r
fönn	f œ nː
hávarðína	h a uː v a r ð iː n a
óþekkt	o uː θ ɛ x t
blekbytta	p l ɛː k p ɪ h t a
þyrsta	θ ɪ r̥ s t a
einasta	e iː n a s t a
hálka	h a u l̥ k a
ekkja	ɛ h c a
grúpa	k r uː p a
lyklabarn	l ɪ h k l a p a r t n
rómur	r o uː m ʏ r
óheflaður	o uː h ɛ p l aː ð ʏ r
rakari	r aː k aː r ɪ
timburmaður	tʰ ɪ m p ʏ r m aː ð ʏ r
flensa	f l ɛ n s a
hrapa	r̥ aː p a
hrái	r̥ a uː ɪ
friðill	f r ɪː ð ɪ t l
meina	m e iː n a
elgur	ɛ l k ʏ r
samband	s a m p a n t
efnafræði	ɛ p n a f r a iː ð ɪ
vél	v j ɛː l
háspil	h a uː s p ɪː l
dregill	t r e iː j ɪ t l
sullur	s ʏ t l ʏ r
eintyngdur	e i n t i ŋ t ʏ r
körfuvíðir	kʰ œ r v ʏ v iː ð ɪ r
trommari	tʰ r ɔ mː aː r ɪ
sori	s ɔː r ɪ
páskabróðir	pʰ a u s k a p r o uː ð ɪ r
banabeður	p aː n a p ɛː ð ʏ r
sönnun	s œ nː ʏ n
mauraþúfa	m ø yː r a θ uː v a
spindill	s p ɪ n t ɪ t l
rífa	r iː v a
þrýstinn	θ r i s t ɪ nː
sveppur	s v ɛ h p ʏ r
duttlungur	t ʏ h t l u ŋ k ʏ r
germynd	c ɛ r m ɪ n t
íslam	iː s t l aː m
böl	p œː l
kerúb	cʰ ɛː r uː p
veð	v ɛː ð
fróðný	f r o u ð n iː
álmur	a u l m ʏ r
júgur	j uː ʏ r
pappír	pʰ a h p iː r
markgreifi	m a r̥ k k r e iː v ɪ
hægðatregða	h a i ɣ ð a tʰ r ɛ ɣ ð a
fit	f ɪː t
glæpur	k l a iː p ʏ r
þingforseti	θ i ŋ k f ɔ r̥ s ɛː t ɪ
nökkvi	n œ h k v ɪ
andardráttur	a n t a r t r a u h t ʏ r
saltsýra	s a l̥ t s iː r a
forritun	f ɔ rː ɪː t ʏ n
keifa	cʰ e iː v a
kjúka	cʰ uː k a
bylur	p ɪː l ʏ r
oktan	ɔ x t aː n
hnjóðsyrði	n̥ j o u ð s ɪ r ð ɪ
hreysi	r̥ e iː s ɪ
buga	p ʏː ɣ a
búðarþjófur	p uː ð a r θ j o uː v ʏ r
froskdýr	f r ɔ s k t iː r
spá	s p a uː
bakborði	p aː k p ɔ r ð ɪ
blik	p l ɪː k
lögmaður	l œ ɣ m aː ð ʏ r
sifjaspell	s ɪ v j a s p ɛ t l
krókus	kʰ r o uː k ʏ s
munni	m ʏ nː ɪ
drykkjarvatn	t r ɪ h c a r v a h t n
stýra	s t iː r a
fíladelfía	f iː l a t ɛ l f iː j a
fangelsa	f a u ŋ c ɛ l s a
bjór	p j o uː r
stjórnvölur	s t j o u r t n v œː l ʏ r
barnæska	p a r t n a i s k a
katrín	kʰ aː t r iː n
höfn	h œ p n
motta	m ɔ h t a
ló	l o uː
jódís	j o uː t iː s
hnefafylli	n̥ ɛː v a f ɪ t l ɪ
valköstur	v a l kʰ œ s t ʏ r
melanóra	m ɛː l a n o uː r a
framleiðsla	f r a m l e i ð s t l a
gláka	k l a uː k a
miðaldalatína	m ɪː ð a l t a l aː t iː n a
kantaraborg	kʰ a n̥ t a r a p ɔ r k
eftirlit	ɛ f t ɪ r l ɪː t
finnbogi	f ɪ n p ɔ j ɪ
gæruskinn	c a iː r ʏ s c ɪ nː
mætur	m a iː t ʏ r
hægð	h a i ɣ ð
réttur	r j ɛ h t ʏ r
þórmundur	θ o u r m ʏ n t ʏ r
leiðangur	l e iː ð a u ŋ k ʏ r
orkídea	ɔ r̥ c iː t ɛː a
munnþurrka	m ʏ nː θ ʏ r̥ k a
forngríska	f ɔ r t n k r i s k a
ið	ɪː ð
samheitaorðabók	s a m h e iː t a ɔ r ð a p o uː k
hrísgrjónavín	r̥ iː s k r j o uː n a v iː n
cís	s iː s
gaul	k ø yː l
glundra	k l ʏ n t r a
fuglakjöt	f ʏ k l a cʰ œː t
leynd	l e i n t
jagúar	j aː k uː a r
styrmir	s t ɪ r m ɪ r
hótfyndni	h o uː t f ɪ n t n ɪ
lesblindur	l ɛː s p l ɪ n t ʏ r
gleðikona	k l ɛː ð ɪ kʰ ɔː n a
gráðugur	k r a uː ð ʏː ɣ ʏ r
gagnauga	k a k n ø yː ɣ a
gulur	k ʏː l ʏ r
glymja	k l ɪ m j a
hádegisverður	h a uː t e iː j ɪ s v ɛ r ð ʏ r
sifjarsóley	s ɪ v j a r s o uː l e iː
lesta	l ɛ s t a
prísund	pʰ r iː s ʏ n t
tötur	tʰ œː t ʏ r
vel	v ɛː l
tóbak	tʰ o uː p aː k
tvísykra	tʰ v iː s ɪː k r a
nauða	n ø yː ð a
kústur	kʰ u s t ʏ r
snjótittlingur	s n j o uː tʰ ɪ h t l i ŋ k ʏ r
aðalfylking	aː ð a l f ɪ l̥ c i ŋ k
blaðamaður	p l aː ð a m aː ð ʏ r
dýna	t iː n a
klám	kʰ l a uː m
íkornabygg	iː kʰ ɔ r t n a p ɪ kː
hálfkák	h a u l v kʰ a uː k
grjón	k r j o uː n
hjúkrun	ç uː k r ʏ n
móða	m o uː ð a
ausa	ø yː s a
stunda	s t ʏ n t a
kröfuganga	kʰ r œː v ʏ k a u ŋ k a
glyrna	k l ɪ r t n a
eftirför	ɛ f t ɪ r f œː r
hvítmosi	kʰ v iː t m ɔː s ɪ
sturta	s t ʏ r̥ t a
endir	ɛ n t ɪ r
skarfakál	s k a r v a kʰ a uː l
ljósta	l j o u s t a
hæða	h a iː ð a
nák	n a uː k
knýja	kʰ n iː j a
þáttur	θ a u h t ʏ r
droplaug	t r ɔː p l ø yː ɣ
angi	a u ɲ c ɪ
bað	p aː ð
útland	uː t l a n t
pínulítill	pʰ iː n ʏ l iː t ɪ t l
framreiðsla	f r a m r e i ð s t l a
prakkari	pʰ r a h k aː r ɪ
áll	a u t l
margæs	m a r c a iː s
járning	j a u r t n i ŋ k
kaupa	kʰ ø yː p a
mastur	m a s t ʏ r
hjalt	ç a l̥ t
svífa	s v iː v a
helvískur	h ɛ l v i s k ʏ r
lögfræðingur	l œ ɣ f r a iː ð i ŋ k ʏ r
aðalsögn	aː ð a l s œ k n
sandlægja	s a n t l a iː j a
víkja	v iː c a
forma	f ɔ r m a
löggjöf	l œ ɣ c œː v
drottnari	t r ɔ h t n a r ɪ
hefnd	h ɛ m t
hagnaður	h a k n a ð ʏ r
last	l a s t
munda	m ʏ n t a
sólveig	s o u l v e iː ɣ
lofa	l ɔː v a
strikamerki	s t r ɪː k a m ɛ r̥ c ɪ
granni	k r a nː ɪ
hrörnun	r̥ œ r t n ʏ n
muna	m ʏː n a
viss	v ɪ sː
gissurína	c ɪ sː ʏ r iː n a
kommúna	kʰ ɔ mː uː n a
feluleikur	f ɛː l ʏ l e iː k ʏ r
herðatré	h ɛ r ð a t r j ɛː
argentína	a r k ɛ n tʰ iː n a
mosagrænn	m ɔː s a k r a i t n
skora	s k ɔː r a
málverk	m a u l v ɛ r̥ k
ölur	œː l ʏ r
almætti	a l m a i h t ɪ
brandari	p r a n t aː r ɪ
millimetri	m ɪ lː ɪ m ɛː t r ɪ
seifur	s e iː v ʏ r
faggi	f a cː ɪ
stórhertogi	s t o uː r h ɛ r̥ tʰ ɔ j ɪ
hringtorg	r̥ i ŋ k tʰ ɔ r k
hansína	h a n s iː n a
föðurbróðir	f œː ð ʏ r p r o uː ð ɪ r
annríki	a nː r iː c ɪ
elda	ɛ l t a
ruddi	r ʏ tː ɪ
skarfur	s k a r v ʏ r
póstmódernismi	p o u s t m o uː t ɛ r n ɪ s m ɪ
spurnaratviksorð	s p ʏ r t n a r aː t v ɪ k s ɔ r ð
verpa	v ɛ r̥ p a
æpa	a iː p a
aðfangadagur	a ð f a u ŋ k a t aː ɣ ʏ r
sófi	s o uː f ɪ
kornsúra	kʰ ɔ r t n s uː r a
syrjóttur	s ɪ r j o u h t ʏ r
eldstæði	ɛ l t s t a iː ð ɪ
parís	pʰ aː r iː s
maría	m aː r iː j a
pæla	pʰ a iː l a
verulegur	v ɛː r ʏ l ɛː ɣ ʏ r
alpahúfa	a l̥ p a h uː v a
hegða	h ɛ ɣ ð a
skriðsóley	s k r ɪ ð s o uː l e iː
hertogi	h ɛ r̥ tʰ ɔ j ɪ
hleypa	l̥ e iː p a
lík	l iː k
stækja	s t a iː c a
lumpa	l ʏ m̥ p a
dripla	t r ɪ h p l a
sleipur	s t l e iː p ʏ r
greni	k r ɛː n ɪ
júði	j uː ð ɪ
tala	tʰ aː l a
þyrstur	θ ɪ r̥ s t ʏ r
rín	r iː n
hálendi	h a uː l ɛ n t ɪ
dyntóttur	t ɪ n̥ t o u h t ʏ r
dreki	t r ɛː c ɪ
mengun	m e i ŋ k ʏ n
moldavía	m ɔ l t a v iː j a
brúður	p r uː ð ʏ r
hettumáfur	h ɛ h t a m a uː v ʏ r
þumall	θ ʏː m a t l
plástur	pʰ l a u s t ʏ r
kirkjugarður	cʰ ɪ r̥ c ʏ k a r ð ʏ r
snertill	s n ɛ r̥ t ɪ t l
svindla	s v ɪ n t l a
hrjúfur	r̥ j uː v ʏ r
einræði	e i n r a iː ð ɪ
allsber	a l s p ɛː r
sæti	s a iː t ɪ
brum	p r ʏː m
amerískur	aː m ɛː r i s k ʏ r
stjórnmál	s t j o u r t n m a uː l
illmælgi	ɪ t l m a i l c ɪ
ljóstýra	l j o uː s tʰ iː r a
hálsfesti	h a u l s f ɛ s t ɪ
tungljurt	tʰ u ŋ l j ʏ r̥ t
aga	aː ɣ a
tá	tʰ a uː
tengja	tʰ e i ɲ c a
fallbeyging	f a t l b e iː j i ŋ k
hornhraði	h ɔ r t n r̥ aː ð ɪ
offita	ɔ f f ɪː t a
önugur	œː n ʏː ɣ ʏ r
sorti	s ɔ r̥ t ɪ
innfeldi	ɪ nː f ɛ l t ɪ
ferð	f ɛ r ð
laktasi	l a x t aː s ɪ
óáreiðanlegur	o uː a uː r e iː ð a n l ɛː ɣ ʏ r
galgopi	k a l k ɔː p ɪ
fjarski	f j a r̥ s c ɪ
breki	p r ɛː c ɪ
snerta	s n ɛ r̥ t a
lunti	l ʏ n̥ t ɪ
konsúll	kʰ ɔ n s u t l
miðmynd	m ɪ ð m ɪ n t
kveðja	kʰ v ɛ ð j a
sálumessa	s a uː l ʏ m ɛ sː a
þorgeir	θ ɔ r k e iː r
heyrnarlaus	h e i r t n a r l ø yː s
dúdúfugl	t uː t uː f ʏ k l
árabátur	a uː r a p a uː t ʏ r
frank	f r a ŋ̊ k
hjarta	ç a r̥ t a
þvottur	θ v ɔ h t ʏ r
stirðlegur	s t ɪ r ð l ɛː ɣ ʏ r
níð	n iː ð
slokkna	s t l ɔ h k n a
hróarskelda	r̥ o uː a r̥ s cʰ ɛ l t a
strjálingur	s t r j a uː l i ŋ k ʏ r
auðmýkja	ø y ð m iː c a
kápa	kʰ a uː p a
skjóttur	s c o u h t ʏ r
elri	ɛ l r ɪ
línuskauti	l iː n ʏ s k ø yː t ɪ
fylli	f ɪ t l ɪ
híbýli	h iː p iː l ɪ
títra	tʰ iː t r a
vit	v ɪː t
bólstur	p o u l s t ʏ r
fönix	f œː n ɪ x s
sokkur	s ɔ h k ʏ r
mamma	m a mː a
fordæmi	f ɔ r t a iː m ɪ
var	v aː r
vaf	v aː v
værð	v a i r ð
byrkningur	p ɪ r̥ k n i ŋ k ʏ r
ropi	r ɔː p ɪ
dalmatía	t a l m a tʰ iː j a
borgaralegur	p ɔ r k aː r a l ɛː ɣ ʏ r
blæðari	p l a iː ð a r ɪ
halla	h a t l a
skellihlæja	s c ɛ t l ɪ l̥ a iː j a
klarínett	kʰ l aː r iː n ɛ h t
grænspæta	k r a i n s p a iː t a
hýðishrísgrjón	h iː ð ɪ s r̥ iː s k r j o uː n
bleyta	p l e iː t a
brandönd	p r a n t œ n t
vök	v œː k
hegna	h ɛ k n a
mjólkurkýr	m j o u l̥ k ʏ r cʰ iː r
nafn	n a p n
hlið	l̥ ɪː ð
hugsjónamaður	h ʏ x s j o uː n a m aː ð ʏ r
seiða	s e iː ð a
trúarlegur	tʰ r uː a r l ɛː ɣ ʏ r
uggur	ʏ kː ʏ r
skikkja	s k ɪ h c a
frost	f r ɔ s t
sef	s ɛː v
rekill	r ɛː c ɪ t l
sigra	s ɪ ɣ r a
kippur	cʰ ɪ h p ʏ r
ástþrúður	a u s t θ r uː ð ʏ r
bragðskyn	p r a ɣ ð s c ɪː n
armur	a r m ʏ r
drífa	t r iː v a
míkrófónn	m iː k r o uː f o u t n
svar	s v aː r
hæka	h a iː k a
dýri	t iː r ɪ
orðabók	ɔ r ð a p o uː k
kjarr	cʰ a rː
bandstrik	p a n t s t r ɪː k
platína	pʰ l aː tʰ iː n a
bar	p aː r
upptrekktur	ʏ h p tʰ r ɛ x t ʏ r
lið	l ɪː ð
útskýra	uː t s c iː r a
rýja	r iː j a
hempa	h ɛ m̥ p a
sjúga	s j uː a
þórólfur	θ o uː r o u l v ʏ r
vör	v œː r
geldingahnappur	c ɛ l t i ŋ k a n̥ a h p ʏ r
spánarkerfill	s p a uː n a r cʰ ɛ r v ɪ t l
hrókera	r̥ o uː k ɛː r a
krónprins	kʰ r o u n pʰ r ɪ n s
aðalbraut	aː ð a l p r ø yː t
skyrpa	s c ɪ r̥ p a
fen	f ɛː n
kala	kʰ aː l a
þruma	θ r ʏː m a
vinna	v ɪ nː a
sjoppa	s j ɔ h p a
pláss	pʰ l a u sː
bismút	p ɪ s m uː t
gríður	k r iː ð ʏ r
skoða	s k ɔː ð a
rusti	r ʏ s t ɪ
sjón	s j o uː n
prettur	pʰ r ɛ h t ʏ r
suddi	s ʏ tː ɪ
dýrabúð	t iː r a p uː ð
hæfileiki	h a iː v ɪ l e iː c ɪ
stemma	s t ɛ mː a
hersegóvína	h ɛ r̥ s ɛː k o uː v iː n a
kasta	kʰ a s t a
árstíð	a u r s tʰ iː ð
abbadís	a pː a t iː s
kaffi	kʰ a fː ɪ
fjallasveifgras	f j a t l a s v e i v k r aː s
svikari	s v ɪː k aː r ɪ
þykja	θ ɪː c a
púpa	pʰ uː p a
blendingur	p l ɛ n t i ŋ k ʏ r
mávur	m a uː v ʏ r
slúður	s t l uː ð ʏ r
lísa	l iː s a
glær	k l a iː r
lóðleit	l o u ð l e iː t
freta	f r ɛː t a
mannfræði	m a nː f r a iː ð ɪ
herkinn	h ɛ r̥ c ɪ nː
liþín	l ɪː θ iː n
hlekkja	l̥ ɛ h c a
bragð	p r a ɣ ð
klökkna	kʰ l œ h k n a
róðukross	r o uː ð ʏ kʰ r ɔ sː
nifteind	n ɪ f t e i n t
miða	m ɪː ð a
gallblaðra	k a t l p l a ð r a
smiðja	s m ɪ ð j a
náttúrulegur	n a u h t uː r ʏ l ɛ ɣ ʏ r
algjörlega	a l c œ r l ɛː ɣ a
líkkista	l iː k cʰ ɪ s t a
skófla	s k o u p l a
röð	r œː ð
kringla	kʰ r i ŋ l a
flórída	f l o uː r i t a
safna	s a p n a
einrækta	e i n r a i x t a
settaug	s ɛː t tʰ ø yː ɣ
marxismi	m a r̥ k s ɪ s m ɪ
amöba	aː m œː p a
kátur	kʰ a uː t ʏ r
spretta	s p r ɛ h t a
ungverska	u ŋ k v ɛ r̥ s k a
freðinn	f r ɛː ð ɪ nː
stinnastör	s t ɪ nː a s t œː r
litháíska	l ɪː t h a uː i s k a
hófur	h o uː v ʏ r
brugg	p r ʏ kː
sjöundi	s j œː ʏ n t ɪ
handa	h a n t a
pétur	p j ɛː t ʏ r
sykurrófa	s ɪː k ʏ r r o uː v a
óvild	o uː v ɪ l t
kæpa	cʰ a iː p a
flá	f l a uː
þorleifína	θ ɔ r l e iː v iː n a
káeta	kʰ a uː ɛː t a
dylgjur	t ɪ l c ʏ r
slappur	s t l a h p ʏ r
nafnliður	n a p n l ɪː ð ʏ r
mekka	m ɛ h k a
viðeigandi	v ɪː ð e iː ɣ a n t ɪ
gjóður	c o uː ð ʏ r
djóka	t j o uː k a
jarlsfrú	j a r t l s f r uː
grunnli	k r ʏ nː l ɪ
reiðufé	r e iː ð ʏ f j ɛː
bráður	p r a uː ð ʏ r
þriðji	θ r ɪ ð j ɪ
stjórn	s t j o u r t n
fastanefnd	f a s t a n ɛ m t
hjartanykra	ç a r̥ t a n ɪː k r a
klínískur	kʰ l iː n i s k ʏ r
myndavél	m ɪ n t a v j ɛː l
vitrun	v ɪː t r ʏ n
ræll	r a i t l
njóli	n j o uː l ɪ
rustikus	r ʏ s t ɪ kʰ ʏ s
skráning	s k r a uː n i ŋ k
kvikmynd	kʰ v ɪː k m ɪ n t
ósk	o u s k
þota	θ ɔː t a
rakafullur	r aː k a f ʏ t l ʏ r
málari	m a uː l aː r ɪ
fóarn	f o uː a r t n
dagblaðapappír	t a ɣ p l aː ð a p a h p iː r
hrækja	r̥ a iː c a
skyndilegur	s c ɪ n t ɪ l ɛː ɣ ʏ r
skírnarfontur	s c i r t n a r f ɔ n̥ t ʏ r
sækja	s a iː c a
frægur	f r a iː ɣ ʏ r
felling	f ɛ t l i ŋ k
anna	a nː a
fang	f a u ŋ k
ál	a uː l
kampur	kʰ a m̥ p ʏ r
danskur	t a n s k ʏ r
kurteisi	kʰ ʏ r̥ t e iː s ɪ
breyta	p r e iː t a
lortur	l ɔ r̥ t ʏ r
vatnsmelóna	v a sː m ɛː l o uː n a
kofaþorp	kʰ ɔː v a θ ɔ r̥ p
hungur	h u ŋ k ʏ r
litur	l ɪː t ʏ r
kyrrsetning	cʰ ɪ r s ɛ h t n i ŋ k
refsing	r ɛ f s i ŋ k
dílaskóf	t iː l a s k o uː v
fórnarlamb	f o u r t n a r l a m p
malurt	m aː l ʏ r̥ t
póll	pʰ o u t l
kráka	kʰ r a uː k a
ærsl	a i r s t l
bryggja	p r ɪ cː a
blóðmör	p l o u ð m œː r
lengd	l e i ŋ k t
viðja	v ɪ ð j a
lygari	l ɪː ɣ aː r ɪ
gallabuxur	k a lː a p ʏ x s ʏ r
treyja	tʰ r e iː j a
kúfa	kʰ uː v a
þakklátur	θ a h k l a uː t ʏ r
glóð	k l o uː ð
ýsa	iː s a
gráða	k r a uː ð a
þjóðerni	θ j o uː ð ɛ r t n ɪ
háttaratviksorð	h a u h t a r aː t v ɪ k s ɔ r ð
höfundur	h œː v ʏ n t ʏ r
hnallur	n̥ a t l ʏ r
nötra	n œː t r a
endurskoðandi	ɛ n t ʏ r s k ɔː ð a n t ɪ
liðugur	l ɪː ð ʏː ɣ ʏ r
skrifstofa	s k r ɪ f s t ɔː v a
yfirheiti	ɪː v ɪ r h e iː t ɪ
gína	c iː n a
fáránlegur	f a uː r a u n l ɛː ɣ ʏ r
smokkar	s m ɔ h k a r
kefla	cʰ ɛ p l a
sveppafræði	s v ɛ h p a f r a iː ð ɪ
króna	kʰ r o u n a
hippi	h ɪ h p ɪ
kraftaverk	kʰ r a f t a v ɛ r̥ k
dömubindi	t œː m ʏ p ɪ n t ɪ
skelfiskur	s c ɛː l f ɪ s k ʏ r
rót	r o uː t
strengur	s t r e i ŋ k ʏ r
framlengja	f r a m l e i ɲ c a
ferja	f ɛ r j a
vist	v ɪ s t
grasafræði	k r aː s a f r a iː ð ɪ
rola	r ɔː l a
fjallaþinur	f j a t l a θ ɪː n ʏ r
krimmi	kʰ r ɪ mː ɪ
sagnbót	s a k n p o uː t
ögmunda	œ ɣ m ʏ n t a
flengur	f l e i ŋ k ʏ r
hjakka	ç a h k a
gisti	c ɪ s t ɪ
þess	θ ɛ sː
háttarökfræði	h a u h t a r œ k f r a iː ð ɪ
sögur	s œː ɣ ʏ r
prjón	pʰ r j o uː n
hópur	h o uː p ʏ r
þyngd	θ i ŋ t
dreif	t r e iː v
montinn	m ɔ n̥ t ɪ nː
mæla	m a iː l a
tún	tʰ uː n
stofnfélagi	s t ɔ p n f j ɛː l aː j ɪ
tölvumús	tʰ œ l v ʏ m uː s
pólland	p o u l l a n t
sporvagn	s p ɔ r v a k n
lensa	l ɛ n s a
fyrirgangur	f ɪː r ɪ r k a u ŋ k ʏ r
kólibrífugl	kʰ o uː l ɪ p r iː f ʏ k l
rúða	r uː ð a
skjaldberi	s c a l t b ɛː r ɪ
eyðilegging	e iː ð ɪ l ɛ cː i ŋ k
ljótur	l j o uː t ʏ r
metfé	m ɛː t f j ɛː
mítur	m iː t ʏ r
krafa	kʰ r aː v a
lýja	l iː j a
vitur	v ɪː t ʏ r
kanna	kʰ a nː a
vekja	v ɛː c a
aukafall	ø yː k a f a t l
fátækur	f a uː tʰ a iː k ʏ r
bláber	p l a uː p ɛː r
bók	p o uː k
pomp	pʰ ɔ m̥ p
runólfína	r ʏː n o u l v iː n a
druna	t r ʏː n a
svanur	s v aː n ʏ r
breiðnefur	p r e i ð n ɛː v ʏ r
baka	p aː k a
samhljómur	s a m l̥ j o uː m ʏ r
hnoða	n̥ ɔː ð a
villigöltur	v ɪ t l ɪ k œ l̥ t ʏ r
kanarífugl	kʰ aː n a r iː f ʏ k l
spaði	s p aː ð ɪ
hrímblaðka	r̥ i m p l a ð k a
læti	l a iː t ɪ
sveigja	s v e iː j a
ágirnd	a uː c ɪ r n t
drottna	t r ɔ h t n a
kjörskrá	cʰ œ r s k r a uː
konungsveldi	kʰ ɔː n u ŋ k s v ɛ l t ɪ
textavarp	tʰ ɛ x s t a v a r̥ p
gróðurhús	k r o uː ð ʏ r h uː s
tattóvera	tʰ aʰ t o u v ɛ r a
líkna	l i h k n a
lúga	l uː a
sarí	s aː r iː
jarþrúður	j a r̥ θ r uː ð ʏ r
gýgur	c iː ɣ ʏ r
hryssa	r̥ ɪ sː a
örva	œ r v a
grennd	k r ɛ n t
hvíla	kʰ v iː l a
baggi	p a cː ɪ
viðtal	v ɪ ð tʰ aː l
bauja	p ø yː j a
forða	f ɔ r ð a
skipaskurður	s c ɪː p a s k ʏ r ð ʏ r
þunnur	θ ʏ nː ʏ r
hálmgresi	h a u l m k r ɛː s ɪ
kvikur	kʰ v ɪː k ʏ r
spíra	s p iː r a
hjólbarði	ç o u l p a r ð ɪ
hlaði	l̥ aː ð ɪ
laga	l aː ɣ a
áhöfn	a uː h œ p n
súta	s uː t a
skafl	s k a p l
finka	f i ŋ̊ k a
mölur	m œː l ʏ r
hamar	h aː m a r
karmur	kʰ a r m ʏ r
hringlaga	r̥ i ŋ k l aː ɣ a
gíbraltar	c iː p r a l̥ t aː r
sverrína	s v ɛ rː iː n a
töff	tʰ œ fː
niðurgangur	n ɪː ð ʏ r k a u ŋ k ʏ r
drangi	t r a u ɲ c ɪ
rúnna	r u nː a
björg	p j œ r k
ýla	iː l a
framkvæmd	f r a m kʰ v a i m t
æður	a iː ð ʏ r
vafri	v a v r ɪ
bjartur	p j a r̥ t ʏ r
strekkja	s t r ɛ h c a
fáni	f a uː n ɪ
pota	pʰ ɔː t a
stél	s t j ɛː l
æta	a iː t a
hrókering	r̥ o uː c ɛ r i ŋ k
mýramaðra	m iː r a m a ð r a
ól	o uː l
stæra	s t a iː r a
tefja	tʰ ɛ v j a
gæla	c a iː l a
aþena	aː θ ɛː n a
upplýsing	ʏ h p l iː s i ŋ k
pýroxen	pʰ iː r ɔ k s ɛː n
sjaldan	s j a l t a n
þýska	θ i s k a
mínúta	m iː n uː t a
bróm	p r o uː m
hellir	h ɛ t l ɪ r
málmblásturshljóðfæri	m a u l m p l a u s t ʏ r̥ s l̥ j o u ð f a iː r ɪ
úti	uː t ɪ
tapa	tʰ aː p a
fjallhæra	f j a t l h a iː r a
tvístra	tʰ v i s t r a
vindur	v ɪ n t ʏ r
þýfi	θ iː v ɪ
rætur	r a iː t ʏ r
rithöfundur	r ɪː t h œː v ʏ n t ʏ r
miðvörður	m ɪ ð v œ r ð ʏ r
hrólfur	r̥ o u l v ʏ r
skipun	s c ɪː p ʏ n
stýri	s t iː r ɪ
neðanjarðarbraut	n ɛː ð a n j a r ð a r p r ø yː t
rangla	r a u ŋ l a
örlítill	œ r l iː t ɪ t l
kára	kʰ a uː r a
kefja	c ɛ v j a
lyndi	l ɪ n t ɪ
syrgja	s ɪ r c a
litín	l ɪː tʰ iː n
svekkja	s v ɛ h c a
loka	l ɔː k a
hjáleið	ç a uː l e iː ð
zóphonías	s o uː f ɔː n iː j a s
þræll	θ r a i t l
trikk	tʰ r ɪ h k
forskot	f ɔ r̥ s k ɔː t
móta	m o uː t a
mont	m ɔ n̥ t
snúður	s t n uː ð ʏ r
haustlegur	h ø y s t l ɛː ɣ ʏ r
tími	tʰ iː m ɪ
rauðkál	r ø y ð kʰ a uː l
hljóta	l̥ j o uː t a
grafít	k r aː f iː t
skurðaðgerð	s k ʏ r ð a ð c ɛ r ð
sérhljóð	s j ɛː r l̥ j o uː ð
lyftutónlist	l ɪ f t ʏ tʰ o u n l ɪ s t
rógur	r o uː ʏ r
fís	f iː s
reður	r ɛː ð ʏ r
holdvotur	h ɔ l t v ɔː t ʏ r
stimpill	s t ɪ m̥ p ɪ t l
landslag	l a n s l aː ɣ
klæðaskápur	kʰ l a iː ð a s k a uː p ʏ r
þjöl	θ j œː l
tölustafur	tʰ œː l ʏ s t aː v ʏ r
jórtra	j o u r̥ t r a
káfa	kʰ a uː v a
hjaltalín	ç a l̥ t a l iː n
mýfluga	m iː f l ʏː ɣ a
einelti	e iː n ɛ l̥ t ɪ
michelsen	m ɪ h k ɛ l s ɛ nː
borgari	p ɔ r k aː r ɪ
tylla	tʰ ɪ t l a
strætisvagn	s t r a iː t ɪ s v a k n
snákur	s t n a uː k ʏ r
átelja	a uː tʰ ɛ l j a
fálm	f a u l m
kví	kʰ v iː
galdur	k a l t ʏ r
ingunn	i ŋ k ʏ nː
grænmeti	k r a i n m ɛː t ɪ
bekkjarlalli	p ɛ h c a r l a t l ɪ
skilningur	s c ɪ l n i ŋ k ʏ r
bráð	p r a uː ð
skalla	s k a t l a
blaðsíða	p l a ð s iː ð a
stormur	s t ɔ r m ʏ r
spánn	s p a u t n
sumarhnoðri	s ʏː m a r n̥ ɔ ð r ɪ
fjöl	f j œː l
innlendur	ɪ nː l ɛ n t ʏ r
bensínsala	p ɛ n s i n s aː l a
herfi	h ɛ r v ɪ
alheimur	aː l h e iː m ʏ r
ásjálegur	a uː s j a uː l ɛː ɣ ʏ r
sykur	s ɪː k ʏ r
hjarni	ç a r t n ɪ
snæland	s n a iː l a n t
páka	pʰ a uː k a
sorta	s ɔ r̥ t a
tepra	tʰ ɛː p r a
martröð	m a r̥ tʰ r œː ð
eistalyppa	e i s t a l ɪ h p a
heimskaut	h e i m s k ø yː t
sekkur	s ɛ h k ʏ r
langamma	l a u ŋ k a mː a
aðalsetning	aː ð a l s ɛ h t n i ŋ k
grjóni	k r j o uː n ɪ
skari	s k aː r ɪ
regnskógur	r ɛ k n s k o uː ʏ r
skoti	s k ɔː t ɪ
gjósa	c o uː s a
gjamm	c a mː
dalalilja	t aː l a l ɪ l j a
fjöltyngdur	f j œ l tʰ i ŋ t ʏ r
rétta	r j ɛ h t a
toddi	tʰ ɔ tː ɪ
kerfi	cʰ ɛ r v ɪ
dráttartaug	t r a u h t a r tʰ ø yː ɣ
kalsín	kʰ a l s iː n
banki	p a u ɲ̊ c ɪ
núll	n u lː
fyllirí	f ɪ t l ɪ r i
hjónaband	ç o uː n a p a n t
handknattleikur	h a n t kʰ n a h t l e iː k ʏ r
bolludagur	p ɔ lː ʏ t aː ɣ ʏ r
kirsuberjatré	cʰ ɪ r̥ s ʏ p ɛ r j a tʰ r j ɛː
sýnn	s i t n
slarka	s t l a r̥ k a
hlað	l̥ aː ð
valkostur	v a l kʰ ɔ s t ʏ r
refur	r ɛː v ʏ r
geislaspilari	c e i s t l a s p ɪː l aː r ɪ
grávorblóm	k r a uː v ɔ r p l o uː m
lottó	l ɔ h t o uː
brussel	p r ʏ sː ɛ l
samtenging	s a m tʰ e i ɲ c i ŋ k
miðnætti	m ɪ ð n a i h t ɪ
sníkill	s t n iː c ɪ t l
lög	l œː ɣ
kveif	kʰ v e iː v
vasadiskó	v aː s a t ɪ s k o uː
lævís	l a iː v iː s
biðja	p ɪ ð j a
il	ɪː l
unnusta	ʏ nː ʏ s t a
þinn	θ ɪ nː
grýla	k r iː l a
frændsemi	f r a i n t s ɛː m ɪ
sunnudagur	s ʏ nː ʏ t aː ɣ ʏ r
brennivín	p r ɛ nː ɪ v iː n
daus	t ø yː s
svik	s v ɪː k
vinkill	v i ɲ̊ c ɪ t l
sótt	s o u h t
drungi	t r u ɲ c ɪ
brenna	p r ɛ nː a
evra	ɛ v r a
bernharðína	p ɛ r n h a r ð iː n a
hamingja	h aː m i ɲ c a
fjólmundur	f j o u l m ʏ n t ʏ r
geimfar	c e i m f aː r
trjóna	tʰ r j o uː n a
gerla	c ɛ r t l a
nytsemi	n ɪː t s ɛː m ɪ
hatur	h aː t ʏ r
sjór	s j o uː r
tiltekinn	tʰ ɪː l tʰ ɛː c ɪ nː
garðar	k a r ð a r
nefna	n ɛ p n a
ball	p a lː
áfir	a uː v ɪ r
ríkharður	r iː k h a r ð ʏ r
hampjurt	h a m̥ p j ʏ r̥ t
smokkur	s m ɔ h k ʏ r
nemandi	n ɛː m a n t ɪ
aragrúi	aː r a k r uː ɪ
hjá	ç a uː
miltu	m ɪ l̥ t ʏ
botnlangi	p ɔ h t n l a u ŋ c ɪ
finnast	f ɪ nː a s t
máta	m a uː t a
bann	p a nː
hommi	h ɔ mː ɪ
brómber	p r o u m p ɛː r
kortér	kʰ ɔ r̥ t j ɛ r
frestun	f r ɛ s t ʏ n
jökull	j œː k ʏ t l
vol	v ɔː l
tignarlegur	tʰ ɪ k n a r l ɛː ɣ ʏ r
vínandi	v iː n a n t ɪ
kokkur	kʰ ɔ h k ʏ r
móanóra	m o uː a n o uː r a
regnkápa	r ɛ k n kʰ a uː p a
yndi	ɪ n t ɪ
óvína	o uː v iː n a
forvöð	f ɔ r v œː ð
derringur	t ɛ rː i ŋ k ʏ r
hænuegg	h a iː n ʏ ɛ kː
pynta	pʰ ɪ n̥ t a
snarpur	s n a r̥ p ʏ r
hrjóta	r̥ j o uː t a
fljóta	f l j o uː t a
lak	l aː k
trymbill	tʰ r ɪ m p ɪ t l
freygerður	f r e iː c ɛ r ð ʏ r
selma	s ɛ l m a
ernir	ɛ r t n ɪ r
bakkus	p a h k ʏ s
fingur	f i ŋ k ʏ r
ásókn	a uː s o u h k n
kamar	kʰ aː m a r
bölvun	p œ l v ʏ n
málsháttur	m a u l s h a u h t ʏ r
ljóstillífun	l j o uː s t ɪ l l iː v ʏ n
skaka	s k aː k a
hrefna	r̥ ɛ p n a
metnaður	m ɛ h t n aː ð ʏ r̥
hönd	h œ n t
voga	v ɔː ɣ a
geil	c e iː l
bolli	p ɔ t l ɪ
stöðva	s t œ ð v a
peysa	pʰ e iː s a
slitna	s t l ɪ h t n a
búningur	p uː n i ŋ k ʏ r
þrátta	θ r a u h t a
brekkusnigill	p r ɛ h k ʏ s t n ɪː j ɪ t l
löpp	l œ h p
rabba	r a pː a
liður	l ɪː ð ʏ r
árás	a uː r a uː s
kattarjurt	kʰ a h t a r j ʏ r̥ t
lára	l a uː r a
úkraínska	uː kʰ r a i n s k a
stokkhólmur	s t ɔ h k h o u l m ʏ r
predika	pʰ r ɛː t ɪː k a
styrkur	s t ɪ r̥ k ʏ r
jósefína	j o uː s ɛː f iː n a
oj	ɔ iː
fyrirgera	f ɪː r ɪ r c ɛː r a
tilviljun	tʰ ɪ l v ɪ l j ʏ n
leiðarstef	l e iː ð a r s t ɛː v
kanada	kʰ aː n aː t a
svartsýnn	s v a r̥ t s i t n
nót	n o uː t
felga	f ɛ l k a
melta	m ɛ l̥ t a
skagi	s k aː j ɪ
blóðormur	p l o uː ð ɔ r m ʏ r
jörð	j œ r ð
himnaríki	h ɪ m n a r iː c ɪ
bót	p o uː t
árangur	a uː r a u ŋ k ʏ r
reiði	r e iː ð ɪ
eðja	ɛ ð j a
krossfífill	kʰ r ɔ sː f iː v ɪ t l
saggi	s a cː ɪ
gotland	k ɔː t l a n t
matvara	m aː t v aː r a
velja	v ɛ l j a
pálína	pʰ a uː l iː n a
ekta	ɛ x t a
heiladingull	h e iː l a t i ŋ k ʏ t l
yfirlæti	ɪː v ɪ r l a iː t ɪ
þverskurður	θ v ɛ r s k ʏ r ð ʏ r
glepja	k l ɛː p j a
sykra	s ɪː k r a
brún	p r uː n
fetta	f ɛ h t a
gunnur	k ʏ nː ʏ r
bæjar	p a iː j a r̥
prímtala	pʰ r i m tʰ aː l a
gjamma	c a mː a
kroppa	kʰ r ɔ h p a
frelsi	f r ɛ l s ɪ
hreinn	r̥ e i t n
láland	l a uː l a n t
nifl	n ɪ p l
stör	s t œː r
bjóða	p j o uː ð a
gúrkutíð	k u r̥ k ʏ tʰ iː ð
kapp	kʰ a h p
blússa	p l u sː a
svöfn	s v œ p n
kantata	kʰ a n̥ t aː t a
stjarfi	s t j a r v ɪ
veggur	v ɛ kː ʏ r
gelding	c ɛ l t i ŋ k
aðaláhugamál	aː ð aː l a uː h ʏː ɣ a m a uː l
afla	a p l a
kjánaskapur	cʰ a uː n a s k aː p ʏ r
hárbursti	h a u r p ʏ r̥ s t ɪ
skína	s c iː n a
benjamín	p ɛ n j a m iː n
þrítyngdur	θ r iː tʰ i ŋ t ʏ r
tvístirni	tʰ v iː s t ɪ r t n ɪ
sekvensa	s ɛː kʰ v ɛ n s a
salka	s a l̥ k a
kóraltoppur	kʰ o uː r a l tʰ ɔ h p ʏ r
stari	s t aː r ɪ
eiði	e iː ð ɪ
förðun	f œ r ð ʏ n
anddyri	a n t t ɪː r ɪ
verufall	v ɛː r ʏ f a t l
miði	m ɪː ð ɪ
england	e i ŋ l a n t
sleggjukast	s t l ɛ cː ʏ kʰ a s t
piparúði	pʰ ɪː p a r uː ð ɪ
ritgerð	r ɪː t c ɛ r ð
jakob	j aː kʰ ɔː p
svikull	s v ɪː k ʏ t l
siður	s ɪː ð ʏ r
bliki	p l ɪː c ɪ
skjóla	s c o uː l a
getnaðarlimur	c ɛ h t n aː ð a r l ɪː m ʏ r
kvíga	kʰ v iː ɣ a
iðnaður	ɪ ð n aː ð ʏ r
bakvörður	p aː k v œ r ð ʏ r
köllun	kʰ œ t l ʏ n
áhætta	a uː h a i h t a
lundúnir	l ʏ n t uː n ɪ r
naust	n ø y s t
miskunn	m ɪ s k ʏ nː
óttast	o u h t a s t
hræ	r̥ a iː
kjallari	cʰ a t l aː r ɪ
tjakkur	tʰ j a h k ʏ r
banga	p a u ŋ k a
ýmis	iː m ɪ s
ferjumaður	f ɛ r j ʏ m aː ð ʏ r
kennslustund	cʰ ɛ n s t l ʏ s t ʏ n t
innræting	ɪ nː r a iː t i ŋ k
héla	ç ɛː l a
undirfylking	ʏ n t ɪ r̥ f ɪ l̥ c i ŋ k
danalög	t aː n a l œː ɣ
tremmi	tʰ r ɛ mː ɪ
nyrðra	n ɪ r ð r a
eigur	e iː ɣ ʏ r
samfélag	s a m f j ɛː l aː ɣ
detta	t ɛ h t a
skandall	s k a n t a t l
afhending	a f h ɛ n t i ŋ k
bassi	p a sː ɪ
aðaltré	aː ð a l tʰ r j ɛː
fangelsi	f a u ŋ c ɛ l s ɪ
keyta	cʰ e iː t a
vistfræði	v ɪ s t f r a iː ð ɪ
matur	m aː t ʏ r
byrjun	p ɪ r j ʏ n
hlýða	l̥ iː ð a
skurðgoð	s k ʏ r ð k ɔː d
þorgilsína	θ ɔ r c ɪ l s iː n a
tamur	tʰ aː m ʏ r
snotur	s t n ɔː t ʏ r
telpa	tʰ ɛ l̥ p a
rýra	r iː r a
hefja	h ɛ v j a
dáleiða	t a uː l e iː ð a
magnea	m a k n ɛː a
hís	ç iː s
blæjuber	p l a iː j ʏ p ɛː r
samkvæmt	s a m k ʱ v a i m̥ t
léttúðugur	l j ɛ h t uː ð ʏː ɣ ʏ r
ingvarsson	i ŋ k v a r̥ s s ɔː n
mýrasauðlaukur	m iː r a s ø y ð l ø yː k ʏ r
dý	t iː
namm	n a mː
maurildi	m œ y̯ r ɪ l t ɪ
aka	aː k a
villimaður	v ɪ t l ɪ m aː ð ʏ r
geldingalauf	c ɛ l t i ŋ k a l ø yː v
marteinn	m a r̥ t e i t n
ydda	ɪ tː a
dísa	t iː s a
gamansamur	k aː m a n s aː m ʏ r
hrífa	r̥ iː v a
smásaga	s m a uː s aː ɣ a
taíland	tʰ a iː l a n t
vona	v ɔː n a
glanni	k l a nː ɪ
jesús	j ɛː s uː s
deila	t e iː l a
bráðna	p r a u ð n a
skutla	s k ʏ h t l a
spurning	s p ʏ r t n i ŋ k
göfuglyndur	k œː v ʏ ɣ l ɪ n t ʏ r
sunnan	s ʏ nː a n
miðjarðarhaf	m ɪ ð j a r ð a r h aː v
göltur	k œ l̥ t ʏ r
ekla	ɛ h k l a
kynskiptingur	cʰ ɪː n s c ɪ f t i ŋ k ʏ r
fræðimaður	f r a iː ð ɪ m aː ð ʏ r
guð	k v ʏː ð
kvað	kʰ v aː ð
besefi	p ɛː s ɛː v ɪ
óafturkræfur	o uː a f t ʏ r kʰ r a iː v ʏ r
morgunn	m ɔ r k ʏ nː
hrumur	r̥ ʏː m ʏ r
eind	e i n t
dagsetning	t a x s ɛ h t n i ŋ k
dreypa	t r e iː p a
nyt	n ɪː t
andri	a n t r ɪ
hriki	r̥ ɪː c ɪ
kar	kʰ aː r
fjöldamorðingi	f j œ l t a m ɔ r ð i ŋ c ɪ
vetni	v ɛ h t n ɪ
héðinn	ç ɛː ð ɪ nː
vin	v ɪː n
leikfang	l e iː k f a u ŋ k
lifa	l ɪː v a
mylja	m ɪ l j a
rósemi	r o uː s ɛː m ɪ
raki	r aː c ɪ
skjóða	s c o uː ð a
páldís	p a u l t iː s
leysingi	l e iː s i ɲ c ɪ
fjólublár	f j o uː l ʏ p l a uː r
hámundur	h a uː m ʏ n t ʏ r
grugg	k r ʏ kː
meðferð	m ɛ ð f ɛ r ð
sveiti	s v e iː t ɪ
bloggari	p l ɔ kː a r ɪ
fyrirtæki	f ɪː r ɪ r tʰ a iː c ɪ
hásveifgras	h a uː s v e i v k r aː s
tæring	tʰ a iː r i ŋ k
estragon	ɛ s t r a k ɔː n
gunga	k u ŋ k a
þykkur	θ ɪ h k ʏ r
veiði	v e iː ð ɪ
andlát	a n t l a uː t
kveisa	kʰ v e iː s a
gjald	c a l t
fúll	f u t l
sverta	s v ɛ r̥ t a
arkitekt	a r̥ c ɪ tʰ ɛ x t
öryggisgirðing	œː r ɪ cː ɪ s c ɪ r ð i ŋ k
nærverufall	n a i r v ɛː r ʏ f a t l
eftirlaun	ɛ f t ɪ r l ø yː n
pakki	pʰ a h c ɪ
róm	r o uː m
gjöf	c œː v
vifta	v ɪ f t a
aðalmundur	aː ð a l m ʏ n t ʏ r
unnusti	ʏ nː ʏ s t ɪ
grúfa	k r uː v a
fjallanóra	f j a t l a n o uː r a
reykja	r e iː c a
dúkka	t u h k a
hraukur	r̥ ø yː k ʏ r
barónett	p aː r o uː n ɛ h t
byrja	p ɪ r j a
frauðplast	f r ø yː ð pʰ l a s t
olía	ɔː l iː j a
kæra	cʰ a iː r a
snöggur	s t n œ kː ʏ r
ká	kʰ a uː
svalur	s v aː l ʏ r
staður	s t aː ð ʏ r
deigja	t e iː j a
anga	a u ŋ k a
hryggur	r̥ ɪ kː ʏ r
valdimaría	v a l t ɪ m aː r iː j a
flaga	f l aː ɣ a
sletta	s t l ɛ h t a
áhugamál	a uː h ʏː ɣ a m a uː l
játvarður	j a uː t v a r ð ʏ r
bjöggi	p j œ cː ɪ
jakki	j a h c ɪ
stöðvun	s t œ ð v ʏ n
strítkar	s t r iː t kʰ aː r
opinberun	ɔː p ɪ n p ɛː r ʏ n
þrettándi	θ r ɛ h t a u n t ɪ
skart	s k a r̥ t
minn	m ɪ nː
bón	p o uː n
aðfaranótt	a ð f aː r a n o u h t
öðruvísi	œ ð r ʏ v iː s ɪ
ara	aː r a
bjarndís	p j a r t n t iː s
kjarnakorn	cʰ a r t n a kʰ ɔ r t n
long	l ɔ ŋː
kreditkort	kʰ r ɛː t ɪ t kʰ ɔ r̥ t
stranda	s t r a n t a
skíra	s c iː r a
brekkusóley	p r ɛ h k ʏ s o uː l e iː
voffi	v ɔ fː ɪ
leikrit	l e iː k r ɪː t
leg	l ɛː ɣ
tær	tʰ a iː r
rafeind	r aː v e i n t
þorri	θ ɔ rː ɪ
brokkolí	p r ɔ h k ɔ l i
brokka	p r ɔ h k a
dúkahnífur	t uː k a n̥ iː v ʏ r
auðmundur	ø y ð m ʏ n t ʏ r
sofna	s ɔ p n a
maurígull	m ø yː r iː ɣ ʏ t l
gleðilegur	k l ɛː ð ɪ l ɛː ɣ ʏ r
áður	a uː ð ʏ r
maur	m ø yː r
lærisveinn	l a iː r ɪ s v e i t n
morgunmatur	m ɔ r k ʏ n m aː t ʏ r
óhreinn	o uː r̥ e i t n
reynd	r e i n t
orðsending	ɔ r ð s ɛ n t i ŋ k
sverfa	s v ɛ r v a
hneisulegur	n̥ e iː s ʏ l ɛː ɣ ʏ r
kössóttur	kʰ œ sː o u h t ʏ r
blindur	p l ɪ n t ʏ r
baugfingur	p ø y x f i ŋ k ʏ r
villtur	v ɪ l̥ t ʏ r
óþarflega	o uː θ a r v l ɛː ɣ a
línulega	l iː n ʏ l ɛː ɣ a
jón	j o uː n
pollagalli	pʰ ɔ t l a k a lː ɪ
forheimskun	f ɔː r h e i m s k ʏ n
litunarjafni	l ɪː t ʏ n a r j a p n ɪ
dýrka	t i r̥ k a
eining	e iː n i ŋ k
siggi	s ɪ cː ɪ
gát	k a uː t
vænn	v a i t n
pípuhattur	pʰ iː p ʏ h a h t ʏ r
magnús	m a k n uː s
náð	n a uː ð
ræðismannsbústaður	r a iː ð ɪ s m a n s p uː s t aː ð ʏ r
kontrabassi	kʰ ɔ n̥ t r a p a sː ɪ
beygja	p e iː j a
flóra	f l o uː r a
aldeilis	a l t e iː l ɪ s
kornblóm	kʰ ɔ r t n p l o uː m
vanilla	v aː n ɪ lː a
hirsla	h ɪ r̥ s t l a
skakkur	s k a h k ʏ r
kvísl	kʰ v i s t l
kjáni	cʰ a uː n ɪ
kítti	cʰ i h t ɪ
hryggja	r̥ ɪ cː a
aronsvöndur	aː r ɔ n s v œ n t ʏ r
veira	v e iː r a
jól	j o uː l
grikkland	k r ɪ h k l a n t
garðyrkja	k a r ð ɪ r̥ c a
bossi	p ɔ sː ɪ
töluorð	tʰ œː l ʏ ɔ r ð
aldur	a l t ʏ r
beitieski	p e iː t ɪ ɛ s c ɪ
þurfa	θ ʏ r v a
kokhlust	kʰ ɔː k l̥ ʏ s t
kvoða	kʰ v ɔː ð a
hera	h ɛː r a
labba	l a pː a
fjórði	f j o u r ð ɪ
nárú	n a uː r uː
kuti	kʰ ʏː t ɪ
geisa	c e iː s a
dauðarefsing	t ø yː ð a r ɛ f s i ŋ k
örðugleiki	œ r ð ʏ k l e iː c ɪ
gripur	k r ɪː p ʏ r
brenninetla	p r ɛ nː ɪ n ɛ h t l a
hissa	h ɪ sː a
sléttlendi	s t l j ɛ h t l ɛ n t ɪ
ós	o uː s
sóldís	s o u l t iː s
gulstör	k ʏ l s t œː r
alvarlegur	a l v a r l ɛː ɣ ʏ r
vanur	v aː n ʏ r
eignarfall	e i k n a r f a t l
nýsnævi	n iː s n a iː v ɪ
vissa	v ɪ sː a
segð	s ɛ ɣ ð
fagur	f aː ɣ ʏ r
frumefni	f r ʏː m ɛ p n ɪ
afturbeyging	a f t ʏ r p e iː j i ŋ k
úran	uː r aː n
bardagi	p a r t aː j ɪ
barki	p a r̥ c ɪ
vera	v ɛː r a
ríkja	r iː c a
skarifífill	s k aː r ɪ f iː v ɪ t l
andaglas	a n t a k l aː s
þröngur	θ r ø y ŋ k ʏ r
dæsa	t a iː s a
fjöldamorð	f j œ l t a m ɔ r ð
tjara	tʰ j aː r a
drukkna	t r ʏ h k n a
barmur	p a r m ʏ r
hróp	r̥ o uː p
hópkynlíf	h o uː p cʰ ɪ n l iː v
erilsamur	ɛː r ɪ l s aː m ʏ r
miltisbrandur	m ɪ l̥ t ɪ s p r a n t ʏ r
rennibekkur	r ɛ nː ɪ p ɛ h k ʏ r
skilja	s c ɪ l j a
hvergi	kʰ v ɛ r c ɪ
kara	kʰ aː r a
eitilfruma	e iː t ɪ l f r ʏː m a
fylgifiskur	f ɪ l c ɪ f ɪ s k ʏ r
ymja	ɪ m j a
erfiður	ɛ r v ɪː ð ʏ r
meinsæri	m e i n s a iː r ɪ
mýrelfting	m iː r ɛ l̥ʷ t i ŋ k
hafur	h aː v ʏ r
leki	l ɛː c ɪ
spuni	s p ʏː n ɪ
bikar	p ɪː k a r
þrár	θ r a uː r
stjóri	s t j o uː r ɪ
brú	p r uː
únsa	u n s a
lufsa	l ʏ f s a
vefa	v ɛː v a
gönguferð	k ø y ŋ k ʏ f ɛ r ð
velgengni	v ɛ l c e i ŋ k n ɪ
kíll	cʰ i t l
sóley	s o uː l e iː
töf	tʰ œː v
ágjarn	a uː c a r t n
statistík	s t aː t ɪ s t iː k
búðingur	p uː ð i ŋ k ʏ r
kók	kʰ o uː k
þistill	θ ɪ s t ɪ t l
sjúkdómur	s j uː k t o uː m ʏ r
skjall	s c a t l
hundshaus	h ʏ n t s h ø yː s
samræmi	s a m r a iː m ɪ
gálaus	k a uː l ø yː s
vangi	v a u ɲ c ɪ
þrýstihópur	θ r i s t ɪ h o uː p ʏ r
lestun	l ɛ s t ʏ n
heimsvaldastefna	h e i m s v a l t a s t ɛ p n a
túnvorblóm	tʰ u n v ɔ r p l o uː m
nærvera	n a i r v ɛː r a
biðukolla	p ɪː ð ʏ kʰ ɔ t l a
skessa	s c ɛ sː a
erfa	ɛ r v a
garður	k a r ð ʏ r
himbrimi	h ɪ m p r ɪː m ɪ
val	v aː l
stjaki	s t j aː c ɪ
drýgja	t r iː j a
hrufla	r̥ ʏ p l a
ertni	ɛ r̥ t n ɪ
þrenningarmaðra	θ r ɛ nː i ŋ k a r m a ð r a
kynlaus	cʰ ɪ n l ø yː s
vörn	v œ r t n
hvolf	kʰ v ɔ l v
rauðíkorni	r ø yː ð iː kʰ ɔ r t n ɪ
þorsti	θ ɔ r̥ s t ɪ
aðstæður	a ð s t a iː ð ʏ r
húsfrú	h uː s f r uː
þrennd	θ r ɛ n t
karlremba	kʰ a r t l r ɛ m p a
vökvi	v œː k v ɪ
þorvarðína	θ ɔ r v a r ð iː n a
rani	r aː n ɪ
renta	r ɛ n̥ t a
klof	kʰ l ɔː v
mörgæs	m œ r c a iː s
eymsli	e i m s t l ɪ
margrét	m a r k r j ɛː t
grámosi	k r a uː m ɔː s ɪ
falstur	f a l s t ʏ r
reykvískur	r e iː k v i s k ʏ r
beina	p e iː n a
flákaský	f l a uː k a s c iː
formaður	f ɔ r m aː ð ʏ r
innflytjandi	ɪ nː f l ɪː t j a n t ɪ
hnussa	n̥ ʏ sː a
bómull	p o uː m ʏ t l
nætur	n a iː t ʏ r
múkki	m u h c ɪ
skilnaður	s c ɪ l n aː ð ʏ r
hneisa	n̥ e iː s a
grimmd	k r ɪ m t
kríli	kʰ r iː l ɪ
mjólkursúkkulaði	m j o u l̥ k ʏ r s u h k ʏ l aː ð ɪ
mokka	m ɔ h k a
blað	p l aː ð
steinunn	s t e iː n ʏ nː
hylja	h ɪ l j a
sleipa	s t l e iː p a
glata	k l aː t a
rofi	r ɔː v ɪ
háskóli	h a uː s k o uː l ɪ
gatnamót	k a h t n a m o uː t
netja	n ɛː t j a
flugur	f l ʏː ɣ ʏ r
vasaþjófur	v aː s a θ j o uː v ʏ r
lemúr	l ɛː m uː r
uppspretta	ʏ h p s p r ɛ h t a
gálma	k a u l m a
maídís	m a iː t iː s
púls	pʰ u l s
linditré	l ɪ n t ɪ tʰ r j ɛː
pynting	pʰ ɪ n̥ t i ŋ k
okfruma	ɔː k f r ʏː m a
þórunn	θ o uː r ʏ nː
hnellinn	n̥ ɛ lː ɪ nː
plast	pʰ l a s t
rafpóstur	r a v pʰ o u s t ʏ r
gæludýr	c a iː l ʏ t iː r
sæll	s a i t l̥
tvíhliða	tʰ v iː l̥ ɪː ð a
spila	s p ɪː l a
friða	f r ɪː ð a
gjaldþrot	c a l t θ r ɔː t
þúfa	θ uː v a
valdína	v a l t iː n a
farangur	f aː r a u ŋ k ʏ r
holurt	h ɔː l ʏ r̥ t
setning	s ɛ h t n i ŋ k
einsemd	e i n s ɛ m t
sjálfur	s j a u l v ʏ r
innrita	ɪ nː r ɪː t a
slarkfær	s t l a r̥ k f a iː r
lauftré	l ø y v t r j ɛː
dómari	t o uː m aː r ɪ
kasheitur	k aː s h e iː t ʏ r
tuskulegur	tʰ ʏ s k ʏ l ɛː ɣ ʏ r
nefnifall	n ɛ p n ɪ f a t l̥
tónlistarskóli	tʰ o u n l ɪ s t a r s k o uː l ɪ
endur	ɛ n t ʏ r
brúðgumi	p r u ð k ʏː m ɪ
dýrkun	t i r̥ k ʏ n
pína	pʰ iː n a
fyllilega	f ɪ t l ɪ l ɛː ɣ a
prinsipissa	pʰ r ɪ n s ɪ pʰ ɪ sː a
þreyta	θ r e iː t a
slíkur	s t l iː k ʏ r
kjarrsveifgras	cʰ a rː s v e i v k r aː s
langatöng	l a u ŋ k a tʰ ø y ŋ k
strekkingur	s t r ɛ h c i ŋ k ʏ r
hakakross	h aː k a kʰ r ɔ sː
skán	s k a uː n
veikur	v e iː k ʏ r
tanta	tʰ a n̥ t a
fylgdarmaður	f ɪ l t a r m aː ð ʏ r
grafa	k r aː v a
hak	h aː k
flogaveiki	f l ɔː ɣ a v e iː c ɪ
loftpúði	l ɔ f t pʰ uː ð ɪ
enni	ɛ nː ɪ
búri	p uː r ɪ
