느끼하다	n ɯ k͈ i ɦ a̠ d a̠
경험	k j ʌ̹ ŋ ɦ ʌ̹ m
빗다	p i t̚ t͈ a̠
조계종	t͡ɕ o̞ ɡ j e̞ d͡ʑ o̞ ŋ
걸프렌드	k ʌ̹ ɭ pʰ ɯ ɾ e̞ n d ɯ
심부름	ɕʰ iː m b u ɾ ɯ m
씨름	ɕ͈ i ɾ ɯ m
재작년	t͡ɕ e̞ː d͡ʑ a̠ ŋ ɲ j ʌ̹ n
좁다	t͡ɕ o̞ p̚ t͈ a̠
법안	p ʌ̹ b a̠ n
주차하다	t͡ɕ uː t͡ɕʰ a̠ ɦ a̠ d a̠
헤스티아	h e̞ sʰ ɯ tʰ i a̠
아랍어	a̠ ɾ a̠ b ʌ̹
기공	k i ɡ o̞ ŋ
대포	t e̞ː pʰ o̞
알리바바	a̠ ɭ ʎ i b a̠ b a̠
입술연지	i p s͈ u ɭ ʎ j ʌ̹ n d͡ʑ i
방어하다	p a̠ ŋ ʌ̹ ɦ a̠ d a̠
소위	sʰ o̞ː ɥ i
너그럽다	n ʌ̹ ɡ ɯ ɾ ʌ̹ p̚ t͈ a̠
백성	p e̞ k s͈ ʌ̹ ŋ
렬도	ɾ j ʌ̹ ɭ t͈ o̞
토대	tʰ o̞ d e̞
쓰촨	s͈ ɯ t͡ɕʰ w a̠ n
바구니	p a̠ ɡ u n i
유대교	j u d e̞ ɡ j o
식혜	ɕʰ i k ç j e̞
해귀엣골	h e̞ ɡ ɥ i e̞ t̚ k͈ o̞ ɭ
시신경	ɕʰ iː ɕʰ i n ɡ j ʌ̹ ŋ
안습	a̠ n sʰ ɯ p̚
계집애	k j e̞ː d͡ʑ i b e̞
쿠알라룸푸르	kʰ u a̠ ɭ ɭ a̠ ɾ u m pʰ u ɾ ɯ
우주	uː d͡ʑ u
조폭	t͡ɕ o̞ pʰ o̞ k̚
어여쁘다	ʌ̹ j ʌ̹ p͈ ɯ d a̠
무빙워크	m u b i ŋ w ʌ̹ k x ɯ
마녀	m a̠ ɲ j ʌ̹
체육	t͡ɕʰ e̞ j u k̚
계속	k j e̞ː sʰ o̞ k̚
야경	j a̠ː ɡ j ʌ̹ ŋ
닦다	t a̠ k̚ t͈ a̠
주차장	t͡ɕ uː t͡ɕʰ a̠ d͡ʑ a̠ ŋ
성상	sʰ ɘː ŋ sʰ a̠ ŋ
코트	kʰ o̞ tʰ ɯ
찾아오다	t͡ɕʰ a̠ d͡ʑ a̠ o̞ d a̠
자랑	t͡ɕ a̠ ɾ a̠ ŋ
숙취	sʰ u k̚ t͡ɕʰ ɥ i
이웃집	i u t̚ t͡ɕ͈ i p̚
립법	ɾ i p̚ p͈ ʌ̹ p̚
오리나무	o̞ ɾ i n a̠ m u
기억	k i ʌ̹ k̚
띠동갑	t͈ i d o̞ ŋ ɡ a̠ p̚
중사	t͡ɕ u ŋ sʰ a̠
커뮤니티	kʰ ʌ̹ m j u n i tʰ i
건축가	k ɘː n t͡ɕʰ u k̚ k͈ a̠
사구	sʰ a̠ ɡ u
신선하다	ɕʰ i n sʰ ʌ̹ n ɦ a̠ d a̠
언론	ʌ̹ ɭ ɭ o̞ n
벼리다	p j ʌ̹ ɾ i d a̠
자본주의	t͡ɕ a̠ b o̞ n d͡ʑ u ɰ i
찍소리	t͡ɕ͈ i k s͈ o̞ ɾ i
뒤집다	t ɥ i d͡ʑ i p̚ t͈ a̠
하이난	h a̠ i n a̠ n
잡종견	t͡ɕ a̠ p̚ t͡ɕ͈ o̞ ŋ ɡ j ʌ̹ n
겪다	k j ʌ̹ k̚ t͈ a̠
아서	a̠ sʰ ʌ̹
콘크리트	kʰ o̞ n k x ɯ ɾ i tʰ ɯ
향하다	ç j a̠ ŋ ɦ a̠ d a̠
인류	i ɭ ʎ j u
라이트세이버	ɾ a̠ i tʰ ɯ sʰ e̞ i b ʌ̹
걸음걸이	k ʌ̹ ɾ ɯ m ɡ ʌ̹ ɾ i
타이	tʰ a̠ i
유령	j u ɾ j ʌ̹ ŋ
배신하다	p e̞ː ɕʰ i n ɦ a̠ d a̠
맹목적	m e̞ ŋ m o̞ k̚ t͡ɕ͈ ʌ̹ k̚
자명종	t͡ɕ a̠ m j ʌ̹ ŋ d͡ʑ o̞ ŋ
과거시제	k w a̠ː ɡ ʌ̹ ɕʰ i d͡ʑ e̞
꾸란	k͈ u ɾ a̠ n
늦잠	n ɯ t̚ t͡ɕ͈ a̠ m
아깝다	a̠ k͈ a̠ p̚ t͈ a̠
전화번호	t͡ɕ ʌ̹ n β w a̠ b ʌ̹ n β o̞
기러기	k i ɾ ʌ̹ ɡ i
많다	m a̠ː n tʰ a̠
불장난	p u ɭ d͡ʑ a̠ ŋ n a̠ n
약식	j a̠ k ɕ͈ i k̚
ᆫ지	n d͡ʑ i
상자	sʰ a̠ ŋ d͡ʑ a̠
보조사	p o̞ː d͡ʑ o̞ sʰ a̠
박수하다	p a̠ k s͈ u ɦ a̠ d a̠
스라소니	sʰ ɯ ɾ a̠ sʰ o̞ n i
소책자	sʰ o̞ː t͡ɕʰ e̞ k̚ t͡ɕ͈ a̠
평가하다	pʰ j ɘː ŋ k͈ a̠ ɦ a̠ d a̠
비교적	p iː ɡ j o d͡ʑ ʌ̹ k̚
철폐	t͡ɕʰ ʌ̹ ɭ pʰ j e̞
파렴치	pʰ a̠ː ɾ j ʌ̹ m t͡ɕʰ i
여전히	j ʌ̹ d͡ʑ ʌ̹ n ʝ i
신앙	ɕʰ iː n a̠ ŋ
먹물	m ʌ̹ ŋ m u ɭ
리왕조	ɾ i w a̠ ŋ d͡ʑ o̞
단추	t a̠ n t͡ɕʰ u
홀소리어울림	ɸʷ o̞ ɭ s͈ o̞ ɾ i ʌ̹ u ɭ ʎ i m
몰타어	m o̞ ɭ tʰ a̠ ʌ̹
가스파초	k a̠ sʰ ɯ pʰ a̠ t͡ɕʰ o̞
두려워하다	t u ɾ j ʌ̹ w ʌ̹ ɦ a̠ d a̠
변절하다	p j ɘː n d͡ʑ ʌ̹ ɾ ɦ a̠ d a̠
호떡	ɸʷ o̞ t͈ ʌ̹ k̚
고관	k o̞ ɡ w a̠ n
가난하다	k a̠ n a̠ n ɦ a̠ d a̠
실험	ɕʰ i ɾ ɦ ʌ̹ m
손질	sʰ o̞ n d͡ʑ i ɭ
노이로제	n o̞ i ɾ o̞ d͡ʑ e̞
뱀머리돌고래	p e̞ m m ʌ̹ ɾ i d o̞ ɭ ɡ o̞ ɾ e̞
찬장	t͡ɕʰ a̠ː n d͡ʑ a̠ ŋ
지어내다	t͡ɕ i ʌ̹ n e̞ d a̠
추수	t͡ɕʰ u sʰ u
카브	kʰ a̠ b ɯ
베테랑	p e̞ tʰ e̞ ɾ a̠ ŋ
주어	t͡ɕ u ʌ̹
찰흙	t͡ɕʰ a̠ ɾ ɣ ɯ k̚
농노	n o̞ ŋ n o̞
태그	tʰ e̞ ɡ ɯ
원칙	w ʌ̹ n t͡ɕʰ i k̚
접시	t͡ɕ ʌ̹ p ɕ͈ i
유명하다	j uː m j ʌ̹ ŋ ɦ a̠ d a̠
모니터	m o̞ n i tʰ ʌ̹
접때	t͡ɕ ɘː p̚ t͈ e̞
횃불	ɸ w e̞ t̚ p͈ u ɭ
두견새	t u ɡ j ʌ̹ n sʰ e̞
부유하다	p uː j u ɦ a̠ d a̠
이간질	iː ɡ a̠ n d͡ʑ i ɭ
후보	ɸʷ u b o̞
음독	ɯ m d o̞ k̚
그릇되다	k ɯ ɾ ɯ t̚ t͈ w e̞ d a̠
상당하다	sʰ a̠ ŋ d a̠ ŋ ɦ a̠ d a̠
거북	k ʌ̹ b u k̚
통화	tʰ o̞ ŋ β w a̠
월경	w ʌ̹ ɭ ɡ j ʌ̹ ŋ
그러나	k ɯ ɾ ʌ̹ n a̠
안녕	a̠ n ɲ j ʌ̹ ŋ
잡다	t͡ɕ a̠ p̚ t͈ a̠
왕복	w a̠ ŋ b o̞ k̚
냄비	n e̞ m b i
임무	iː m m u
대단하다	t e̞ː d a̠ n ɦ a̠ d a̠
너구리	n ʌ̹ ɡ u ɾ i
갤러리	k e̞ ɭ ɭ ʌ̹ ɾ i
운명	uː n m j ʌ̹ ŋ
펩티드	pʰ e̞ p̚ tʰ i d ɯ
뛰어나다	t͈ ɥ i ʌ̹ n a̠ d a̠
독어	t o̞ ɡ ʌ̹
이웃	i u t̚
아버지	a̠ b ʌ̹ d͡ʑ i
아빠	a̠ p͈ a̠
법무부	p ʌ̹ m m u b u
맹인	m e̞ː ŋ i n
통계	tʰ o̞ː ŋ ɡ j e̞
장소	t͡ɕ a̠ ŋ sʰ o̞
댓글	t e̞ t̚ k͈ ɯ ɭ
빈방	p i n b a̠ ŋ
대응	t e̞ː ɯ ŋ
겨루다	k j ʌ̹ ɾ u d a̠
십이지장	ɕʰ i b i d͡ʑ i d͡ʑ a̠ ŋ
질문	t͡ɕ i ɭ m u n
영사	j ʌ̹ ŋ sʰ a̠
관점	k w a̠ n t͡ɕ͈ ʌ̹ m
부재	p u d͡ʑ e̞
손님	sʰ o̞ n n i m
백반	p e̞ k̚ p͈ a̠ n
작용하다	t͡ɕ a̠ ɡ j o ŋ ɦ a̠ d a̠
따르다	t͈ a̠ ɾ ɯ d a̠
괜찮다	k w e̞ n t͡ɕʰ a̠ n tʰ a̠
초지	t͡ɕʰ o̞ d͡ʑ i
테마	tʰ e̞ m a̠
쏘련	s͈ o̞ ɾ j ʌ̹ n
면허증	m j ɘː n ɦ ʌ̹ t͡ɕ͈ ɯ ŋ
그거	k ɯ ɡ ʌ̹
발란	p a̠ː ɭ ɭ a̠ n
안심하다	a̠ n ɕʰ i m ɦ a̠ d a̠
혹부리고래	ɸʷ o̞ k̚ p͈ u ɾ i ɡ o̞ ɾ e̞
발목	p a̠ ɭ m o̞ k̚
원문	w ʌ̹ n m u n
초콜렛	t͡ɕʰ o̞ kʰ o̞ ɭ ɭ e̞ t̚
지명	t͡ɕ i m j ʌ̹ ŋ
족발	t͡ɕ o̞ k̚ p͈ a̠ ɭ
지라프	t͡ɕ i ɾ a̠ pʰ ɯ
이용하다	iː j o ŋ ɦ a̠ d a̠
붓펜	p u t̚ pʰ e̞ n
납량	n a̠ m ɲ j a̠ ŋ
옅다	j ʌ̹ t̚ t͈ a̠
인문학	i n m u n ɦ a̠ k̚
비사우	p i sʰ a̠ u
며느리	m j ʌ̹ n ɯ ɾ i
밀접하다	m i ɭ t͡ɕ͈ ʌ̹ pʰ a̠ d a̠
여성	j ʌ̹ sʰ ʌ̹ ŋ
일대일	i ɭ t͈ e̞ i ɭ
논리학	n o̞ ɭ ʎ i ɦ a̠ k̚
련방	ɾ j ʌ̹ n b a̠ ŋ
혼수	ɸʷ o̞ n sʰ u
이행	iː ɦ e̞ ŋ
크메르어	k x ɯ m e̞ ɾ ɯ ʌ̹
투표하다	tʰ u pʰ j o ɦ a̠ d a̠
진달래	t͡ɕ i n d a̠ ɭ ɭ e̞
이상	iː sʰ a̠ ŋ
원료	w ʌ̹ ɭ ʎ j o
사다새	sʰ a̠ d a̠ sʰ e̞
어릿광대	ʌ̹ ɾ i t̚ k͈ w a̠ ŋ d e̞
황후	ɸ w a̠ ŋ β u
팔라듐	pʰ a̠ ɭ ɭ a̠ d j u m
방송국	p a̠ː ŋ sʰ o̞ ŋ ɡ u k̚
한테	h a̠ n tʰ e̞
다다미	t a̠ d a̠ m i
서두르다	sʰ ʌ̹ d u ɾ ɯ d a̠
고생하다	k o̞ sʰ e̞ ŋ ɦ a̠ d a̠
세인트조지스	sʰ e̞ i n tʰ ɯ d͡ʑ o̞ d͡ʑ i sʰ ɯ
교편	k j oː pʰ j ʌ̹ n
안와	a̠ː n w a̠
다이아몬드	t a̠ i a̠ m o̞ n d ɯ
약탈	j a̠ k̚ tʰ a̠ ɭ
칵테일	kʰ a̠ k̚ tʰ e̞ i ɭ
의원	ɰ i w ʌ̹ n
애국주의	e̞ː ɡ u k̚ t͡ɕ͈ u ɰ i
주머니	t͡ɕ u m ʌ̹ n i
간사하다	k a̠ n sʰ a̠ ɦ a̠ d a̠
터븀	tʰ ʌ̹ b j u m
뚝배기	t͈ u k̚ p͈ e̞ ɡ i
지하드	t͡ɕ i ɦ a̠ d ɯ
지키다	t͡ɕ i k ç i d a̠
하데스	h a̠ d e̞ sʰ ɯ
근거	k ɯ n ɡ ʌ̹
슬로베니아어	sʰ ɯ ɭ ɭ o̞ b e̞ n i a̠ ʌ̹
따지다	t͈ a̠ d͡ʑ i d a̠
가소롭다	k a̠ː sʰ o̞ ɾ o̞ p̚ t͈ a̠
우즈베키스탄	u d͡ʑ ɯ b e̞ k ç i sʰ ɯ tʰ a̠ n
세배	sʰ e̞ː b e̞
한잔	h a̠ n d͡ʑ a̠ n
숨구멍	sʰ u m ɡ u m ʌ̹ ŋ
자율	t͡ɕ a̠ j u ɭ
주문	t͡ɕ uː m u n
라벨	ɾ a̠ b e̞ ɭ
일어서다	i ɾ ʌ̹ sʰ ʌ̹ d a̠
저편	t͡ɕ ʌ̹ pʰ j ʌ̹ n
원작	w ʌ̹ n d͡ʑ a̠ k̚
감수하다	k a̠ː m sʰ u ɦ a̠ d a̠
괴수	k w e̞ː sʰ u
맞추다	m a̠ t̚ t͡ɕʰ u d a̠
과금	k w a̠ ɡ ɯ m
향기롭다	ç j a̠ ŋ ɡ i ɾ o̞ p̚ t͈ a̠
되돌리다	t w e̞ d o̞ ɭ ʎ i d a̠
포크	pʰ o̞ k x ɯ
갈퀴다	k a̠ ɭ kʰ ɥ i d a̠
취급	t͡ɕʰ ɥ i ɡ ɯ p̚
식용유	ɕʰ i ɡ j o ŋ ɲ j u
조심하다	t͡ɕ o̞ː ɕʰ i m ɦ a̠ d a̠
예능	j e̞ː n ɯ ŋ
농담하다	n o̞ː ŋ d a̠ m ɦ a̠ d a̠
두드러기	t u d ɯ ɾ ʌ̹ ɡ i
무사하다	m u sʰ a̠ ɦ a̠ d a̠
ᆸ니까	m n i k͈ a̠
이슬람교도	i sʰ ɯ ɭ ɭ a̠ m ɡ j o d o̞
천부	t͡ɕʰ ʌ̹ n b u
악수	a̠ k s͈ u
수소폭탄	sʰ u sʰ o̞ pʰ o̞ k̚ tʰ a̠ n
달마다	t a̠ ɭ m a̠ d a̠
김책	k i m t͡ɕʰ e̞ k̚
인명	i n m j ʌ̹ ŋ
된장녀	t w e̞ː n d͡ʑ a̠ ŋ ɲ j ʌ̹
발코니	p a̠ ɭ kʰ o̞ n i
바누아투	p a̠ n u a̠ tʰ u
쇳돌	sʰ w e̞ t̚ t͈ o̞ ɭ
영국	j ʌ̹ ŋ ɡ u k̚
가야	k a̠ j a̠
재료	t͡ɕ e̞ ɾ j o
지하철	t͡ɕ i ɦ a̠ t͡ɕʰ ʌ̹ ɭ
송림	sʰ o̞ ŋ n i m
위대	ɥ i d e̞
기요틴	k i j o tʰ i n
수달	sʰ u d a̠ ɭ
창조적	t͡ɕʰ a̠ː ŋ d͡ʑ o̞ d͡ʑ ʌ̹ k̚
왕후	w a̠ ŋ β u
반의어	p a̠ː n ɰ i ʌ̹
일부러	iː ɭ b u ɾ ʌ̹
벚꽃	p ʌ̹ t̚ k͈ o̞ t̚
빼닮다	p͈ e̞ː d a̠ m t͈ a̠
국회	k u kʰ w e̞
커피숍	kʰ ʌ̹ pʰ i ɕʰ j o p̚
깡통따개	k͈ a̠ ŋ tʰ o̞ ŋ t͈ a̠ ɡ e̞
항의	h a̠ː ŋ ɰ i
브라우저	p ɯ ɾ a̠ u d͡ʑ ʌ̹
체형	t͡ɕʰ e̞ ʝ j ʌ̹ ŋ
창문	t͡ɕʰ a̠ ŋ m u n
흐리다	x ɯ ɾ i d a̠
마디	m a̠ d i
가스	k͈ a̠ sʰ ɯ
게르만	k e̞ ɾ ɯ m a̠ n
리히텐슈타인	ɾ i ʝ i tʰ e̞ n ɕʰ j u tʰ a̠ i n
마루	m a̠ ɾ u
죄수	t͡ɕ w e̞ sʰ u
이응	i ɯ ŋ
단엽기	t a̠ ɲ j ʌ̹ p̚ k͈ i
기업	k i ʌ̹ p̚
만성	m a̠ n sʰ ʌ̹ ŋ
미끄럼대	m i k͈ ɯ ɾ ʌ̹ m t͈ e̞
하이킹	h a̠ i k ç i ŋ
연락처	j ʌ̹ ɭ ɭ a̠ k̚ t͡ɕʰ ʌ̹
끼우다	k͈ i u d a̠
시어머니	ɕʰ i ʌ̹ m ʌ̹ n i
플레로븀	pʰ ɯ ɭ ɭ e̞ ɾ o̞ b j u m
쫓기다	t͡ɕ͈ o̞ t̚ k͈ i d a̠
모르다	m o̞ː ɾ ɯ d a̠
워라밸	w ʌ̹ ɾ a̠ b e̞ ɭ
터미널	tʰ ʌ̹ m i n ʌ̹ ɭ
강판	k a̠ ŋ pʰ a̠ n
등반	t ɯ ŋ b a̠ n
뜯다	t͈ ɯ t̚ t͈ a̠
요도	j o d o̞
깃발	k i t̚ p͈ a̠ ɭ
떨치다	t͈ ʌ̹ ɭ t͡ɕʰ i d a̠
뚜껑	t͈ u k͈ ʌ̹ ŋ
주정꾼	t͡ɕ uː d͡ʑ ʌ̹ ŋ k͈ u n
청진기	t͡ɕʰ ʌ̹ ŋ d͡ʑ i n ɡ i
서클	s͈ ʌ̹ k x ɯ ɭ
자네들	t͡ɕ a̠ n e̞ d ɯ ɭ
거듭씨	k ʌ̹ d ɯ p ɕ͈ i
부활절	p uː β w a̠ ɭ t͡ɕ͈ ʌ̹ ɭ
괄시	k w a̠ ɭ ɕʰ i
두줄망둑	t uː d͡ʑ u ɭ m a̠ ŋ d u k̚
악마	a̠ ŋ m a̠
스테이크	sʰ ɯ tʰ e̞ i k x ɯ
청둥오리	t͡ɕʰ ʌ̹ ŋ d u ŋ o̞ ɾ i
여행자	j ʌ̹ ɦ e̞ ŋ d͡ʑ a̠
트렁크	tʰ ɯ ɾ ʌ̹ ŋ k x ɯ
부유	p u j u
야한	j a̠ː ɦ a̠ n
물만두	m u ɭ m a̠ n d u
나치	n a̠ t͡ɕʰ i
바다사자	p a̠ d a̠ sʰ a̠ d͡ʑ a̠
팬티	pʰ e̞ n tʰ i
증권	t͡ɕ ɯ ŋ k͈ w ʌ̹ n
기각	k i ɡ a̠ k̚
난리	n a̠ː ɭ ʎ i
공통	k o̞ː ŋ tʰ o̞ ŋ
수류탄	sʰ u ɾ j u tʰ a̠ n
푸르다	pʰ u ɾ ɯ d a̠
장면	t͡ɕ a̠ ŋ m j ʌ̹ n
번역하다	p ʌ̹ ɲ j ʌ̹ kʰ a̠ d a̠
눈앞	n u n a̠ p̚
탈주병	tʰ a̠ ɭ t͡ɕ͈ u b j ʌ̹ ŋ
간곡하다	k a̠ː n ɡ o̞ kʰ a̠ d a̠
한영	h a̠ː ɲ j ʌ̹ ŋ
축축하다	t͡ɕʰ u k̚ t͡ɕʰ u kʰ a̠ d a̠
항공	h a̠ː ŋ ɡ o̞ ŋ
첨가물	t͡ɕʰ ʌ̹ m ɡ a̠ m u ɭ
양하	j a̠ ŋ ɦ a̠
공로	k o̞ ŋ n o̞
성곽	sʰ ʌ̹ ŋ ɡ w a̠ k̚
사랑하다	sʰ a̠ ɾ a̠ ŋ ɦ a̠ d a̠
자비	t͡ɕ a̠ b i
역겹다	j ʌ̹ k̚ k͈ j ʌ̹ p̚ t͈ a̠
멀어지다	m ɘː ɾ ʌ̹ d͡ʑ i d a̠
비취	p iː t͡ɕʰ ɥ i
이날	i n a̠ ɭ
하루	h a̠ ɾ u
면도기	m j ʌ̹ n d o̞ ɡ i
공책	k o̞ ŋ t͡ɕʰ e̞ k̚
여덟	j ʌ̹ d ʌ̹ ɭ
부호	p uː β o̞
꿀벌	k͈ u ɭ b ʌ̹ ɭ
오락	o̞ː ɾ a̠ k̚
풍습	pʰ u ŋ sʰ ɯ p̚
시대정신	ɕʰ i d e̞ d͡ʑ ʌ̹ ŋ ɕʰ i n
칼날	kʰ a̠ ɭ ɭ a̠ ɭ
색안경	sʰ e̞ ɡ a̠ n ɡ j ʌ̹ ŋ
낭인	n a̠ː ŋ i n
브리튼	p ɯ ɾ i tʰ ɯ n
태초	tʰ e̞ t͡ɕʰ o̞
옥심	o̞ k ɕ͈ i m
운전대	uː n d͡ʑ ʌ̹ n d e̞
가시아버지	k a̠ ɕʰ i a̠ b ʌ̹ d͡ʑ i
깔개	k͈ a̠ ɭ ɡ e̞
일왕	i ɾ w a̠ ŋ
숙주나물	sʰ u k̚ t͡ɕ͈ u n a̠ m u ɭ
야마토	j a̠ m a̠ tʰ o̞
전날	t͡ɕ ʌ̹ n n a̠ ɭ
펼쳐지다	pʰ j ʌ̹ ɭ t͡ɕʰ j ʌ̹ d͡ʑ i d a̠
색소	sʰ e̞ k s͈ o̞
빈뇨	p i n ɲ j o
멧박쥐	m e̞ t̚ p͈ a̠ k̚ t͡ɕ͈ ɥ i
남친	n a̠ m t͡ɕʰ i n
휴게	ç j u ɡ e̞
분개	p uː n ɡ e̞
조산사	t͡ɕ o̞ː sʰ a̠ n sʰ a̠
고맙다	k o̞ː m a̠ p̚ t͈ a̠
이메일	i m e̞ i ɭ
탐험	tʰ a̠ m ɦ ʌ̹ m
선술집	sʰ ʌ̹ n sʰ u ɭ d͡ʑ i p̚
어원학	ɘː w ʌ̹ n ɦ a̠ k̚
거듭홀소리	k ʌ̹ d ɯ pʰ o̞ ɭ sʰ o̞ ɾ i
기울	k i u ɭ
진지	t͡ɕ iː n d͡ʑ i
버릇	p ʌ̹ ɾ ɯ t̚
등대	t ɯ ŋ d e̞
육체	j u k̚ t͡ɕʰ e̞
멋있다	m ʌ̹ ɕʰ i t̚ t͈ a̠
무리	m u ɾ i
토네이도	tʰ o̞ n e̞ i d o̞
가창오리	k a̠ t͡ɕʰ a̠ ŋ o̞ ɾ i
고작	k o̞ d͡ʑ a̠ k̚
공군	k o̞ ŋ ɡ u n
파마	pʰ a̠ m a̠
카르빌아민	kʰ a̠ ɾ ɯ b i ɾ a̠ m i n
찹쌀	t͡ɕʰ a̠ p s͈ a̠ ɭ
속삭이다	sʰ o̞ k s͈ a̠ ɡ i d a̠
헤이룽장	h e̞ i ɾ u ŋ d͡ʑ a̠ ŋ
폴란드어	pʰ o̞ ɭ ɭ a̠ n d ɯ ʌ̹
동창	t o̞ ŋ t͡ɕʰ a̠ ŋ
억류	ʌ̹ ŋ ɲ j u
찢다	t͡ɕ͈ i t̚ t͈ a̠
본토	p o̞ n tʰ o̞
애쓰다	e̞ː s͈ ɯ d a̠
계수	k j e̞ː sʰ u
성냥	sʰ ʌ̹ ŋ ɲ j a̠ ŋ
가다	k a̠ d a̠
서체	sʰ ʌ̹ t͡ɕʰ e̞
문배	m u n b e̞
칠리	t͡ɕʰ i ɭ ʎ i
자치	t͡ɕ a̠ t͡ɕʰ i
얼리다	ʌ̹ ɭ ʎ i d a̠
온돌	o̞ n d o̞ ɭ
객관	k e̞ k̚ k͈ w a̠ n
형광펜	ç j ʌ̹ ŋ ɡ w a̠ ŋ pʰ e̞ n
해부학	h e̞ː b u ɦ a̠ k̚
파괴되다	pʰ a̠ː ɡ w e̞ d w e̞ d a̠
국시	k u k ɕ͈ i
다녀가다	t a̠ ɲ j ʌ̹ ɡ a̠ d a̠
카옌	kʰ a̠ j e̞ n
성게	sʰ ɘː ŋ ɡ e̞
통하다	tʰ o̞ ŋ ɦ a̠ d a̠
번지다	p ɘː n d͡ʑ i d a̠
혈액	ç j ʌ̹ ɾ e̞ k̚
구분	k u b u n
조만간	t͡ɕ o̞ː m a̠ n ɡ a̠ n
초음파	t͡ɕʰ o̞ ɯ m pʰ a̠
마리	m a̠ ɾ i
운전기사	uː n d͡ʑ ʌ̹ n ɡ i sʰ a̠
쌀밥	s͈ a̠ ɭ b a̠ p̚
매리복	m e̞ ɾ i b o̞ k̚
교파	k j oː pʰ a̠
댕기흰죽지	t e̞ ŋ ɡ i ʝ i n d͡ʑ u k̚ t͡ɕ͈ i
몰도바	m o̞ ɭ d o̞ b a̠
백과사전	p e̞ k̚ k͈ w a̠ sʰ a̠ d͡ʑ ʌ̹ n
회계사	ɸ w e̞ː ɡ j e̞ sʰ a̠
알까기	a̠ ɭ k͈ a̠ ɡ i
심방	ɕʰ i m b a̠ ŋ
서밋	sʰ ʌ̹ m i t̚
구들	k u d ɯ ɭ
구녕	k u ɲ j ʌ̹ ŋ
실록	ɕʰ i ɭ ɭ o̞ k̚
유능	j u n ɯ ŋ
간악하다	k a̠ n a̠ kʰ a̠ d a̠
천정	t͡ɕʰ ʌ̹ n d͡ʑ ʌ̹ ŋ
갚다	k a̠ p̚ t͈ a̠
책방	t͡ɕʰ e̞ k̚ p͈ a̠ ŋ
두렵다	t u ɾ j ʌ̹ p̚ t͈ a̠
마사지하다	m a̠ sʰ a̠ d͡ʑ i ɦ a̠ d a̠
목사	m o̞ k s͈ a̠
글리세롤	k ɯ ɭ ʎ i sʰ e̞ ɾ o̞ ɭ
명의	m j ʌ̹ ŋ ɰ i
패션프루츠	pʰ e̞ ɕʰ j ʌ̹ n pʰ ɯ ɾ u t͡ɕʰ ɯ
스위치	sʰ ɯ ɥ i t͡ɕʰ i
푸다	pʰ u d a̠
업둥이	ʌ̹ p̚ t͈ u ŋ i
뛰어넘다	t͈ ɥ i ʌ̹ n ʌ̹ m t͈ a̠
부근	p uː ɡ ɯ n
전투	t͡ɕ ʌ̹ n tʰ u
개나리	k e̞ː n a̠ ɾ i
재수	t͡ɕ e̞ sʰ u
구글	k u ɡ ɯ ɭ
계획하다	k j e̞ː β w e̞ kʰ a̠ d a̠
원추각막	w ʌ̹ n t͡ɕʰ u ɡ a̠ ŋ m a̠ k̚
선종	sʰ ʌ̹ n d͡ʑ o̞ ŋ
어리다	ʌ̹ ɾ i d a̠
서재	sʰ ʌ̹ d͡ʑ e̞
캠프	kʰ e̞ m pʰ ɯ
공급	k o̞ː ŋ ɡ ɯ p̚
노파	n o̞ː pʰ a̠
긁다	k ɯ k̚ t͈ a̠
챔피언	t͡ɕʰ e̞ m pʰ i ʌ̹ n
수음하다	sʰ u ɯ m ɦ a̠ d a̠
시절	ɕʰ i d͡ʑ ʌ̹ ɭ
강좌	k a̠ː ŋ d͡ʑ w a̠
광시	k w a̠ ŋ ɕʰ i
알콜	a̠ ɭ kʰ o̞ ɭ
주로	t͡ɕ u ɾ o̞
돼지갈비	t w e̞ d͡ʑ i ɡ a̠ ɭ b i
솜씨	sʰ o̞ m ɕ͈ i
굵다랗다	k uː k̚ t͈ a̠ ɾ a̠ tʰ a̠
구렁	k u ɾ ʌ̹ ŋ
오소리	o̞ sʰ o̞ ɾ i
이사야	i sʰ a̠ j a̠
마구간	m a̠ː ɡ u k͈ a̠ n
이유	iː j u
하숙집	h a̠ː sʰ u k̚ t͡ɕ͈ i p̚
기관차	k i ɡ w a̠ n t͡ɕʰ a̠
교전	k j o d͡ʑ ʌ̹ n
자아	t͡ɕ a̠ a̠
사항	sʰ a̠ː ɦ a̠ ŋ
고냉이	k o̞ n e̞ ŋ i
꽃말	k͈ o̞ n m a̠ ɭ
가지다	k a̠ d͡ʑ i d a̠
신조어	ɕʰ i n d͡ʑ o̞ ʌ̹
패럴림픽	pʰ e̞ ɾ ʌ̹ ɭ ʎ i m pʰ i k̚
비밀리	p iː m i ɭ ʎ i
카보베르데	kʰ a̠ b o̞ b e̞ ɾ ɯ d e̞
신부	ɕʰ i n b u
강화하다	k a̠ ŋ β w a̠ ɦ a̠ d a̠
회견	ɸ w e̞ː ɡ j ʌ̹ n
데메테르	t e̞ m e̞ tʰ e̞ ɾ ɯ
오라버니	o̞ ɾ a̠ b ʌ̹ n i
이신론	i ɕʰ i n n o̞ n
어치	ʌ̹ t͡ɕʰ i
부들	p u d ɯ ɭ
판도라	pʰ a̠ n d o̞ ɾ a̠
왈츠	w a̠ ɭ t͡ɕʰ ɯ
구별되다	k u b j ʌ̹ ɭ d w e̞ d a̠
꽃뱀	k͈ o̞ t̚ p͈ e̞ m
섹스	s͈ e̞ k s͈ ɯ
참가하다	t͡ɕʰ a̠ m ɡ a̠ ɦ a̠ d a̠
베풀다	p e̞ pʰ u ɭ d a̠
무선	m u sʰ ʌ̹ n
교각	k j o ɡ a̠ k̚
찌푸리다	t͡ɕ͈ i pʰ u ɾ i d a̠
옥수수	o̞ k s͈ u sʰ u
복잡하다	p o̞ k̚ t͡ɕ͈ a̠ pʰ a̠ d a̠
주구	t͡ɕ u ɡ u
희극	ç i ɡ ɯ k̚
이스라엘	i sʰ ɯ ɾ a̠ e̞ ɭ
매음굴	m e̞ː ɯ m ɡ u ɭ
민간	m i n ɡ a̠ n
소굴	sʰ o̞ ɡ u ɭ
광야	k w a̠ː ŋ j a̠
주두	t͡ɕ u d u
반하다	p a̠ n ɦ a̠ d a̠
여유	j ʌ̹ j u
바이러스	p a̠ i ɾ ʌ̹ sʰ ɯ
간계	k a̠ n ɡ j e̞
뇌피셜	n w e̞ pʰ i ɕʰ j ʌ̹ ɭ
프린터	pʰ ɯ ɾ i n tʰ ʌ̹
주소	t͡ɕ uː sʰ o̞
우는토끼	uː n ɯ n tʰ o̞ k͈ i
구어	k uː ʌ̹
남아메리카	n a̠ m a̠ m e̞ ɾ i kʰ a̠
마르스	m a̠ ɾ ɯ sʰ ɯ
제법	t͡ɕ e̞ b ʌ̹ p̚
나이	n a̠ i
소피아	sʰ o̞ pʰ i a̠
왕종개	w a̠ ŋ d͡ʑ o̞ ŋ ɡ e̞
전염병	t͡ɕ ʌ̹ ɲ j ʌ̹ m b j ʌ̹ ŋ
반듯이	p a̠ n d ɯ ɕʰ i
와사비	w a̠ sʰ a̠ b i
증후군	t͡ɕ ɯ ŋ β u ɡ u n
젊다	t͡ɕ ɘː m t͈ a̠
출석	t͡ɕʰ u ɭ s͈ ʌ̹ k̚
울리다	u ɭ ʎ i d a̠
허가	h ʌ̹ ɡ a̠
인쇄기	i n sʰ w e̞ ɡ i
어드벤처	ʌ̹ d ɯ b e̞ n t͡ɕʰ ʌ̹
쥐다	t͡ɕ ɥ i d a̠
증가시키다	t͡ɕ ɯ ŋ ɡ a̠ ɕʰ i k ç i d a̠
딸기	t͈ a̠ː ɭ ɡ i
기차다	k i t͡ɕʰ a̠ d a̠
도살장	t o̞ sʰ a̠ ɭ t͡ɕ͈ a̠ ŋ
유두	j u d u
세모꼴	sʰ e̞ː m o̞ k͈ o̞ ɭ
한번	h a̠ n b ʌ̹ n
곤이	k o̞ n i
ᆸ시다	p ɕ͈ i d a̠
소비하다	sʰ o̞ b i ɦ a̠ d a̠
당하다	t a̠ ŋ ɦ a̠ d a̠
서너	sʰ ʌ̹ n ʌ̹
조심	t͡ɕ o̞ː ɕʰ i m
비타민	p i tʰ a̠ m i n
배터리	p e̞ tʰ ʌ̹ ɾ i
개관식	k e̞ ɡ w a̠ n ɕʰ i k̚
법원	p ʌ̹ b w ʌ̹ n
구별하다	k u b j ʌ̹ ɾ ɦ a̠ d a̠
이야깃거리	i j a̠ ɡ i t̚ k͈ ʌ̹ ɾ i
카라반	kʰ a̠ ɾ a̠ b a̠ n
광경	k w a̠ ŋ ɡ j ʌ̹ ŋ
양복	j a̠ ŋ b o̞ k̚
백색	p e̞ː k s͈ e̞ k̚
가슴	k a̠ sʰ ɯ m
땐스	t͈ e̞ n sʰ ɯ
추켜세우다	t͡ɕʰ u k ç j ʌ̹ sʰ e̞ u d a̠
반지름	p a̠ː n d͡ʑ i ɾ ɯ m
비하다	p iː ɦ a̠ d a̠
황소	ɸ w a̠ ŋ sʰ o̞
강준치	k a̠ ŋ d͡ʑ u n t͡ɕʰ i
그려지다	k ɯ ɾ j ʌ̹ d͡ʑ i d a̠
략어	ɾ j a̠ ɡ ʌ̹
영도자	j ʌ̹ ŋ d o̞ d͡ʑ a̠
코크스	kʰ o̞ k x ɯ sʰ ɯ
가두녀성	k a̠ d u ɲ j ʌ̹ sʰ ʌ̹ ŋ
쓰레기통	s͈ ɯ ɾ e̞ ɡ i tʰ o̞ ŋ
미스	m i sʰ ɯ
사발	sʰ a̠ b a̠ ɭ
개나리꽃	k e̞ː n a̠ ɾ i k͈ o̞ t̚
메토끼	m e̞ tʰ o̞ k͈ i
어우러지다	ʌ̹ u ɾ ʌ̹ d͡ʑ i d a̠
조개	t͡ɕ o̞ ɡ e̞
실정	ɕʰ i ɭ t͡ɕ͈ ʌ̹ ŋ
가위바위보	k a̠ ɥ i b a̠ ɥ i b o̞
기술자	k i sʰ u ɭ t͡ɕ͈ a̠
나한	n a̠ ɦ a̠ n
단위	t a̠ n ɥ i
지협	t͡ɕ i ʝ j ʌ̹ p̚
왠지	w e̞ n d͡ʑ i
위협	ɥ i ʝ j ʌ̹ p̚
이뤄지다	i ɾ w ʌ̹ d͡ʑ i d a̠
씹두덩	ɕ͈ i p̚ t͈ u d ʌ̹ ŋ
우수리	u sʰ u ɾ i
실패하다	ɕʰ i ɭ pʰ e̞ ɦ a̠ d a̠
조롱이	t͡ɕ o̞ ɾ o̞ ŋ i
공부하다	k o̞ ŋ b u ɦ a̠ d a̠
가까이하다	k a̠ k͈ a̠ i ɦ a̠ d a̠
불가피	p u ɭ ɡ a̠ pʰ i
그저	k ɯ d͡ʑ ʌ̹
아세나프텐	a̠ sʰ e̞ n a̠ pʰ ɯ tʰ e̞ n
도마	t o̞ m a̠
수고하다	sʰ uː ɡ o̞ ɦ a̠ d a̠
볼기	p o̞ː ɭ ɡ i
제약	t͡ɕ e̞ː j a̠ k̚
가지	k a̠ d͡ʑ i
해저	h e̞ː d͡ʑ ʌ̹
건설	k ɘː n sʰ ʌ̹ ɭ
언짢다	ʌ̹ n t͡ɕ͈ a̠ n tʰ a̠
허혼	h ʌ̹ β o̞ n
라자냐	ɾ a̠ d͡ʑ a̠ ɲ j a̠
늙다	n ɯ k̚ t͈ a̠
젖당못견딤증	t͡ɕ ʌ̹ t̚ t͈ a̠ ŋ m o̞ t̚ k͈ j ʌ̹ n d i m d͡ʑ ɯ ŋ
모양	m o̞ j a̠ ŋ
덮다	t ʌ̹ p̚ t͈ a̠
된장찌개	t w e̞ː n d͡ʑ a̠ ŋ t͡ɕ͈ i ɡ e̞
소리치다	sʰ o̞ ɾ i t͡ɕʰ i d a̠
도매	t o̞ m e̞
야심	j a̠ː ɕʰ i m
웹사이트	w e̞ p s͈ a̠ i tʰ ɯ
태극	tʰ e̞ ɡ ɯ k̚
자기애	t͡ɕ a̠ ɡ i e̞
나뭇가지	n a̠ m u t̚ k͈ a̠ d͡ʑ i
짊다	t͡ɕ i m t͈ a̠
등신	t ɯː ŋ ɕʰ i n
몽골어	m o̞ ŋ ɡ o̞ ɾ ʌ̹
윤년	j uː n ɲ j ʌ̹ n
괴리	k w e̞ ɾ i
화살	ɸ w a̠ sʰ a̠ ɭ
등줄쥐	t ɯ ŋ d͡ʑ u ɭ d͡ʑ ɥ i
닮다	t a̠ː m t͈ a̠
아까	a̠ k͈ a̠
염증	j ʌ̹ m d͡ʑ ɯ ŋ
간접화법	k a̠ n d͡ʑ ʌ̹ pʰ w a̠ b ʌ̹ p̚
우러르다	u ɾ ʌ̹ ɾ ɯ d a̠
민수기	m i n sʰ u ɡ i
그끄제	k ɯ k͈ ɯ d͡ʑ e̞
저가락	t͡ɕ ʌ̹ ɡ a̠ ɾ a̠ k̚
먹방	m ʌ̹ k̚ p͈ a̠ ŋ
성당	sʰ ɘː ŋ d a̠ ŋ
지휘소	t͡ɕ i ɦ ɥ i sʰ o̞
크리스마스이브	k x ɯ ɾ i sʰ ɯ m a̠ sʰ ɯ i b ɯ
반찬	p a̠ n t͡ɕʰ a̠ n
닮음	t a̠ ɭ m ɯ m
테러범	tʰ e̞ ɾ ʌ̹ b ʌ̹ m
트러스트	tʰ ɯ ɾ ʌ̹ sʰ ɯ tʰ ɯ
두목	t u m o̞ k̚
숙명	sʰ u ŋ m j ʌ̹ ŋ
복엽기	p o̞ ɡ j ʌ̹ p̚ k͈ i
지원자	t͡ɕ i w ʌ̹ n d͡ʑ a̠
가만가만	k a̠ m a̠ n ɡ a̠ m a̠ n
저금통	t͡ɕ ɘː ɡ ɯ m tʰ o̞ ŋ
기체	k i t͡ɕʰ e̞
벨로키랍토르	p e̞ ɭ ɭ o̞ k ç i ɾ a̠ p̚ tʰ o̞ ɾ ɯ
가돌리늄	k a̠ d o̞ ɭ ʎ i ɲ j u m
막히다	m a̠ k ç i d a̠
강의	k a̠ː ŋ ɰ i
끝나다	k͈ ɯ n n a̠ d a̠
녀학생	ɲ j ʌ̹ ɦ a̠ k s͈ e̞ ŋ
음악	ɯ m a̠ k̚
실내악	ɕʰ i ɭ ɭ e̞ a̠ k̚
나타내다	n a̠ tʰ a̠ n e̞ d a̠
군도	k u n d o̞
흠잡다	x ɯː m d͡ʑ a̠ p̚ t͈ a̠
공간	k o̞ ŋ ɡ a̠ n
복수	p o̞ k s͈ u
얽다	ʌ̹ k̚ t͈ a̠
고집	k o̞ d͡ʑ i p̚
십이	ɕʰ i b i
애플리케이션	e̞ pʰ ɯ ɭ ʎ i kʰ e̞ i ɕʰ j ʌ̹ n
긴발톱첨서	k i n b a̠ ɭ tʰ o̞ p̚ t͡ɕʰ ʌ̹ m sʰ ʌ̹
담뱃대	t a̠ː m b e̞ t̚ t͈ e̞
홀로	ɸʷ o̞ ɭ ɭ o̞
부탁해요	p u tʰ a̠ kʰ e̞ j o
터럭	tʰ ʌ̹ ɾ ʌ̹ k̚
벤질기	p e̞ n d͡ʑ i ɭ ɡ i
발달하다	p a̠ ɭ t͈ a̠ ɾ ɦ a̠ d a̠
성함	sʰ ɘː ŋ ɦ a̠ m
노벨륨	n o̞ b e̞ ɭ ʎ j u m
난민	n a̠ n m i n
이터븀	i tʰ ʌ̹ b j u m
정식	t͡ɕ ɘː ŋ ɕʰ i k̚
캐스팅	kʰ e̞ sʰ ɯ tʰ i ŋ
하르툼	h a̠ ɾ ɯ tʰ u m
찌르다	t͡ɕ͈ i ɾ ɯ d a̠
규소	k j u sʰ o̞
현상학	ç j ʌ̹ n sʰ a̠ ŋ ɦ a̠ k̚
포피	pʰ o̞ pʰ i
친애	t͡ɕʰ i n e̞
다신론	t a̠ ɕʰ i n n o̞ n
폭풍우	pʰ o̞ k̚ pʰ u ŋ u
고향	k o̞ ʝ j a̠ ŋ
코스프레	kʰ o̞ sʰ ɯ pʰ ɯ ɾ e̞
표어	pʰ j o ʌ̹
제발	t͡ɕ e̞ː b a̠ ɭ
장식하다	t͡ɕ a̠ ŋ ɕʰ i kʰ a̠ d a̠
세르비아	s͈ e̞ ɾ ɯ b i a̠
구성	k u sʰ ʌ̹ ŋ
조종사	t͡ɕ o̞ d͡ʑ o̞ ŋ sʰ a̠
학생소년궁전	h a̠ k s͈ e̞ ŋ sʰ o̞ ɲ j ʌ̹ n ɡ u ŋ d͡ʑ ʌ̹ n
고난	k o̞ n a̠ n
진여	t͡ɕ i ɲ j ʌ̹
못생기다	m o̞ː t̚ s͈ e̞ ŋ ɡ i d a̠
뉴델리	ɲ j u d e̞ ɭ ʎ i
첫사랑	t͡ɕʰ ʌ̹ t̚ s͈ a̠ ɾ a̠ ŋ
안남	a̠ n n a̠ m
검둥이	k ʌ̹ m d u ŋ i
관화	k w a̠ n β w a̠
분석하다	p u n sʰ ʌ̹ kʰ a̠ d a̠
살찌우다	sʰ a̠ ɭ t͡ɕ͈ i u d a̠
이러쿵저러쿵	i ɾ ʌ̹ kʰ u ŋ d͡ʑ ʌ̹ ɾ ʌ̹ kʰ u ŋ
여러해살이	j ʌ̹ ɾ ʌ̹ ɦ e̞ sʰ a̠ ɾ i
항문	h a̠ ŋ m u n
보름	p o̞ ɾ ɯ m
비번	p i b ʌ̹ n
한둑중개	h a̠ n d u k̚ t͡ɕ͈ u ŋ ɡ e̞
먼지	m ʌ̹ n d͡ʑ i
음문	ɯ m m u n
암실	a̠ː m ɕʰ i ɭ
환상	ɸ w a̠ː n sʰ a̠ ŋ
공허하다	k o̞ ŋ ɦ ʌ̹ ɦ a̠ d a̠
사형	sʰ a̠ː ʝ j ʌ̹ ŋ
카르마	kʰ a̠ ɾ ɯ m a̠
밀자개	m i ɭ d͡ʑ a̠ ɡ e̞
잡담	t͡ɕ a̠ p̚ t͈ a̠ m
동네	t o̞ː ŋ n e̞
인민	i n m i n
소매	sʰ o̞ m e̞
화보	ɸ w a̠ː b o̞
듯이	t ɯ ɕʰ i
쳐죽이다	t͡ɕʰ j ʌ̹ d͡ʑ u ɡ i d a̠
대폭적	t e̞ː pʰ o̞ k̚ t͡ɕ͈ ʌ̹ k̚
매트리스	m e̞ tʰ ɯ ɾ i sʰ ɯ
액세서리	e̞ k s͈ e̞ sʰ ʌ̹ ɾ i
생화학	sʰ e̞ ŋ β w a̠ ɦ a̠ k̚
테러	tʰ e̞ ɾ ʌ̹
시민권	ɕʰ iː m i n k͈ w ʌ̹ n
옛말	j e̞ː n m a̠ ɭ
바탕	p a̠ tʰ a̠ ŋ
조치	t͡ɕ o̞ t͡ɕʰ i
해커	h e̞ kʰ ʌ̹
나일론	n a̠ i ɭ ɭ o̞ n
이원	i w ʌ̹ n
처방	t͡ɕʰ ʌ̹ b a̠ ŋ
코헬렛	kʰ o̞ ɦ e̞ ɭ ɭ e̞ t̚
크롬	k x ɯ ɾ o̞ m
찰나	t͡ɕʰ a̠ ɭ ɭ a̠
겨리	k j ʌ̹ ɾ i
항목	h a̠ː ŋ m o̞ k̚
여왕	j ʌ̹ w a̠ ŋ
게맛살	k e̞ m a̠ t̚ s͈ a̠ ɭ
고을	k o̞ ɯ ɭ
디스크	t i sʰ ɯ k x ɯ
꿀잼	k͈ u ɭ d͡ʑ e̞ m
청진	t͡ɕʰ ʌ̹ ŋ d͡ʑ i n
짱뚱어	t͡ɕ͈ a̠ ŋ t͈ u ŋ ʌ̹
보행	p o̞ː ɦ e̞ ŋ
활동적	ɸ w a̠ ɭ t͈ o̞ ŋ d͡ʑ ʌ̹ k̚
주먹	t͡ɕ u m ʌ̹ k̚
용접하다	j o ŋ d͡ʑ ʌ̹ pʰ a̠ d a̠
페나진	pʰ e̞ n a̠ d͡ʑ i n
체포하다	t͡ɕʰ e̞ pʰ o̞ ɦ a̠ d a̠
산과	sʰ a̠ n ɡ w a̠
안락사	a̠ ɭ ɭ a̠ k s͈ a̠
무시하다	m u ɕʰ i ɦ a̠ d a̠
텔레비죤	tʰ e̞ ɭ ɭ e̞ b i d͡ʑ j o n
물증	m u ɭ d͡ʑ ɯ ŋ
커뮤니케이션	kʰ ʌ̹ m j u n i kʰ e̞ i ɕʰ j ʌ̹ n
계산하다	k j e̞ː sʰ a̠ n ɦ a̠ d a̠
결과적	k j ʌ̹ ɭ ɡ w a̠ d͡ʑ ʌ̹ k̚
원앙	w ʌ̹ n a̠ ŋ
거대하다	k ɘː d e̞ ɦ a̠ d a̠
유혈목이	j u ʝ j ʌ̹ ɭ m o̞ ɡ i
의식하다	ɰ iː ɕʰ i kʰ a̠ d a̠
메달	m e̞ d a̠ ɭ
가주	k a̠ d͡ʑ u
다짐하다	t a̠ d͡ʑ i m ɦ a̠ d a̠
영화	j ʌ̹ ŋ β w a̠
인력거	i ɭ ʎ j ʌ̹ k̚ k͈ ʌ̹
나머지	n a̠ m ʌ̹ d͡ʑ i
유아원	j u a̠ w ʌ̹ n
안드레이	a̠ n d ɯ ɾ e̞ i
키스하다	k ç i sʰ ɯ ɦ a̠ d a̠
고드름	k o̞ d ɯ ɾ ɯ m
마련	m a̠ ɾ j ʌ̹ n
여권	j ʌ̹ k͈ w ʌ̹ n
운송	u n sʰ o̞ ŋ
재채기	t͡ɕ e̞ t͡ɕʰ e̞ ɡ i
함수	h a̠ː m s͈ u
아라한	a̠ ɾ a̠ ɦ a̠ n
방사선	p a̠ː ŋ sʰ a̠ sʰ ʌ̹ n
중도	t͡ɕ u ŋ d o̞
장력	t͡ɕ a̠ ŋ ɲ j ʌ̹ k̚
게이트	k e̞ i tʰ ɯ
괴물	k w e̞ː m u ɭ
버그	p ʌ̹ ɡ ɯ
책가방	t͡ɕʰ e̞ k̚ k͈ a̠ b a̠ ŋ
걸어	k ʌ̹ ɾ ʌ̹
코펜하겐	kʰ o̞ pʰ e̞ n ɦ a̠ ɡ e̞ n
실망	ɕʰ i ɭ m a̠ ŋ
백악	p e̞ ɡ a̠ k̚
수도원	sʰ u d o̞ w ʌ̹ n
축복	t͡ɕʰ u k̚ p͈ o̞ k̚
유고슬라비아	j u ɡ o̞ sʰ ɯ ɭ ɭ a̠ b i a̠
프러포즈	pʰ ɯ ɾ ʌ̹ pʰ o̞ d͡ʑ ɯ
동아리	t o̞ ŋ a̠ ɾ i
백마	p e̞ ŋ m a̠
널리	n ʌ̹ ɭ ʎ i
확성기	ɸ w a̠ k s͈ ʌ̹ ŋ ɡ i
보잘것없다	p o̞ d͡ʑ a̠ ɭ k͈ ʌ̹ sʰ ʌ̹ p̚ t͈ a̠
고전적	k o̞ː d͡ʑ ʌ̹ n d͡ʑ ʌ̹ k̚
스몰렌스크	sʰ ɯ m o̞ ɭ ɭ e̞ n sʰ ɯ k x ɯ
학습하다	h a̠ k s͈ ɯ pʰ a̠ d a̠
매월	m e̞ː w ʌ̹ ɭ
곡예사	k o̞ ɡ j e̞ sʰ a̠
유음	j u ɯ m
봉지	p o̞ ŋ d͡ʑ i
고급	k o̞ ɡ ɯ p̚
동포	t o̞ ŋ pʰ o̞
불구	p u ɭ ɡ u
땅콩	t͈ a̠ ŋ kʰ o̞ ŋ
간사	k a̠ n sʰ a̠
납지리	n a̠ p̚ t͡ɕ͈ i ɾ i
안내인	a̠ː n n e̞ i n
단념하다	t a̠ː n ɲ j ʌ̹ m ɦ a̠ d a̠
프리즘	pʰ ɯ ɾ i d͡ʑ ɯ m
구멍	k u m ʌ̹ ŋ
오른	o̞ ɾ ɯ n
립자	ɾ i p̚ t͡ɕ͈ a̠
미성	m i sʰ ʌ̹ ŋ
짜증	t͡ɕ͈ a̠ d͡ʑ ɯ ŋ
허용	h ʌ̹ j o ŋ
스승	sʰ ɯ sʰ ɯ ŋ
확실히	ɸ w a̠ k ɕ͈ i ɾ ʝ i
금액	k ɯ m e̞ k̚
통가리	tʰ o̞ ŋ ɡ a̠ ɾ i
요법	j o b ʌ̹ p̚
애초	e̞ t͡ɕʰ o̞
과로	k w a̠ ɾ o̞
밖에	p a̠ k͈ e̞
테레비	tʰ e̞ ɾ e̞ b i
불어	p u ɾ ʌ̹
문화원	m uː n β w a̠ w ʌ̹ n
짐작	t͡ɕ i m d͡ʑ a̠ k̚
음표	ɯ m pʰ j o
교류	k j o ɾ j u
매달다	m e̞ː d a̠ ɭ d a̠
왜케	w e̞ kʰ e̞
산티아고	sʰ a̠ n tʰ i a̠ ɡ o̞
부농	p uː n o̞ ŋ
배가사리	p e̞ ɡ a̠ sʰ a̠ ɾ i
낙제	n a̠ k̚ t͡ɕ͈ e̞
들여다보다	t ɯ ɾ j ʌ̹ d a̠ b o̞ d a̠
중국화	t͡ɕ u ŋ ɡ u kʰ w a̠
설화	sʰ ʌ̹ ɾ β w a̠
평균	pʰ j ʌ̹ ŋ ɡ j u n
투르	tʰ u ɾ ɯ
지하	t͡ɕ i ɦ a̠
포경	pʰ o̞ː ɡ j ʌ̹ ŋ
경제	k j ʌ̹ ŋ d͡ʑ e̞
창조하다	t͡ɕʰ a̠ː ŋ d͡ʑ o̞ ɦ a̠ d a̠
할머님	h a̠ ɭ m ʌ̹ n i m
줄공치	t͡ɕ u ɭ ɡ o̞ ŋ t͡ɕʰ i
무죄	m u d͡ʑ w e̞
제주	t͡ɕ e̞ː d͡ʑ u
라틴	ɾ a̠ tʰ i n
햇빛	h e̞ t̚ p͈ i t̚
감동	k a̠ː m d o̞ ŋ
과업	k w a̠ ʌ̹ p̚
탄소	tʰ a̠ː n sʰ o̞
개구리	k e̞ ɡ u ɾ i
퍼즐	pʰ ʌ̹ d͡ʑ ɯ ɭ
분수	p uː n sʰ u
개구리꺽정이	k e̞ ɡ u ɾ i k͈ ʌ̹ k̚ t͡ɕ͈ ʌ̹ ŋ i
녀자	ɲ j ʌ̹ d͡ʑ a̠
임산부	iː m sʰ a̠ n b u
쉽사리	ʃʰ ɥ iː p s͈ a̠ ɾ i
경고하다	k j ɘː ŋ ɡ o̞ ɦ a̠ d a̠
캥거루	kʰ e̞ ŋ ɡ ʌ̹ ɾ u
성폭행하다	sʰ ɘː ŋ pʰ o̞ kʰ e̞ ŋ ɦ a̠ d a̠
베다	p e̞ː d a̠
붙이다	p u t͡ɕʰ i d a̠
검정	k ʌ̹ m d͡ʑ ʌ̹ ŋ
여가	j ʌ̹ ɡ a̠
지난번	t͡ɕ i n a̠ n b ʌ̹ n
헤프다	h e̞ː pʰ ɯ d a̠
페미니즘	pʰ e̞ m i n i d͡ʑ ɯ m
파이프	pʰ a̠ i pʰ ɯ
네티즌	n e̞ tʰ i d͡ʑ ɯ n
스테로이드	sʰ ɯ tʰ e̞ ɾ o̞ i d ɯ
사나	sʰ a̠ n a̠
아르테미스	a̠ ɾ ɯ tʰ e̞ m i sʰ ɯ
지하도	t͡ɕ i ɦ a̠ d o̞
분점	p u n d͡ʑ ʌ̹ m
입시	i p ɕ͈ i
볼모	p o̞ ɭ m o̞
뽀뽀하다	p͈ o̞ p͈ o̞ ɦ a̠ d a̠
물러나다	m u ɭ ɭ ʌ̹ n a̠ d a̠
인증하다	i n d͡ʑ ɯ ŋ ɦ a̠ d a̠
척추동물	t͡ɕʰ ʌ̹ k̚ t͡ɕʰ u d o̞ ŋ m u ɭ
일주일	i ɭ t͡ɕ͈ u i ɭ
인사	i n sʰ a̠
경제학	k j ʌ̹ ŋ d͡ʑ e̞ ɦ a̠ k̚
비디오	p i d i o̞
개량	k e̞ː ɾ j a̠ ŋ
캠핑족	kʰ e̞ m pʰ i ŋ d͡ʑ o̞ k̚
곧장	k o̞ t̚ t͡ɕ͈ a̠ ŋ
퓨린	pʰ j u ɾ i n
전문	t͡ɕ ʌ̹ n m u n
결심하다	k j ʌ̹ ɭ ɕ͈ i m ɦ a̠ d a̠
이슬	i sʰ ɯ ɭ
가공품	k a̠ ɡ o̞ ŋ pʰ u m
서법	sʰ ʌ̹ b ʌ̹ p̚
셋째	sʰ e̞ː t̚ t͡ɕ͈ e̞
대형	t e̞ː ʝ j ʌ̹ ŋ
테러리즘	tʰ e̞ ɾ ʌ̹ ɾ i d͡ʑ ɯ m
조부모	t͡ɕ o̞ b u m o̞
신비	ɕʰ i n b i
고대교회슬라브어	k o̞ː d e̞ ɡ j o β w e̞ sʰ ɯ ɭ ɭ a̠ b ɯ ʌ̹
남수단	n a̠ m sʰ u d a̠ n
광고	k w a̠ː ŋ ɡ o̞
최초	t͡ɕʰ w e̞ː t͡ɕʰ o̞
겨누다	k j ʌ̹ n u d a̠
냉무	n e̞ ŋ m u
와봐	w a̠ː b w a̠
가운데	k a̠ u n d e̞
아무튼	a̠ː m u tʰ ɯ n
압록강	a̠ m n o̞ k̚ k͈ a̠ ŋ
점차	t͡ɕ ɘː m t͡ɕʰ a̠
해마다	h e̞ m a̠ d a̠
이해	iː ɦ e̞
그리움	k ɯ ɾ i u m
책장	t͡ɕʰ e̞ k̚ t͡ɕ͈ a̠ ŋ
동성애자	t o̞ ŋ sʰ ʌ̹ ŋ e̞ d͡ʑ a̠
미아	m i a̠
골다	k o̞ː ɭ d a̠
어원	ɘː w ʌ̹ n
끄리	k͈ ɯ ɾ i
과목	k w a̠ m o̞ k̚
교가	k j o ɡ a̠
앞서	a̠ p s͈ ʌ̹
그리스도교	k ɯ ɾ i sʰ ɯ d o̞ ɡ j o
자랑스럽다	t͡ɕ a̠ ɾ a̠ ŋ sʰ ɯ ɾ ʌ̹ p̚ t͈ a̠
지평선	t͡ɕ i pʰ j ʌ̹ ŋ sʰ ʌ̹ n
대비하다	t e̞ː b i ɦ a̠ d a̠
센트	sʰ e̞ n tʰ ɯ
긴장	k i n d͡ʑ a̠ ŋ
객실	k e̞ k ɕ͈ i ɭ
법률학	p ʌ̹ m ɲ j u ɾ ɦ a̠ k̚
여자	j ʌ̹ d͡ʑ a̠
완곡하다	w a̠ː n ɡ o̞ kʰ a̠ d a̠
이탈리아	i tʰ a̠ ɭ ʎ i a̠
스타	sʰ ɯ tʰ a̠
마차	m a̠ː t͡ɕʰ a̠
트랜지스터	tʰ ɯ ɾ e̞ n d͡ʑ i sʰ ɯ tʰ ʌ̹
당기다	t a̠ ŋ ɡ i d a̠
핵반응	h e̞ k̚ p͈ a̠ n ɯ ŋ
오문	o̞ m u n
구주	k u d͡ʑ u
부르짖다	p u ɾ ɯ d͡ʑ i t̚ t͈ a̠
복스럽다	p o̞ k s͈ ɯ ɾ ʌ̹ p̚ t͈ a̠
음모	ɯ m m o̞
안전제일	a̠ n d͡ʑ ʌ̹ n d͡ʑ e̞ i ɭ
쌓다	s͈ a̠ tʰ a̠
아웃	a̠ u t̚
작별	t͡ɕ a̠ k̚ p͈ j ʌ̹ ɭ
프로젝트	pʰ ɯ ɾ o̞ d͡ʑ e̞ k̚ tʰ ɯ
오사존	o̞ sʰ a̠ d͡ʑ o̞ n
설탕	sʰ ʌ̹ ɭ tʰ a̠ ŋ
미용원	m iː j o ŋ w ʌ̹ n
강수	k a̠ː ŋ sʰ u
간선	k a̠ n sʰ ʌ̹ n
선풍기	sʰ ʌ̹ n pʰ u ŋ ɡ i
담벼락	t a̠ m p͈ j ʌ̹ ɾ a̠ k̚
통역사	tʰ o̞ ŋ j ʌ̹ k s͈ a̠
가까이	k a̠ k͈ a̠ i
소년궁전	sʰ o̞ː ɲ j ʌ̹ n ɡ u ŋ d͡ʑ ʌ̹ n
돛대	t o̞ t̚ t͈ e̞
고문	k o̞ m u n
추억	t͡ɕʰ u ʌ̹ k̚
주근깨	t͡ɕ u ɡ ɯ n k͈ e̞
논쟁점	n o̞ n d͡ʑ e̞ ŋ t͡ɕ͈ ʌ̹ m
샤타	ɕʰ j a̠ tʰ a̠
뮌헨	m ɥ i n ɦ e̞ n
보상하다	p o̞ː sʰ a̠ ŋ ɦ a̠ d a̠
애틋하다	e̞ tʰ ɯ tʰ a̠ d a̠
그네들	k ɯ n e̞ d ɯ ɭ
개지랄하다	k e̞ː d͡ʑ i ɾ a̠ ɾ ɦ a̠ d a̠
사진	sʰ a̠ d͡ʑ i n
빈자	p i n d͡ʑ a̠
바레인	p a̠ ɾ e̞ i n
명왕성	m j ʌ̹ ŋ w a̠ ŋ sʰ ʌ̹ ŋ
아마	a̠ m a̠
이심전심	i ɕʰ i m d͡ʑ ʌ̹ n ɕʰ i m
예식	j e̞ ɕʰ i k̚
벤토	p e̞ n tʰ o̞
뛰어들다	t͈ ɥ i ʌ̹ d ɯ ɭ d a̠
긴몰개	k iː n m o̞ ɭ ɡ e̞
발뒤꿈	p a̠ ɭ t͈ ɥ i k͈ u m
상대적	sʰ a̠ ŋ d e̞ d͡ʑ ʌ̹ k̚
리튬	ɾ i tʰ j u m
월병	w ʌ̹ ɭ b j ʌ̹ ŋ
호치키스	ɸʷ o̞ t͡ɕʰ i k ç i sʰ ɯ
민물가마우지	m i n m u ɭ ɡ a̠ m a̠ u d͡ʑ i
기억하다	k i ʌ̹ kʰ a̠ d a̠
셀레늄	sʰ e̞ ɭ ɭ e̞ ɲ j u m
가지뿔	k a̠ d͡ʑ i p͈ u ɭ
냉동고	n e̞ː ŋ d o̞ ŋ ɡ o̞
탁자	tʰ a̠ k̚ t͡ɕ͈ a̠
부여	p u j ʌ̹
멱살	m j ʌ̹ k s͈ a̠ ɭ
언뜻	ʌ̹ n t͈ ɯ t̚
빈도	p i n d o̞
카자흐스탄	kʰ a̠ d͡ʑ a̠ ɣ ɯ sʰ ɯ tʰ a̠ n
요사이	j o sʰ a̠ i
순결	sʰ u n ɡ j ʌ̹ ɭ
파괴하다	pʰ a̠ː ɡ w e̞ ɦ a̠ d a̠
트빌리시	tʰ ɯ b i ɭ ʎ i ɕʰ i
저희	t͡ɕ ʌ̹ ʝ i
스미다	sʰ ɯ m i d a̠
충돌	t͡ɕʰ u ŋ d o̞ ɭ
닝샤	n i ŋ ɕʰ j a̠
아이들	a̠ i d ɯ ɭ
오페레타	o̞ pʰ e̞ ɾ e̞ tʰ a̠
성실	sʰ ʌ̹ ŋ ɕʰ i ɭ
매번	m e̞ː b ʌ̹ n
앨리트	e̞ ɭ ʎ i tʰ ɯ
미카엘	m i kʰ a̠ e̞ ɭ
가늘다	k a̠ n ɯ ɭ d a̠
테구시갈파	tʰ e̞ ɡ u ɕʰ i ɡ a̠ ɭ pʰ a̠
가축	k a̠ t͡ɕʰ u k̚
종다리	t͡ɕ o̞ ŋ d a̠ ɾ i
사기	sʰ a̠ ɡ i
돌잡이	t o̞ ɭ d͡ʑ a̠ b i
비늘흰발망둑	p i n ɯ ɾ ʝ i n b a̠ ɭ m a̠ ŋ d u k̚
사방	sʰ a̠ː b a̠ ŋ
개자식	k e̞ː d͡ʑ a̠ ɕʰ i k̚
불라	p u ɭ ɭ a̠
젖통	t͡ɕ ʌ̹ t̚ tʰ o̞ ŋ
줴치다	t͡ɕ w e̞ː t͡ɕʰ i d a̠
부대찌개	p u d e̞ t͡ɕ͈ i ɡ e̞
법률	p ʌ̹ m ɲ j u ɭ
사닥다리	sʰ a̠ d a̠ k̚ t͈ a̠ ɾ i
바람직하다	p a̠ ɾ a̠ m d͡ʑ i kʰ a̠ d a̠
평원	pʰ j ʌ̹ ŋ w ʌ̹ n
전시하다	t͡ɕ ɘː n ɕʰ i ɦ a̠ d a̠
녀성	ɲ j ʌ̹ sʰ ʌ̹ ŋ
제트기	t͡ɕ e̞ tʰ ɯ ɡ i
음악회	ɯ m a̠ kʰ w e̞
건달	k ʌ̹ n d a̠ ɭ
저녁놀	t͡ɕ ʌ̹ ɲ j ʌ̹ ŋ n o̞ ɭ
신임	ɕʰ iː n i m
기쁨조	k i p͈ ɯ m d͡ʑ o̞
들어가다	t ɯ ɾ ʌ̹ ɡ a̠ d a̠
전문가	t͡ɕ ʌ̹ n m u n ɡ a̠
기본적	k i b o̞ n d͡ʑ ʌ̹ k̚
빨갱이	p͈ a̠ ɭ ɡ e̞ ŋ i
플라스크	pʰ ɯ ɭ ɭ a̠ sʰ ɯ k x ɯ
닿소리	t a̠ s͈ o̞ ɾ i
압록자그사니	a̠ m n o̞ k̚ t͡ɕ͈ a̠ ɡ ɯ sʰ a̠ n i
맹꽁이	m e̞ː ŋ k͈ o̞ ŋ i
간첩	k a̠ː n t͡ɕʰ ʌ̹ p̚
유희	j u ʝ i
기여	k i j ʌ̹
티라노사우루스	tʰ i ɾ a̠ n o̞ sʰ a̠ u ɾ u sʰ ɯ
회상	ɸ w e̞ sʰ a̠ ŋ
해결되다	h e̞ː ɡ j ʌ̹ ɭ d w e̞ d a̠
파파라치	pʰ a̠ pʰ a̠ ɾ a̠ t͡ɕʰ i
비닐	p i n i ɭ
문화주택	m u n β w a̠ d͡ʑ u tʰ e̞ k̚
모서리	m o̞ sʰ ʌ̹ ɾ i
형님	ç j ʌ̹ ŋ n i m
욕하다	j o kʰ a̠ d a̠
해롭다	h e̞ː ɾ o̞ p̚ t͈ a̠
램프	ɾ e̞ m pʰ ɯ
주요	t͡ɕ u j o
거래	k ɘː ɾ e̞
달려오다	t a̠ ɭ ʎ j ʌ̹ o̞ d a̠
카렌더	kʰ a̠ ɾ e̞ n d ʌ̹
부귀영화	p uː ɡ ɥ i j ʌ̹ ŋ β w a̠
니코틴	n i kʰ o̞ tʰ i n
뻗다	p͈ ʌ̹ t̚ t͈ a̠
그녀	k ɯ ɲ j ʌ̹
마련되다	m a̠ ɾ j ʌ̹ n d w e̞ d a̠
포도	pʰ o̞ d o̞
홍머리오리	ɸʷ o̞ ŋ m ʌ̹ ɾ i o̞ ɾ i
핫라인	h a̠ n n a̠ i n
옴쌀	o̞ m s͈ a̠ ɭ
분재	p u n d͡ʑ e̞
인티파다	i n tʰ i pʰ a̠ d a̠
수다떨다	sʰ u d a̠ t͈ ʌ̹ ɭ d a̠
요람	j o ɾ a̠ m
선율	sʰ ʌ̹ ɲ j u ɭ
가뭄	k a̠ m u m
하슘	h a̠ ɕʰ j u m
제유	t͡ɕ e̞ j u
그제	k ɯ d͡ʑ e̞
오라버님	o̞ ɾ a̠ b ʌ̹ n i m
축제	t͡ɕʰ u k̚ t͡ɕ͈ e̞
피페리딘	pʰ i pʰ e̞ ɾ i d i n
독일어	t o̞ ɡ i ɾ ʌ̹
자주복	t͡ɕ a̠ː d͡ʑ u b o̞ k̚
노쇠	n o̞ː sʰ w e̞
그게	k ɯ ɡ e̞
쇼케이스	ɕʰ j o kʰ e̞ i sʰ ɯ
모이	m o̞ i
분량	p uː ɭ ʎ j a̠ ŋ
다루다	t a̠ ɾ u d a̠
묵다	m u k̚ t͈ a̠
여론	j ɘː ɾ o̞ n
쏟아지다	s͈ o̞ d a̠ d͡ʑ i d a̠
세탁실	sʰ e̞ː tʰ a̠ k ɕ͈ i ɭ
안트라센	a̠ n tʰ ɯ ɾ a̠ sʰ e̞ n
기저	k i d͡ʑ ʌ̹
린스	ɾ i n sʰ ɯ
진눈깨비	t͡ɕ i n n u n k͈ e̞ b i
그라피토	k͈ ɯ ɾ a̠ pʰ i tʰ o̞
야드	j a̠ d ɯ
들키다	t ɯ ɭ k ç i d a̠
덩어리	t ʌ̹ ŋ ʌ̹ ɾ i
메밀	m e̞ m i ɭ
당뇨병	t a̠ ŋ ɲ j o p͈ j ʌ̹ ŋ
시냇물	ɕʰ iː n e̞ n m u ɭ
여름	j ʌ̹ ɾ ɯ m
하얼빈	h a̠ ʌ̹ ɭ b i n
반항	p a̠ː n ɦ a̠ ŋ
고지	k o̞ d͡ʑ i
밥솥	p a̠ p s͈ o̞ t̚
수로	sʰ u ɾ o̞
하노이	h a̠ n o̞ i
아메바	a̠ m e̞ b a̠
막다	m a̠ k̚ t͈ a̠
곪다	k o̞ː m t͈ a̠
갑작스레	k a̠ p̚ t͡ɕ͈ a̠ k s͈ ɯ ɾ e̞
과연	k w a̠ː j ʌ̹ n
적혈구	t͡ɕ ʌ̹ k ç j ʌ̹ ɭ ɡ u
무언가	m u ʌ̹ n ɡ a̠
내리다	n e̞ ɾ i d a̠
나리	n a̠ ɾ i
트롤	tʰ ɯ ɾ o̞ ɭ
마이크로폰	m a̠ i k x ɯ ɾ o̞ pʰ o̞ n
랜섬웨어	ɾ e̞ n sʰ ʌ̹ m w e̞ ʌ̹
좌우	t͡ɕ w a̠ː u
떨어뜨리다	t͈ ʌ̹ ɾ ʌ̹ t͈ ɯ ɾ i d a̠
돌아보다	t o̞ ɾ a̠ b o̞ d a̠
아순시온	a̠ sʰ u n ɕʰ i o̞ n
아라	a̠ ɾ a̠
수동태	sʰ u d o̞ ŋ tʰ e̞
청춘	t͡ɕʰ ʌ̹ ŋ t͡ɕʰ u n
구애	k u e̞
복습하다	p o̞ k s͈ ɯ pʰ a̠ d a̠
동생	t o̞ ŋ sʰ e̞ ŋ
서점	sʰ ʌ̹ d͡ʑ ʌ̹ m
엷다	j ɘː ɭ t͈ a̠
무기	m uː ɡ i
쓸개즙	s͈ ɯ ɭ ɡ e̞ d͡ʑ ɯ p̚
한편	h a̠ n pʰ j ʌ̹ n
큰기러기	k x ɯ n ɡ i ɾ ʌ̹ ɡ i
오다	o̞ d a̠
모스크바	m o̞ sʰ ɯ k x ɯ b a̠
장보다	t͡ɕ a̠ ŋ b o̞ d a̠
월남	w ʌ̹ ɭ ɭ a̠ m
혹등고래	ɸʷ o̞ k̚ t͈ ɯ ŋ ɡ o̞ ɾ e̞
모페드	m o̞ pʰ e̞ d ɯ
교재	k j oː d͡ʑ e̞
스키	sʰ ɯ k ç i
까벨	k͈ a̠ b e̞ ɭ
도라지	t o̞ ɾ a̠ d͡ʑ i
일출	i ɭ t͡ɕʰ u ɭ
회전목마	ɸ w e̞ d͡ʑ ʌ̹ n m o̞ ŋ m a̠
숙제하다	sʰ u k̚ t͡ɕ͈ e̞ ɦ a̠ d a̠
편복	pʰ j ʌ̹ n b o̞ k̚
돼지	t w e̞ː d͡ʑ i
누리다	n u ɾ i d a̠
몰다	m o̞ː ɭ d a̠
삼국	sʰ a̠ m ɡ u k̚
전통적	t͡ɕ ʌ̹ n tʰ o̞ ŋ d͡ʑ ʌ̹ k̚
계집아이	k j e̞ː d͡ʑ i b a̠ i
성서	sʰ ɘː ŋ sʰ ʌ̹
사계	sʰ a̠ k͈ j e̞
저승사자	t͡ɕ ʌ̹ sʰ ɯ ŋ sʰ a̠ d͡ʑ a̠
발기	p a̠ ɭ ɡ i
비버	p i b ʌ̹
진공	t͡ɕ i n ɡ o̞ ŋ
동맹	t o̞ ŋ m e̞ ŋ
수건	sʰ uː ɡ ʌ̹ n
알약	a̠ ɭ ʎ j a̠ k̚
슈니첼	ɕʰ j u n i t͡ɕʰ e̞ ɭ
의학	ɰ i ɦ a̠ k̚
근무	k ɯː n m u
솔까말	sʰ o̞ ɭ k͈ a̠ m a̠ ɭ
노예	n o̞ j e̞
궁륭	k u ŋ ɲ j u ŋ
박제	p a̠ k̚ t͡ɕ͈ e̞
독사	t o̞ k s͈ a̠
아무런	a̠ː m u ɾ ʌ̹ n
장기	t͡ɕ a̠ː ŋ ɡ i
줄납자루	t͡ɕ u ɭ ɭ a̠ p̚ t͡ɕ͈ a̠ ɾ u
투발루	tʰ u b a̠ ɭ ɭ u
못지않다	m o̞ː t̚ t͡ɕ͈ i a̠ n tʰ a̠
손빨래	sʰ o̞ n p͈ a̠ ɭ ɭ e̞
잠들다	t͡ɕ a̠ m d ɯ ɭ d a̠
영국인	j ʌ̹ ŋ ɡ u ɡ i n
매력	m e̞ ɾ j ʌ̹ k̚
하라레	h a̠ ɾ a̠ ɾ e̞
타일	tʰ a̠ i ɭ
감리교	k a̠ m n i ɡ j o
대학수학능력시험	t e̞ː ɦ a̠ k s͈ u ɦ a̠ ŋ n ɯ ŋ ɲ j ʌ̹ k ɕ͈ i ɦ ʌ̹ m
올해	o̞ ɾ ɦ e̞
사이보그	s͈ a̠ i b o̞ ɡ ɯ
섣달	sʰ ɘː t̚ t͈ a̠ ɭ
결합	k j ʌ̹ ɾ ɦ a̠ p̚
천주교	t͡ɕʰ ʌ̹ n d͡ʑ u ɡ j o
뱅어	p e̞ː ŋ ʌ̹
참가자	t͡ɕʰ a̠ m ɡ a̠ d͡ʑ a̠
찻숱가락	t͡ɕʰ a̠ t̚ s͈ u t̚ k͈ a̠ ɾ a̠ k̚
활동가	ɸ w a̠ ɭ t͈ o̞ ŋ ɡ a̠
왜인	w e̞ i n
벽돌	p j ʌ̹ k̚ t͈ o̞ ɭ
캠퍼스	kʰ e̞ m pʰ ʌ̹ sʰ ɯ
사창	sʰ a̠ t͡ɕʰ a̠ ŋ
더듬다	t ʌ̹ d ɯ m t͈ a̠
시도하다	ɕʰ iː d o̞ ɦ a̠ d a̠
오줌	o̞ d͡ʑ u m
검은담비	k ʌ̹ m ɯ n d a̠ m b i
성문	sʰ ʌ̹ ŋ m u n
기계	k i ɡ j e̞
스마트폰	sʰ ɯ m a̠ tʰ ɯ pʰ o̞ n
사단	sʰ a̠ d a̠ n
광업	k w a̠ː ŋ ʌ̹ p̚
엿새	j ʌ̹ t̚ s͈ e̞
입천장	i p̚ t͡ɕʰ ʌ̹ n d͡ʑ a̠ ŋ
따라서	t͈ a̠ ɾ a̠ sʰ ʌ̹
냉수	n e̞ː ŋ sʰ u
반반	p a̠ː n b a̠ n
안해	a̠ n ɦ e̞
희로애락	ç i ɾ o̞ e̞ ɾ a̠ k̚
방패	p a̠ ŋ pʰ e̞
염려하다	j ɘː m ɲ j ʌ̹ ɦ a̠ d a̠
친절하다	t͡ɕʰ i n d͡ʑ ʌ̹ ɾ ɦ a̠ d a̠
직감	t͡ɕ i k̚ k͈ a̠ m
식탁보	ɕʰ i k̚ tʰ a̠ k̚ p͈ o̞
두뇌	t u n w e̞
초고속	t͡ɕʰ o̞ ɡ o̞ sʰ o̞ k̚
오디	o̞ d i
카지노	kʰ a̠ d͡ʑ i n o̞
추격	t͡ɕʰ u ɡ j ʌ̹ k̚
홋카이도	ɸʷ o̞ t̚ kʰ a̠ i d o̞
포스터	pʰ o̞ sʰ ɯ tʰ ʌ̹
지치다	t͡ɕ iː t͡ɕʰ i d a̠
격려	k j ʌ̹ ŋ ɲ j ʌ̹
열차	j ʌ̹ ɭ t͡ɕʰ a̠
영화관	j ʌ̹ ŋ β w a̠ ɡ w a̠ n
고약하다	k o̞ː j a̠ kʰ a̠ d a̠
욕망	j o ŋ m a̠ ŋ
꺼풀	k͈ ʌ̹ pʰ u ɭ
미꾸라지	m i k͈ u ɾ a̠ d͡ʑ i
인후	i n β u
라이선스	ɾ a̠ i sʰ ʌ̹ n sʰ ɯ
회사원	ɸ w e̞ː sʰ a̠ w ʌ̹ n
스푼	sʰ ɯ pʰ u n
구매	k u m e̞
유로	j u ɾ o̞
변동	p j ɘː n d o̞ ŋ
밴대질	p e̞ n d e̞ d͡ʑ i ɭ
핵가족	h e̞ k̚ k͈ a̠ d͡ʑ o̞ k̚
눈사람	n uː n s͈ a̠ ɾ a̠ m
인류학	i ɭ ʎ j u ɦ a̠ k̚
볼펜	p o̞ ɭ pʰ e̞ n
주바	t͡ɕ u b a̠
경로	k j ʌ̹ ŋ n o̞
충전기	t͡ɕʰ u ŋ d͡ʑ ʌ̹ n ɡ i
케익	kʰ e̞ i k̚
당당하다	t a̠ ŋ d a̠ ŋ ɦ a̠ d a̠
깊다	k i p̚ t͈ a̠
군주	k u n d͡ʑ u
무서워하다	m u sʰ ʌ̹ w ʌ̹ ɦ a̠ d a̠
조용하다	t͡ɕ o̞ j o ŋ ɦ a̠ d a̠
영묘	j ʌ̹ ŋ m j o
벨트	p e̞ ɭ tʰ ɯ
정리하다	t͡ɕ ɘː ŋ n i ɦ a̠ d a̠
로망스	ɾ o̞ m a̠ ŋ sʰ ɯ
생각하다	sʰ e̞ ŋ ɡ a̠ kʰ a̠ d a̠
연가	j ɘː n ɡ a̠
공부자	k o̞ː ŋ b u d͡ʑ a̠
까마귀	k͈ a̠ m a̠ ɡ ɥ i
득도	t ɯ k̚ t͈ o̞
중국인	t͡ɕ u ŋ ɡ u ɡ i n
그리스어	k ɯ ɾ i sʰ ɯ ʌ̹
아홉째	a̠ β o̞ p̚ t͡ɕ͈ e̞
현미경	ç j ɘː n m i ɡ j ʌ̹ ŋ
미니버스	m i n i b ʌ̹ sʰ ɯ
운전사	uː n d͡ʑ ʌ̹ n sʰ a̠
조직	t͡ɕ o̞ d͡ʑ i k̚
별빛	p j ɘː ɭ p͈ i t̚
모습	m o̞ sʰ ɯ p̚
잽싸다	t͡ɕ e̞ p s͈ a̠ d a̠
지각	t͡ɕ i ɡ a̠ k̚
스파이웨어	sʰ ɯ pʰ a̠ i w e̞ ʌ̹
매탄	m e̞ tʰ a̠ n
멜버른	m e̞ ɭ b ʌ̹ ɾ ɯ n
정치인	t͡ɕ ʌ̹ ŋ t͡ɕʰ i i n
막대기	m a k̚ d̬ ɛː ɡ i
조끼	t͡ɕ o̞ k͈ i
전차	t͡ɕ ɘː n t͡ɕʰ a̠
참가	t͡ɕʰ a̠ m ɡ a̠
곁사슬	k j ʌ̹ t̚ s͈ a̠ sʰ ɯ ɭ
왜냐하면	w e̞ ɲ j a̠ ɦ a̠ m j ʌ̹ n
끼치다	k͈ i t͡ɕʰ i d a̠
영성	j ʌ̹ ŋ sʰ ʌ̹ ŋ
쌍반점	s͈ a̠ ŋ b a̠ n d͡ʑ ʌ̹ m
선언	sʰ ʌ̹ n ʌ̹ n
딱딱하다	t͈ a̠ k̚ t͈ a̠ kʰ a̠ d a̠
박물관	p a̠ ŋ m u ɭ ɡ w a̠ n
면세	m j ɘː n sʰ e̞
후과	ɸʷ u ɡ w a̠
우크라이나어	u k x ɯ ɾ a̠ i n a̠ ʌ̹
책상	t͡ɕʰ e̞ k s͈ a̠ ŋ
결혼하다	k j ʌ̹ ɾ β o̞ n ɦ a̠ d a̠
살인자	sʰ a̠ ɾ i n d͡ʑ a̠
미싱	m i ɕʰ i ŋ
충격	t͡ɕʰ u ŋ ɡ j ʌ̹ k̚
마음	m a̠ ɯ m
면사	m j ʌ̹ n sʰ a̠
색맹	sʰ e̞ ŋ m e̞ ŋ
직캠	t͡ɕ i k̚ kʰ e̞ m
재난	t͡ɕ e̞ n a̠ n
ᆫ데	n d e̞
늘어나다	n ɯ ɾ ʌ̹ n a̠ d a̠
외손자	w e̞ː sʰ o̞ n d͡ʑ a̠
세다	sʰ e̞ː d a̠
추가	t͡ɕʰ u ɡ a̠
리셉션	ɾ i s͈ e̞ p ɕ͈ j ʌ̹ n
육군	j u k̚ k͈ u n
공식	k o̞ ŋ ɕʰ i k̚
홍해	ɸʷ o̞ ŋ ɦ e̞
뽑다	p͈ o̞ p̚ t͈ a̠
삼선	sʰ a̠ m sʰ ʌ̹ n
마티아	m a̠ tʰ i a̠
상인	sʰ a̠ ŋ i n
슬로베니아	sʰ ɯ ɭ ɭ o̞ b e̞ n i a̠
알락오리	a̠ ɭ ɭ a̠ ɡ o̞ ɾ i
임대하다	iː m d e̞ ɦ a̠ d a̠
마멋	m a̠ m ʌ̹ t̚
시력	ɕʰ iː ɾ j ʌ̹ k̚
샤워	ɕʰ j a̠ w ʌ̹
바이너리	p a̠ i n ʌ̹ ɾ i
교포	k j o pʰ o̞
동쪽	t o̞ ŋ t͡ɕ͈ o̞ k̚
계산원	k j e̞ː sʰ a̠ n w ʌ̹ n
띵호아	t͈ i ŋ β o̞ a̠
봐주다	p w a̠ː d͡ʑ u d a̠
아콰리움	a̠ kʰ w a̠ ɾ i u m
자칼	t͡ɕ a̠ kʰ a̠ ɭ
날두하다	n a̠ ɭ d u ɦ a̠ d a̠
눅다	n u k̚ t͈ a̠
핀란드어	pʰ i ɭ ɭ a̠ n d ɯ ʌ̹
우습다	uː sʰ ɯ p̚ t͈ a̠
띠다	t͈ iː d a̠
인생	i n sʰ e̞ ŋ
기슭	k i sʰ ɯ k̚
해결	h e̞ː ɡ j ʌ̹ ɭ
산문	sʰ a̠ː n m u n
따라하다	t͈ a̠ ɾ a̠ ɦ a̠ d a̠
점줄망둑	t͡ɕ ʌ̹ m d͡ʑ u ɭ m a̠ ŋ d u k̚
고구마	k o̞ː ɡ u m a̠
스쿼시	sʰ ɯ kʰ w ʌ̹ ɕʰ i
찻잎	t͡ɕʰ a̠ n n i p̚
게릴라	k e̞ ɾ i ɭ ɭ a̠
육각수	j u k̚ k͈ a̠ k s͈ u
피트	pʰ i tʰ ɯ
본질	p o̞ n d͡ʑ i ɭ
의지	ɰ iː d͡ʑ i
약속하다	j a̠ k s͈ o̞ kʰ a̠ d a̠
레위니옹	ɾ e̞ ɥ i n i o̞ ŋ
유성	j u sʰ ʌ̹ ŋ
조선글	t͡ɕ o̞ sʰ ʌ̹ n ɡ ɯ ɭ
악단	a̠ k̚ t͈ a̠ n
의견	ɰ iː ɡ j ʌ̹ n
흰개미	ç i n ɡ e̞ m i
스모	s͈ ɯ m o̞
수간	sʰ u ɡ a̠ n
말뚝	m a̠ ɭ t͈ u k̚
홍수	ɸʷ o̞ ŋ sʰ u
도움	t o̞ u m
결과	k j ʌ̹ ɭ ɡ w a̠
양자역학	j a̠ ŋ d͡ʑ a̠ j ʌ̹ kʰ a̠ k̚
쇠붙이	sʰ w e̞ b u t͡ɕʰ i
주교	t͡ɕ u ɡ j o
예카테린부르크	j e̞ kʰ a̠ tʰ e̞ ɾ i n b u ɾ ɯ k x ɯ
다차	t a̠ t͡ɕʰ a̠
독살	t o̞ k s͈ a̠ ɭ
도료	t o̞ ɾ j o
선실	sʰ ʌ̹ n ɕʰ i ɭ
슈퍼마켓	ɕʰ j u pʰ ʌ̹ m a̠ kʰ e̞ t̚
몽골	m o̞ ŋ ɡ o̞ ɭ
지겹다	t͡ɕ i ɡ j ʌ̹ p̚ t͈ a̠
유럽	j u ɾ ʌ̹ p̚
역학	j ʌ̹ kʰ a̠ k̚
통지	tʰ o̞ ŋ d͡ʑ i
교육	k j oː j u k̚
어머	ʌ̹ m ʌ̹
부스깨	p u sʰ ɯ k͈ e̞
전설	t͡ɕ ɘː n sʰ ʌ̹ ɭ
노인병학	n o̞ː i n b j ʌ̹ ŋ ɦ a̠ k̚
옥문	o̞ ŋ m u n
키토	k ç i tʰ o̞
뜨락또르	t͈ ɯ ɾ a̠ k̚ t͈ o̞ ɾ ɯ
쌩얼	s͈ e̞ ŋ ʌ̹ ɭ
자존심	t͡ɕ a̠ d͡ʑ o̞ n ɕʰ i m
문헌	m u n ɦ ʌ̹ n
부릅뜨다	p u ɾ ɯ p̚ t͈ ɯ d a̠
구아니딘	k u a̠ n i d i n
부침개	p u t͡ɕʰ i m ɡ e̞
기니비사우	k i n i b i sʰ a̠ u
예상하다	j e̞ː sʰ a̠ ŋ ɦ a̠ d a̠
독극물	t o̞ k̚ k͈ ɯ ŋ m u ɭ
부끄리다	p u k͈ ɯ ɾ i d a̠
노란색	n o̞ ɾ a̠ n sʰ e̞ k̚
윅셔너리	ɥ i k ɕ͈ j ʌ̹ n ʌ̹ ɾ i
양곤	j a̠ ŋ ɡ o̞ n
흔히	x ɯ n ʝ i
갈고랑이	k a̠ ɭ ɡ o̞ ɾ a̠ ŋ i
장사	t͡ɕ a̠ ŋ sʰ a̠
체질	t͡ɕʰ e̞ d͡ʑ i ɭ
철사	t͡ɕʰ ʌ̹ ɭ s͈ a̠
청색	t͡ɕʰ ʌ̹ ŋ sʰ e̞ k̚
애매모호	e̞ː m e̞ m o̞ β o̞
미각	m i ɡ a̠ k̚
설사	sʰ ʌ̹ ɭ s͈ a̠
세월	sʰ e̞ w ʌ̹ ɭ
실로	ɕʰ i ɭ ɭ o̞
비엔나	p i e̞ n n a̠
누리집	n u ɾ i d͡ʑ i p̚
음소	ɯ m sʰ o̞
자주	t͡ɕ a̠ d͡ʑ u
눈알	n u n a̠ ɭ
푸른얼굴얼가니새	pʰ u ɾ ɯ n ʌ̹ ɭ ɡ u ɾ ʌ̹ ɭ ɡ a̠ n i sʰ e̞
망설이다	m a̠ ŋ sʰ ʌ̹ ɾ i d a̠
마케팅	m a̠ kʰ e̞ tʰ i ŋ
미생물학	m i sʰ e̞ ŋ m u ɾ ɦ a̠ k̚
본부	p o̞ n b u
중복되다	t͡ɕ uː ŋ b o̞ k̚ t͈ w e̞ d a̠
휴대	ç j u d e̞
고소하다	k o̞ː sʰ o̞ ɦ a̠ d a̠
굳세다	k u t̚ s͈ e̞ d a̠
쓸개	s͈ ɯ ɭ ɡ e̞
외숙모	w e̞ sʰ u ŋ m o̞
취리히	t͡ɕʰ ɥ i ɾ i ʝ i
동행	t o̞ ŋ ɦ e̞ ŋ
가스레인지	k a̠ sʰ ɯ ɾ e̞ i n d͡ʑ i
스튜	sʰ ɯ tʰ j u
원룸	w ʌ̹ n n u m
곱셈	k o̞ p s͈ e̞ m
축음기	t͡ɕʰ u ɡ ɯ m ɡ i
제대로	t͡ɕ e̞ d e̞ ɾ o̞
상견례	sʰ a̠ ŋ ɡ j ʌ̹ ɭ ʎ j e̞
반지	p a̠ n d͡ʑ i
직후	t͡ɕ i kʰ u
갈비탕	k a̠ ɭ b i tʰ a̠ ŋ
영어	j ʌ̹ ŋ ʌ̹
갑옷	k a̠ b o̞ t̚
좀수수치	t͡ɕ o̞ m sʰ u sʰ u t͡ɕʰ i
슬픔	sʰ ɯ ɭ pʰ ɯ m
오십	o̞ː ɕʰ i p̚
다르에스살람	t a̠ ɾ ɯ e̞ sʰ ɯ sʰ a̠ ɭ ɭ a̠ m
어파	ɘː pʰ a̠
별명	p j ʌ̹ ɭ m j ʌ̹ ŋ
높다	n o̞ p̚ t͈ a̠
말벌	m a̠ ɭ b ʌ̹ ɭ
방정식	p a̠ ŋ d͡ʑ ʌ̹ ŋ ɕʰ i k̚
한국산개구리	h a̠ n ɡ u k s͈ a̠ n ɡ e̞ ɡ u ɾ i
국내	k u ŋ n e̞
열대붉은해오라기	j ʌ̹ ɭ d e̞ b u ɭ ɡ ɯ n ɦ e̞ o̞ ɾ a̠ ɡ i
스텝	sʰ ɯ tʰ e̞ p̚
큰흰죽지	k x ɯ n ʝ i n d͡ʑ u k̚ t͡ɕ͈ i
시에라리온	ɕ͈ i e̞ ɾ a̠ ɾ i o̞ n
흥청망청	x ɯ ŋ t͡ɕʰ ʌ̹ ŋ m a̠ ŋ t͡ɕʰ ʌ̹ ŋ
유제품	j u d͡ʑ e̞ pʰ u m
무릎	m u ɾ ɯ p̚
심하다	ɕʰ iː m ɦ a̠ d a̠
민감	m i n ɡ a̠ m
배지	p e̞ d͡ʑ i
하프늄	h a̠ pʰ ɯ ɲ j u m
게이	k e̞ i
자두나무	t͡ɕ a̠ d u n a̠ m u
갹출	k j a̠ k̚ t͡ɕʰ u ɭ
흠뻑	x ɯ m p͈ ʌ̹ k̚
자모	t͡ɕ a̠ m o̞
나이지리아	n a̠ i d͡ʑ i ɾ i a̠
이교	iː ɡ j o
구분하다	k u b u n ɦ a̠ d a̠
킬트	k ç i ɭ tʰ ɯ
질투	t͡ɕ i ɭ tʰ u
석류석	sʰ ʌ̹ ŋ ɲ j u sʰ ʌ̹ k̚
참붕어	t͡ɕʰ a̠ m b u ŋ ʌ̹
쌍동이	s͈ a̠ ŋ d o̞ ŋ i
워낙	w ʌ̹ n a̠ k̚
브라질리아	p ɯ ɾ a̠ d͡ʑ i ɭ ʎ i a̠
도작	t o̞ d͡ʑ a̠ k̚
보너스	p o̞ n ʌ̹ sʰ ɯ
씹하다	ɕ͈ i pʰ a̠ d a̠
호박	ɸʷ o̞ː b a̠ k̚
지르코늄	t͡ɕ i ɾ ɯ kʰ o̞ ɲ j u m
장치	t͡ɕ a̠ ŋ t͡ɕʰ i
상태	sʰ a̠ ŋ tʰ e̞
꿰다	k͈ w e̞ː d a̠
아이스크림	a̠ i sʰ ɯ k x ɯ ɾ iː m
비교급	p iː ɡ j o ɡ ɯ p̚
레이캬비크	ɾ e̞ i k ç j a̠ b i k x ɯ
만일	m a̠ː n i ɭ
까불다	k͈ a̠ b u ɭ d a̠
간모	k a̠ n m o̞
황해	ɸ w a̠ ŋ ɦ e̞
나르다	n a̠ ɾ ɯ d a̠
분야	p u ɲ j a̠
히라가나	ç i ɾ a̠ ɡ a̠ n a̠
화신	ɸ w a̠ː ɕʰ i n
초밥	t͡ɕʰ o̞ b a̠ p̚
마찬가지	m a̠ t͡ɕʰ a̠ n ɡ a̠ d͡ʑ i
침몰	t͡ɕʰ i m m o̞ ɭ
출생	t͡ɕʰ u ɭ s͈ e̞ ŋ
비파나무	p i pʰ a̠ n a̠ m u
승강기	sʰ ɯ ŋ ɡ a̠ ŋ ɡ i
세미나	sʰ e̞ m i n a̠
사진빨	sʰ a̠ d͡ʑ i n p͈ a̠ ɭ
페인트	pʰ e̞ i n tʰ ɯ
활시위	ɸ w a̠ ɭ ɕ͈ i ɥ i
언급하다	ʌ̹ n ɡ ɯ pʰ a̠ d a̠
쫄면	t͡ɕ͈ o̞ ɭ m j ʌ̹ n
가락	k a̠ ɾ a̠ k̚
똥침	t͈ o̞ ŋ t͡ɕʰ i m
외면하다	w e̞ː m j ʌ̹ n ɦ a̠ d a̠
재판권	t͡ɕ e̞ pʰ a̠ n k͈ w ʌ̹ n
현찰	ç j ɘː n t͡ɕʰ a̠ ɭ
전략가	t͡ɕ ɘː ɭ ʎ j a̠ k̚ k͈ a̠
부러움	p u ɾ ʌ̹ u m
숨통	sʰ u m tʰ o̞ ŋ
맥아	m e̞ ɡ a̠
쓰레기	s͈ ɯ ɾ e̞ ɡ i
눈다랑어	n u n d a̠ ɾ a̠ ŋ ʌ̹
않다	a̠ n tʰ a̠
주정뱅이	t͡ɕ uː d͡ʑ ʌ̹ ŋ b e̞ ŋ i
총명하다	t͡ɕʰ o̞ ŋ m j ʌ̹ ŋ ɦ a̠ d a̠
멋없다	m ʌ̹ d ʌ̹ p̚ t͈ a̠
적극	t͡ɕ ʌ̹ k̚ k͈ ɯ k̚
악한	a̠ kʰ a̠ n
담보물	t a̠ m b o̞ m u ɭ
라디에이터	ɾ a̠ d i e̞ i tʰ ʌ̹
현명하다	ç j ʌ̹ n m j ʌ̹ ŋ ɦ a̠ d a̠
마음대로	m a̠ ɯ m d e̞ ɾ o̞
어디	ʌ̹ d i
쩍다	t͡ɕ͈ ʌ̹ k̚ t͈ a̠
이번	i b ʌ̹ n
고려하다	k o̞ ɾ j ʌ̹ ɦ a̠ d a̠
소리	sʰ o̞ ɾ i
능격	n ɯ ŋ ɡ j ʌ̹ k̚
말거머리	m a̠ ɭ ɡ ʌ̹ m ʌ̹ ɾ i
누다	n u d a̠
비중	p iː d͡ʑ u ŋ
용액	j o ŋ e̞ k̚
스킨십	sʰ ɯ k ç i n ɕʰ i p̚
스와질란드	sʰ ɯ w a̠ d͡ʑ i ɭ ɭ a̠ n d ɯ
반도체	p a̠ n d o̞ t͡ɕʰ e̞
직할시	t͡ɕ i kʰ a̠ ɭ ɕʰ i
다하다	t a̠ː ɦ a̠ d a̠
북아메리카	p u ɡ a̠ m e̞ ɾ i kʰ a̠
유역	j u j ʌ̹ k̚
허영심	h ʌ̹ j ʌ̹ ŋ ɕʰ i m
유인원	j uː i n w ʌ̹ n
올라오다	o̞ ɭ ɭ a̠ o̞ d a̠
질문하다	t͡ɕ i ɭ m u n ɦ a̠ d a̠
주키니	t͡ɕ u k ç i n i
버튼	p ʌ̹ tʰ ɯ n
내려다보다	n e̞ ɾ j ʌ̹ d a̠ b o̞ d a̠
필요성	pʰ i ɾ j o s͈ ʌ̹ ŋ
일행	i ɾ ɦ e̞ ŋ
평정	pʰ j ʌ̹ ŋ d͡ʑ ʌ̹ ŋ
숨지다	sʰ uː m d͡ʑ i d a̠
볶이	p o̞ k͈ i
올라가다	o̞ ɭ ɭ a̠ ɡ a̠ d a̠
쐐기	s͈ w e̞ː ɡ i
충심	t͡ɕʰ u ŋ ɕʰ i m
일상생활	i ɭ s͈ a̠ ŋ sʰ e̞ ŋ β w a̠ ɭ
호실	ɸʷ o̞ː ɕʰ i ɭ
까닭	k͈ a̠ d a̠ k̚
미확인비행물체	m i β w a̠ ɡ i n b i ɦ e̞ ŋ m u ɭ t͡ɕʰ e̞
떠올리다	t͈ ʌ̹ o̞ ɭ ʎ i d a̠
사용되다	sʰ a̠ː j o ŋ d w e̞ d a̠
취미	t͡ɕʰ ɥ iː m i
상대방	sʰ a̠ ŋ d e̞ b a̠ ŋ
큰말똥가리	k x ɯ n m a̠ ɭ t͈ o̞ ŋ ɡ a̠ ɾ i
스카프	sʰ ɯ kʰ a̠ pʰ ɯ
두상	t u sʰ a̠ ŋ
마르코	m a̠ ɾ ɯ kʰ o̞
있다	i t̚ t͈ a̠
자제	t͡ɕ a̠ d͡ʑ e̞
할머니	h a̠ ɭ m ʌ̹ n i
주어지다	t͡ɕ u ʌ̹ d͡ʑ i d a̠
평양	pʰ j ʌ̹ ŋ j a̠ ŋ
북방흰뺨오리	p u k̚ p͈ a̠ ŋ ʝ i n p͈ j a̠ m o̞ ɾ i
참을성	t͡ɕʰ a̠ m ɯ ɭ sʰ ʌ̹ ŋ
토르	tʰ o̞ ɾ ɯ
집들이	t͡ɕ i p̚ t͈ ɯ ɾ i
항체	h a̠ ŋ t͡ɕʰ e̞
어젯밤	ʌ̹ d͡ʑ e̞ t̚ p͈ a̠ m
마니	m a̠ n i
승무원	sʰ ɯ ŋ m u w ʌ̹ n
골격	k o̞ ɭ ɡ j ʌ̹ k̚
스트레이트	sʰ ɯ tʰ ɯ ɾ e̞ i tʰ ɯ
마름모	m a̠ ɾ ɯ m m o̞
공통점	k o̞ː ŋ tʰ o̞ ŋ t͡ɕ͈ ʌ̹ m
이동	i d o̞ ŋ
관음	k w a̠ n ɯ m
경기장	k j ɘː ŋ ɡ i d͡ʑ a̠ ŋ
이벤트	i b e̞ n tʰ ɯ
부대	p u d e̞
슬로벤스꼬	sʰ ɯ ɭ ɭ o̞ b e̞ n sʰ ɯ k͈ o̞
일반	i ɭ b a̠ n
보일러	p o̞ i ɭ ɭ ʌ̹
남성	n a̠ m sʰ ʌ̹ ŋ
연대	j ʌ̹ n d e̞
분주하다	p u n d͡ʑ u ɦ a̠ d a̠
짝짓기	t͡ɕ͈ a̠ k̚ t͡ɕ͈ i t̚ k͈ i
뿌리다	p͈ u ɾ i d a̠
가브리엘	k a̠ b ɯ ɾ i e̞ ɭ
키갈리	k ç i ɡ a̠ ɭ ʎ i
비행기록장치	p i ɦ e̞ ŋ ɡ i ɾ o̞ k̚ t͡ɕ͈ a̠ ŋ t͡ɕʰ i
사람	sʰ a̠ː ɾ a̠ m
헤엄치다	h e̞ ʌ̹ m t͡ɕʰ i d a̠
수원청개구리	sʰ u w ʌ̹ n t͡ɕʰ ʌ̹ ŋ ɡ e̞ ɡ u ɾ i
만화가	m a̠ n β w a̠ ɡ a̠
사루기	sʰ a̠ ɾ u ɡ i
파리하다	pʰ a̠ ɾ i ɦ a̠ d a̠
오믈렛	o̞ m ɯ ɭ ɭ e̞ t̚
사망하다	sʰ a̠ m a̠ ŋ ɦ a̠ d a̠
한쪽	h a̠ n t͡ɕ͈ o̞ k̚
청첩장	t͡ɕʰ ɘː ŋ t͡ɕʰ ʌ̹ p̚ t͡ɕ͈ a̠ ŋ
콘셉트	kʰ o̞ n sʰ e̞ p̚ tʰ ɯ
유익하다	j u i kʰ a̠ d a̠
마다	m a̠ d a̠
농민	n o̞ ŋ m i n
엮다	j ʌ̹ k̚ t͈ a̠
엉엉	ʌ̹ ŋ ʌ̹ ŋ
경옥	k j ʌ̹ ŋ o̞ k̚
물오리	m u ɾ o̞ ɾ i
학사	h a̠ k s͈ a̠
산술	sʰ a̠ː n sʰ u ɭ
답하다	t a̠ pʰ a̠ d a̠
밝을녘	p a̠ ɭ ɡ ɯ ɭ ʎ j ʌ̹ k̚
의례	ɰ i ɾ j e̞
마지막	m a̠ d͡ʑ i m a̠ k̚
합법화	h a̠ p̚ p͈ ʌ̹ pʰ w a̠
생쥐	sʰ e̞ː ŋ d͡ʑ ɥ i
신고	ɕʰ i n ɡ o̞
꽁치	k͈ o̞ ŋ t͡ɕʰ i
옥토	o̞ k̚ tʰ o̞
찾아내다	t͡ɕʰ a̠ d͡ʑ a̠ n e̞ d a̠
표제	pʰ j o d͡ʑ e̞
수영복	sʰ u j ʌ̹ ŋ b o̞ k̚
남작	n a̠ m d͡ʑ a̠ k̚
지출	t͡ɕ i t͡ɕʰ u ɭ
추위	t͡ɕʰ u ɥ i
폭우	pʰ o̞ ɡ u
리그	ɾ i ɡ ɯ
단백질	t a̠ː n b e̞ k̚ t͡ɕ͈ i ɭ
괄호	k w a̠ ɾ β o̞
고투	k o̞ː tʰ u
국민	k u ŋ m i n
빨아먹다	p͈ a̠ ɾ a̠ m ʌ̹ k̚ t͈ a̠
스포츠	sʰ ɯ pʰ o̞ t͡ɕʰ ɯ
판매	pʰ a̠ n m e̞
근면하다	k ɯː n m j ʌ̹ n ɦ a̠ d a̠
브리지타운	p ɯ ɾ i d͡ʑ i tʰ a̠ u n
다락같다	t a̠ ɾ a̠ k̚ k͈ a̠ t̚ t͈ a̠
흑기러기	x ɯ k̚ k͈ i ɾ ʌ̹ ɡ i
동남	t o̞ ŋ n a̠ m
요리사	j o ɾ i sʰ a̠
불상놈	p uː ɭ sʰ a̠ ŋ n o̞ m
양서류	j a̠ː ŋ sʰ ʌ̹ ɾ j u
물음	m u ɾ ɯ m
산책하다	sʰ a̠ː n t͡ɕʰ e̞ kʰ a̠ d a̠
판판하다	pʰ a̠ n pʰ a̠ n ɦ a̠ d a̠
확대경	ɸ w a̠ k̚ t͈ e̞ ɡ j ʌ̹ ŋ
감다	k a̠ m t͈ a̠
서하	sʰ ʌ̹ ɦ a̠
중요	t͡ɕ uː ŋ j o
대신하다	t e̞ː ɕʰ i n ɦ a̠ d a̠
토요일	tʰ o̞ j o i ɭ
큰덤불해오라기	k x ɯ n d ʌ̹ m b u ɾ ɦ e̞ o̞ ɾ a̠ ɡ i
은하수	ɯ n ɦ a̠ sʰ u
연필	j ʌ̹ n pʰ i ɭ
평화	pʰ j ʌ̹ ŋ β w a̠
예산	j e̞ː sʰ a̠ n
맨날	m e̞ː n n a̠ ɭ
뒹굴뒹굴	t ɥ i ŋ ɡ u ɭ d ɥ i ŋ ɡ u ɭ
세계	sʰ e̞ː ɡ j e̞
오렌지색	o̞ ɾ e̞ n d͡ʑ i sʰ e̞ k̚
다가가다	t a̠ ɡ a̠ ɡ a̠ d a̠
카드	kʰ a̠ d ɯ
애완동물	e̞ː w a̠ n d o̞ ŋ m u ɭ
언제나	ɘː n d͡ʑ e̞ n a̠
먹이	m ʌ̹ ɡ i
길이	k i ɾ i
맬웨어	m e̞ ɾ w e̞ ʌ̹
다이오드	t a̠ i o̞ d ɯ
바치다	p a̠ t͡ɕʰ i d a̠
로키	ɾ o̞ k ç i
아이디어	a̠ i d i ʌ̹
문의	m uː n ɰ i
다물다	t a̠ m u ɭ d a̠
우르두어	u ɾ ɯ d u ʌ̹
가관	k a̠ː ɡ w a̠ n
가꾸다	k a̠ k͈ u d a̠
정치판	t͡ɕ ʌ̹ ŋ t͡ɕʰ i pʰ a̠ n
통솔자	tʰ o̞ ŋ sʰ o̞ ɭ d͡ʑ a̠
사위	sʰ a̠ ɥ i
튀니지	tʰ ɥ i n i d͡ʑ i
브루나이	p ɯ ɾ u n a̠ i
복수전	p o̞ k s͈ u d͡ʑ ʌ̹ n
가두다	k a̠ d u d a̠
공알	k o̞ː ŋ a̠ ɭ
인국	i n ɡ u k̚
입쌀	i p s͈ a̠ ɭ
미누스	m i n u sʰ ɯ
빠리	p͈ a̠ ɾ i
사울	sʰ a̠ u ɭ
삐침	p͈ i t͡ɕʰ i m
쳐다보다	t͡ɕʰ j ɘː d a̠ b o̞ d a̠
재기하다	t͡ɕ e̞ ɡ i ɦ a̠ d a̠
프로	pʰ ɯ ɾ o̞
연구자	j ɘː n ɡ u d͡ʑ a̠
맵다	m e̞ p̚ t͈ a̠
구조	k u d͡ʑ o̞
의견란	ɰ iː ɡ j ʌ̹ n n a̠ n
헤드폰	h e̞ d ɯ pʰ o̞ n
지갑	t͡ɕ i ɡ a̠ p̚
해당하다	h e̞ d a̠ ŋ ɦ a̠ d a̠
해중	h e̞ː d͡ʑ u ŋ
돌아다니다	t o̞ ɾ a̠ d a̠ n i d a̠
늘리다	n ɯ ɭ ʎ i d a̠
일어나라	i ɾ ʌ̹ n a̠ ɾ a̠
감독	k a̠ m d o̞ k̚
곤란	k o̞ː ɭ ɭ a̠ n
빠르다	p͈ a̠ ɾ ɯ d a̠
재판	t͡ɕ e̞ pʰ a̠ n
리듬	ɾ i d ɯ m
화평	ɸ w a̠ pʰ j ʌ̹ ŋ
편안하다	pʰ j ʌ̹ n a̠ n ɦ a̠ d a̠
물려받다	m u ɭ ʎ j ʌ̹ b a̠ t̚ t͈ a̠
끝내다	k͈ ɯ n n e̞ d a̠
억류자	ʌ̹ ŋ ɲ j u d͡ʑ a̠
오랜만	o̞ ɾ e̞ n m a̠ n
수원	sʰ u w ʌ̹ n
가히	k a̠ː ʝ i
귀찮다	k ɥ i t͡ɕʰ a̠ n tʰ a̠
정글	t͡ɕ ʌ̹ ŋ ɡ ɯ ɭ
오롯하다	o̞ ɾ o̞ tʰ a̠ d a̠
대양	t e̞ j a̠ ŋ
고통	k o̞ tʰ o̞ ŋ
산보	sʰ a̠ n b o̞
해석	h e̞ː sʰ ʌ̹ k̚
파파야	pʰ a̠ pʰ a̠ j a̠
모색하다	m o̞ sʰ e̞ kʰ a̠ d a̠
손가락질	sʰ o̞ n ɡ a̠ ɾ a̠ k̚ t͡ɕ͈ i ɭ
노른자위	n o̞ ɾ ɯ n d͡ʑ a̠ ɥ i
유쾌하다	j u kʰ w e̞ ɦ a̠ d a̠
띠앗	t͈ i a̠ t̚
두서너	t u sʰ ʌ̹ n ʌ̹
이기적	iː ɡ i d͡ʑ ʌ̹ k̚
보츠와나	p o̞ t͡ɕʰ ɯ w a̠ n a̠
라트비아	ɾ a̠ tʰ ɯ b i a̠
평소	pʰ j ʌ̹ ŋ sʰ o̞
문천	m u n t͡ɕʰ ʌ̹ n
백제	p e̞ k̚ t͡ɕ͈ e̞
담당하다	t a̠ m d a̠ ŋ ɦ a̠ d a̠
포름알데히드	pʰ o̞ ɾ ɯ m a̠ ɭ d e̞ ʝ i d ɯ
수학자	sʰ u ɦ a̠ k̚ t͡ɕ͈ a̠
마을	m a̠ ɯ ɭ
안티오키아	a̠ n tʰ i o̞ k ç i a̠
수입	sʰ u i p̚
모으다	m o̞ ɯ d a̠
통일	tʰ o̞ː ŋ i ɭ
신장위	ɕʰ i n d͡ʑ a̠ ŋ ɥ i
발가벗다	p a̠ ɭ ɡ a̠ b ʌ̹ t̚ t͈ a̠
초록색	t͡ɕʰ o̞ ɾ o̞ k s͈ e̞ k̚
드라이브하다	t ɯ ɾ a̠ i b ɯ ɦ a̠ d a̠
외국어	w e̞ː ɡ u ɡ ʌ̹
향상	ç j a̠ː ŋ sʰ a̠ ŋ
수하물	sʰ u ɦ a̠ m u ɭ
아줌마	a̠ d͡ʑ u m m a̠
선수	sʰ ɘː n sʰ u
분단	p u n d a̠ n
옛날	j e̞ː n n a̠ ɭ
외접원	w e̞ː d͡ʑ ʌ̹ b w ʌ̹ n
수집하다	sʰ u d͡ʑ i pʰ a̠ d a̠
날뛰다	n a̠ ɭ t͈ ɥ i d a̠
샤발	ɕʰ j a̠ b a̠ ɭ
오등	o̞ː d ɯ ŋ
객차	k e̞ k̚ t͡ɕʰ a̠
애굽	e̞ ɡ u p̚
리투아니아어	ɾ i tʰ u a̠ n i a̠ ʌ̹
붉히다	p u ɭ k ç i d a̠
버리다	p ʌ̹ ɾ i d a̠
음경	ɯ m ɡ j ʌ̹ ŋ
남만	n a̠ m m a̠ n
시조조	ɕʰ iː d͡ʑ o̞ d͡ʑ o̞
프롤레타리아	pʰ ɯ ɾ o̞ ɭ ɭ e̞ tʰ a̠ ɾ i a̠
방면	p a̠ ŋ m j ʌ̹ n
한정사	h a̠ n d͡ʑ ʌ̹ ŋ sʰ a̠
말살하다	m a̠ ɭ s͈ a̠ ɾ ɦ a̠ d a̠
젊음	t͡ɕ ɘː ɭ m ɯ m
세탁기	sʰ e̞ː tʰ a̠ k̚ k͈ i
아포스트로피	a̠ pʰ o̞ sʰ ɯ tʰ ɯ ɾ o̞ pʰ i
룰렛	ɾ u ɭ ɭ e̞ t̚
음순	ɯ m sʰ u n
우승	u sʰ ɯ ŋ
희한하다	ç i ɦ a̠ n ɦ a̠ d a̠
계시다	k j e̞ː ɕʰ i d a̠
퓨란	pʰ j u ɾ a̠ n
게이샤	k e̞ i ɕʰ j a̠
한식집	h a̠ n ɕ͈ i k̚ t͡ɕ͈ i p̚
인돌	i n d o̞ ɭ
풀오버	pʰ u ɾ o̞ b ʌ̹
북마크	p u ŋ m a̠ k x ɯ
짭짤하다	t͡ɕ͈ a̠ p̚ t͡ɕ͈ a̠ ɾ ɦ a̠ d a̠
돌마자	t o̞ ɭ m a̠ d͡ʑ a̠
담배	t a̠ː m b e̞
그물	k ɯ m u ɭ
아이쇼핑	a̠ i ɕ͈ j o pʰ i ŋ
샌드위치	sʰ e̞ n d ɯ ɥ i t͡ɕʰ i
무당개구리	m uː d a̠ ŋ ɡ e̞ ɡ u ɾ i
밥집	p a̠ p̚ t͡ɕ͈ i p̚
예쁘다	j e̞ː p͈ ɯ d a̠
해외구매	h e̞ w e̞ ɡ u m e̞
회음	ɸ w e̞ː ɯ m
확인	ɸ w a̠ ɡ i n
꼬리	k͈ o̞ ɾ i
경상북도	k j ɘː ŋ sʰ a̠ ŋ b u k̚ t͈ o̞
바람	p a̠ ɾ a̠ m
뿌리	p͈ u ɾ i
방문객	p a̠ː ŋ m u n ɡ e̞ k̚
미성숙하다	m iː sʰ ʌ̹ ŋ sʰ u kʰ a̠ d a̠
재단사	t͡ɕ e̞ d a̠ n sʰ a̠
색정	sʰ e̞ k̚ t͡ɕ͈ ʌ̹ ŋ
따라오다	t͈ a̠ ɾ a̠ o̞ d a̠
발표	p a̠ ɭ pʰ j o
이체자	i t͡ɕʰ e̞ d͡ʑ a̠
깁스	k i p s͈ ɯ
울다	uː ɭ d a̠
작년	t͡ɕ a̠ ŋ ɲ j ʌ̹ n
지나다	t͡ɕ i n a̠ d a̠
헹구다	h e̞ ŋ ɡ u d a̠
친우	t͡ɕʰ i n u
요구	j o ɡ u
바리	p a̠ ɾ i
우화	uː β w a̠
흡인력	x ɯ b i ɭ ʎ j ʌ̹ k̚
표식	pʰ j o ɕʰ i k̚
엽서	j ʌ̹ p s͈ ʌ̹
제작하다	t͡ɕ e̞ː d͡ʑ a̠ kʰ a̠ d a̠
그곳	k ɯ ɡ o̞ t̚
가공	k a̠ ɡ o̞ ŋ
튼튼하다	tʰ ɯ n tʰ ɯ n ɦ a̠ d a̠
옴개구리	o̞ m ɡ e̞ ɡ u ɾ i
킹스타운	k ç i ŋ sʰ ɯ tʰ a̠ u n
동글다	t o̞ ŋ ɡ ɯ ɭ d a̠
업다	ʌ̹ p̚ t͈ a̠
벨모판	p e̞ ɭ m o̞ pʰ a̠ n
불가지론	p u ɭ ɡ a̠ d͡ʑ i ɾ o̞ n
가방	k a̠ b a̠ ŋ
잉크	i ŋ k x ɯ
벽장	p j ʌ̹ k̚ t͡ɕ͈ a̠ ŋ
피다	pʰ i d a̠
다짐	t a̠ d͡ʑ i m
해자	h e̞ d͡ʑ a̠
손주	sʰ o̞ n d͡ʑ u
포트오브스페인	pʰ o̞ tʰ ɯ o̞ b ɯ sʰ ɯ pʰ e̞ i n
붉은뺨가마우지	p u ɭ ɡ ɯ n p͈ j a̠ m ɡ a̠ m a̠ u d͡ʑ i
재벌	t͡ɕ e̞ b ʌ̹ ɭ
귓구멍	k ɥ i t̚ k͈ u m ʌ̹ ŋ
버전	p ʌ̹ d͡ʑ ʌ̹ n
입덧	i p̚ t͈ ʌ̹ t̚
우동	u d o̞ ŋ
자동차	t͡ɕ a̠ d o̞ ŋ t͡ɕʰ a̠
술병	sʰ u ɭ b j ʌ̹ ŋ
붙다	p u t̚ t͈ a̠
수정란	sʰ u d͡ʑ ʌ̹ ŋ n a̠ n
증진하다	t͡ɕ ɯ ŋ d͡ʑ i n ɦ a̠ d a̠
지난밤	t͡ɕ i n a̠ n b a̠ m
놀이	n o̞ ɾ i
화사	ɸ w a̠ sʰ a̠
방향족	p a̠ ŋ ʝ j a̠ ŋ d͡ʑ o̞ k̚
노아	n o̞ a̠
씌우다	ɕ͈ i u d a̠
비우다	p i u d a̠
베프	p e̞ pʰ ɯ
얼룩	ʌ̹ ɭ ɭ u k̚
안도라	a̠ n d o̞ ɾ a̠
중세	t͡ɕ u ŋ sʰ e̞
변화하다	p j ɘː n β w a̠ ɦ a̠ d a̠
당연	t a̠ ŋ j ʌ̹ n
어렴풋이	ʌ̹ ɾ j ʌ̹ m pʰ u ɕʰ i
브라키오사우루스	p ɯ ɾ a̠ k ç i o̞ sʰ a̠ u ɾ u sʰ ɯ
돌리다	t o̞ ɭ ʎ i d a̠
프로그래머	pʰ ɯ ɾ o̞ ɡ ɯ ɾ e̞ m ʌ̹
안마	a̠ː n m a̠
고기겹빵	k o̞ ɡ i ɡ j ʌ̹ p̚ p͈ a̠ ŋ
말라빠지다	m a̠ ɭ ɭ a̠ p͈ a̠ d͡ʑ i d a̠
노래하다	n o̞ ɾ e̞ ɦ a̠ d a̠
부정사	p u d͡ʑ ʌ̹ ŋ sʰ a̠
팩스	pʰ e̞ k s͈ ɯ
동정	t o̞ ŋ d͡ʑ ʌ̹ ŋ
금발	k ɯ m b a̠ ɭ
일종	i ɭ t͡ɕ͈ o̞ ŋ
잃다	i ɭ tʰ a̠
알레고리	a̠ ɭ ɭ e̞ ɡ o̞ ɾ i
가람	k a̠ ɾ a̠ m
양파	j a̠ ŋ pʰ a̠
회백질	ɸ w e̞ b e̞ k̚ t͡ɕ͈ i ɭ
열등감	j ʌ̹ ɭ t͈ ɯ ŋ ɡ a̠ m
검찰	k ɘː m t͡ɕʰ a̠ ɭ
유학생	j u ɦ a̠ k s͈ e̞ ŋ
법관	p ʌ̹ p̚ k͈ w a̠ n
흑룡강	x ɯ ŋ ɲ j o ŋ ɡ a̠ ŋ
등장인물	t ɯ ŋ d͡ʑ a̠ ŋ i n m u ɭ
마유	m a̠ː j u
단천	t a̠ n t͡ɕʰ ʌ̹ n
흥행장	x ɯ ŋ ɦ e̞ ŋ d͡ʑ a̠ ŋ
아직	a̠ d͡ʑ i k̚
거짓말쟁이	k ɘː d͡ʑ i n m a̠ ɭ d͡ʑ e̞ ŋ i
검은금	k ʌ̹ m ɯ n ɡ ɯ m
수업	sʰ u ʌ̹ p̚
마마	m a̠ː m a̠
카트만두	kʰ a̠ tʰ ɯ m a̠ n d u
제기차기	t͡ɕ e̞ ɡ i t͡ɕʰ a̠ ɡ i
토고	tʰ o̞ ɡ o̞
송이	sʰ o̞ ŋ i
거위	k ʌ̹ ɥ i
물가	m u ɭ k͈ a̠
동경	t o̞ ŋ ɡ j ʌ̹ ŋ
현대	ç j ʌ̹ n d e̞
밸런타인데이	p e̞ ɭ ɭ ʌ̹ n tʰ a̠ i n d e̞ i
곡식	k o̞ k ɕ͈ i k̚
면역	m j ɘː ɲ j ʌ̹ k̚
칼납자루	kʰ a̠ ɭ ɭ a̠ p̚ t͡ɕ͈ a̠ ɾ u
어르다	ɘː ɾ ɯ d a̠
이성애	iː sʰ ʌ̹ ŋ e̞
가만히	k a̠ m a̠ n ʝ i
일컬리다	i ɭ kʰ ʌ̹ ɭ ʎ i d a̠
잘못하다	t͡ɕ a̠ ɭ m o̞ tʰ a̠ d a̠
아낙	a̠ n a̠ k̚
불교	p u ɭ ɡ j o
페르시아어	pʰ e̞ ɾ ɯ ɕʰ i a̠ ʌ̹
쾌락	kʰ w e̞ ɾ a̠ k̚
풋사과	pʰ u t̚ s͈ a̠ ɡ w a̠
모호하다	m o̞ β o̞ ɦ a̠ d a̠
도안	t o̞ a̠ n
기구	k i ɡ u
사이	sʰ a̠ i
외롭다	w e̞ ɾ o̞ p̚ t͈ a̠
반도	p a̠ n d o̞
파동	pʰ a̠ d o̞ ŋ
말없이	m a̠ː ɾ ʌ̹ p ɕ͈ i
아일랜드어	a̠ i ɭ ɭ e̞ n d ɯ ʌ̹
퀴놀린	kʰ ɥ i n o̞ ɭ ʎ i n
가젤	k a̠ d͡ʑ e̞ ɭ
범죄자	p ɘː m d͡ʑ w e̞ d͡ʑ a̠
합창	h a̠ p̚ t͡ɕʰ a̠ ŋ
쌈장	s͈ a̠ m d͡ʑ a̠ ŋ
치와와	t͡ɕʰ i w a̠ w a̠
햇볕	h e̞ t̚ p͈ j ʌ̹ t̚
러시아어	ɾ ʌ̹ ɕʰ i a̠ ʌ̹
질환	t͡ɕ i ɾ β w a̠ n
끌어안다	k͈ ɯː ɾ ʌ̹ a̠ n t͈ a̠
정은	t͡ɕ ɘː ŋ ɯ n
말씀하다	m a̠ː ɭ s͈ ɯ m ɦ a̠ d a̠
프로파길	pʰ ɯ ɾ o̞ pʰ a̠ ɡ i ɭ
전부	t͡ɕ ʌ̹ n b u
성어	sʰ ʌ̹ ŋ ʌ̹
소문	sʰ o̞ː m u n
쇼츠	ɕʰ j o t͡ɕʰ ɯ
노끈	n o̞ k͈ ɯ n
북돋다	p u k̚ t͈ o̞ t̚ t͈ a̠
영향력	j ɘː ŋ ʝ j a̠ ŋ ɲ j ʌ̹ k̚
전치사	t͡ɕ ʌ̹ n t͡ɕʰ i sʰ a̠
출구	t͡ɕʰ u ɭ ɡ u
출처	t͡ɕʰ u ɭ t͡ɕʰ ʌ̹
달필	t a̠ ɭ pʰ i ɭ
처리	t͡ɕʰ ɘː ɾ i
김치	k i m t͡ɕʰ i
법령	p ʌ̹ m ɲ j ʌ̹ ŋ
미안	m i a̠ n
지복직관	t͡ɕ iː b o̞ k̚ t͡ɕ͈ i k̚ k͈ w a̠ n
플래티나	pʰ ɯ ɭ ɭ e̞ tʰ i n a̠
약학	j a̠ kʰ a̠ k̚
때때로	t͈ e̞ t͈ e̞ ɾ o̞
명관	m j ʌ̹ ŋ ɡ w a̠ n
회계학	ɸ w e̞ː ɡ j e̞ ɦ a̠ k̚
부레	p u ɾ e̞
꿀벅지	k͈ u ɭ b ʌ̹ k̚ t͡ɕ͈ i
씹다	ɕ͈ i p̚ t͈ a̠
출근	t͡ɕʰ u ɭ ɡ ɯ n
부이온	p u i o̞ n
갈아입다	k a̠ ɾ a̠ i p̚ t͈ a̠
계시	k j e̞ː ɕʰ i
다윗	t a̠ ɥ i t̚
병따개	p j ʌ̹ ŋ t͈ a̠ ɡ e̞
겨자	k j ʌ̹ d͡ʑ a̠
다름없다	t a̠ ɾ ɯ m ʌ̹ p̚ t͈ a̠
마노	m a̠ n o̞
조그맣다	t͡ɕ o̞ ɡ ɯ m a̠ tʰ a̠
세미콜론	sʰ e̞ m i kʰ o̞ ɭ ɭ o̞ n
초딩	t͡ɕʰ o̞ d i ŋ
이렇게	i ɾ ʌ̹ kʰ e̞
왜놈	w e̞ n o̞ m
모스크	m o̞ sʰ ɯ k x ɯ
디엔에이	t i e̞ n e̞ i
국회의원	k u kʰ w e̞ ɰ i w ʌ̹ n
방석집	p a̠ ŋ sʰ ʌ̹ k̚ t͡ɕ͈ i p̚
투자	tʰ u d͡ʑ a̠
투숙	tʰ u sʰ u k̚
손가방	sʰ o̞ n ɡ a̠ b a̠ ŋ
분광기	p u n ɡ w a̠ ŋ ɡ i
업무	ʌ̹ m m u
유가	j u ɡ a̠
혹고니	ɸʷ o̞ k̚ k͈ o̞ n i
반역	p a̠ː ɲ j ʌ̹ k̚
입대	i p̚ t͈ e̞
정크푸드	t͡ɕ ʌ̹ ŋ k x ɯ pʰ u d ɯ
자살하다	t͡ɕ a̠ sʰ a̠ ɾ ɦ a̠ d a̠
중요성	t͡ɕ uː ŋ j o sʰ ʌ̹ ŋ
가로등	k a̠ ɾ o̞ d ɯ ŋ
설거지하다	sʰ ʌ̹ ɭ ɡ ʌ̹ d͡ʑ i ɦ a̠ d a̠
본뜨다	p o̞ n t͈ ɯ d a̠
녹음실	n o̞ ɡ ɯ m ɕʰ i ɭ
잡담하다	t͡ɕ a̠ p̚ t͈ a̠ m ɦ a̠ d a̠
보드카	p o̞ d ɯ kʰ a̠
망막	m a̠ ŋ m a̠ k̚
팔뚝	pʰ a̠ ɭ t͈ u k̚
취향	t͡ɕʰ ɥ iː ʝ j a̠ ŋ
백혈구	p e̞ k ç j ʌ̹ ɭ ɡ u
모로코	m o̞ ɾ o̞ kʰ o̞
광물학	k w a̠ ŋ m u ɾ ɦ a̠ k̚
하남	h a̠ n a̠ m
미호종개	m i β o̞ d͡ʑ o̞ ŋ ɡ e̞
콧물	kʰ o̞ n m u ɭ
마이크로버스	m a̠ i k x ɯ ɾ o̞ b ʌ̹ sʰ ɯ
핀셋	pʰ i n sʰ e̞ t̚
방글라데시	p a̠ ŋ ɡ ɯ ɭ ɭ a̠ d e̞ ɕʰ i
감기다	k a̠ m ɡ i d a̠
부모님	p u m o̞ n i m
부활	p uː β w a̠ ɭ
토치	tʰ o̞ t͡ɕʰ i
주뼛주뼛	t͡ɕ u p͈ j ʌ̹ t̚ t͡ɕ͈ u p͈ j ʌ̹ t̚
주머니칼	t͡ɕ u m ʌ̹ n i kʰ a̠ ɭ
백포도주	p e̞ k̚ pʰ o̞ d o̞ d͡ʑ u
하프	h a̠ pʰ ɯ
아스하바트	a̠ sʰ ɯ ɦ a̠ b a̠ tʰ ɯ
십팔	ɕʰ i p̚ pʰ a̠ ɭ
엿보다	j ɘː t̚ p͈ o̞ d a̠
출발하다	t͡ɕʰ u ɭ b a̠ ɾ ɦ a̠ d a̠
전개	t͡ɕ ɘː n ɡ e̞
제설차	t͡ɕ e̞ sʰ ʌ̹ ɭ t͡ɕʰ a̠
무쿠리	m u kʰ u ɾ i
미혼모	m iː β o̞ n m o̞
진화	t͡ɕ i n β w a̠
일화	i ɾ β w a̠
연월일	j ʌ̹ n w ʌ̹ ɾ i ɭ
영상	j ʌ̹ ŋ sʰ a̠ ŋ
해물	h e̞ː m u ɭ
스트로	sʰ ɯ tʰ ɯ ɾ o̞
달력	t a̠ ɭ ʎ j ʌ̹ k̚
식사	ɕʰ i k s͈ a̠
광산	k w a̠ ŋ sʰ a̠ n
임자	iː m d͡ʑ a̠
뺑소니치다	p͈ e̞ ŋ sʰ o̞ n i t͡ɕʰ i d a̠
간주	k a̠ n d͡ʑ u
기울다	k i u ɭ d a̠
틀리다	tʰ ɯ ɭ ʎ i d a̠
주황색	t͡ɕ u β w a̠ ŋ sʰ e̞ k̚
매체	m e̞ t͡ɕʰ e̞
거지	k ɘː d͡ʑ i
삿포로	sʰ a̠ t̚ pʰ o̞ ɾ o̞
이모부	i m o̞ b u
학자	h a̠ k̚ t͡ɕ͈ a̠
거스름돈	k ʌ̹ sʰ ɯ ɾ ɯ m t͈ o̞ n
아그라	a̠ ɡ ɯ ɾ a̠
승합차	sʰ ɯ ŋ ɦ a̠ p̚ t͡ɕʰ a̠
또한	t͈ o̞ ɦ a̠ n
방송원	p a̠ ŋ sʰ o̞ ŋ w ʌ̹ n
선택	sʰ ɘː n tʰ e̞ k̚
감상	k a̠ m sʰ a̠ ŋ
남쪽	n a̠ m t͡ɕ͈ o̞ k̚
스펀지	sʰ ɯ pʰ ʌ̹ n d͡ʑ i
연적	j ɘː n d͡ʑ ʌ̹ k̚
설폰	sʰ ʌ̹ ɭ pʰ o̞ n
알라딘	a̠ ɭ ɭ a̠ d i n
아크라	a̠ k x ɯ ɾ a̠
팔리다	pʰ a̠ ɭ ʎ i d a̠
없다	ɘː p̚ t͈ a̠
라이벌	ɾ a̠ i b ʌ̹ ɭ
해남	h e̞ n a̠ m
왁찐	w a̠ k̚ t͡ɕ͈ i n
실뱅어	ɕʰ iː ɭ b e̞ ŋ ʌ̹
몽고	m o̞ ŋ ɡ o̞
군복	k u n b o̞ k̚
아테나	a̠ tʰ e̞ n a̠
플러스	pʰ ɯ ɭ ɭ ʌ̹ sʰ ɯ
갖다	k a̠ t̚ t͈ a̠
대변	t e̞ː b j ʌ̹ n
임부	iː m b u
한국인	h a̠ n ɡ u ɡ i n
멀쩡하다	m ʌ̹ ɭ t͡ɕ͈ ʌ̹ ŋ ɦ a̠ d a̠
회의	ɸ w e̞ː ɰ i
금지하다	k ɯː m d͡ʑ i ɦ a̠ d a̠
객쩍다	k e̞ k̚ t͡ɕ͈ ʌ̹ k̚ t͈ a̠
담요	t a̠ː m ɲ j o
오늘날	o̞ n ɯ ɭ ɭ a̠ ɭ
업동이	ʌ̹ p̚ t͈ o̞ ŋ i
쌍점	s͈ a̠ ŋ d͡ʑ ʌ̹ m
어머님	ʌ̹ m ʌ̹ n i m
왜꾹저구	w e̞ k͈ u k̚ t͡ɕ͈ ʌ̹ ɡ u
스케이트보드	sʰ ɯ kʰ e̞ i tʰ ɯ b o̞ d ɯ
입겿	i p̚ k͈ j ʌ̹ t̚
해돋이	h e̞ d o̞ d i
대두어	t e̞ː d u ʌ̹
강제	k a̠ː ŋ d͡ʑ e̞
항성	h a̠ ŋ sʰ ʌ̹ ŋ
갈색	k a̠ ɭ s͈ e̞ k̚
터키	tʰ ʌ̹ k ç i
합쇼체	h a̠ p ɕ͈ j o t͡ɕʰ e̞
그동안	k ɯ d o̞ ŋ a̠ n
물통	m u ɭ tʰ o̞ ŋ
현재시제	ç j ɘː n d͡ʑ e̞ ɕʰ i d͡ʑ e̞
콩자반	kʰ o̞ ŋ d͡ʑ a̠ b a̠ n
굴리다	k u ɭ ʎ i d a̠
트이다	tʰ ɯ i d a̠
아저씨	a̠ d͡ʑ ʌ̹ ɕ͈ i
보온병	p o̞ː o̞ n b j ʌ̹ ŋ
발달	p a̠ ɭ t͈ a̠ ɭ
지방족	t͡ɕ i b a̠ ŋ d͡ʑ o̞ k̚
가리다	k a̠ ɾ i d a̠
복섬	p o̞ k s͈ ʌ̹ m
가장자리	k a̠ː d͡ʑ a̠ ŋ d͡ʑ a̠ ɾ i
용대	j o ŋ d e̞
그리워하다	k ɯ ɾ i w ʌ̹ ɦ a̠ d a̠
던지다	t ʌ̹ n d͡ʑ i d a̠
합법화되다	h a̠ p̚ p͈ ʌ̹ pʰ w a̠ d w e̞ d a̠
이후	i β u
미합중국	m i ɦ a̠ p̚ t͡ɕ͈ u ŋ ɡ u k̚
복호	p o̞ kʰ o̞
키리바시	k ç i ɾ i b a̠ ɕʰ i
폐어	pʰ j e̞ː ʌ̹
사인하다	sʰ a̠ i n ɦ a̠ d a̠
포커	pʰ o̞ kʰ ʌ̹
여객기	j ʌ̹ ɡ e̞ k̚ k͈ i
디카	t i kʰ a̠
대작자	t e̞ː d͡ʑ a̠ k̚ t͡ɕ͈ a̠
글씨	k ɯ ɭ ɕ͈ i
토론토	tʰ o̞ ɾ o̞ n tʰ o̞
바듯하다	p a̠ d ɯ tʰ a̠ d a̠
전술	t͡ɕ ɘː n sʰ u ɭ
두개골	t u ɡ e̞ ɡ o̞ ɭ
기지	k i d͡ʑ i
담배갑	t a̠ː m b e̞ ɡ a̠ p̚
뜨겁다	t͈ ɯ ɡ ʌ̹ p̚ t͈ a̠
갸웃거리다	k j a̠ u t̚ k͈ ʌ̹ ɾ i d a̠
뚫리다	t͈ u ɭ ʎ i d a̠
재다	t͡ɕ e̞ː d a̠
전라도	t͡ɕ ʌ̹ ɭ ɭ a̠ d o̞
이빠이	i p͈ a̠ i
시간표	ɕʰ i ɡ a̠ n pʰ j o
성취	sʰ ʌ̹ ŋ t͡ɕʰ ɥ i
이념	iː ɲ j ʌ̹ m
똑바로	t͈ o̞ k̚ p͈ a̠ ɾ o̞
삼림	sʰ a̠ m n i m
미닫이문	m iː d a̠ d i m u n
터뜨리다	tʰ ɘː t͈ ɯ ɾ i d a̠
방귀	p a̠ː ŋ ɡ ɥ i
부정적	p uː d͡ʑ ʌ̹ ŋ d͡ʑ ʌ̹ k̚
책자	t͡ɕʰ e̞ː k̚ t͡ɕ͈ a̠
예멘	j e̞ m e̞ n
생강	sʰ e̞ ŋ ɡ a̠ ŋ
가져가다	k a̠ d͡ʑ j ʌ̹ ɡ a̠ d a̠
뢴트겐	ɾ w e̞ n tʰ ɯ ɡ e̞ n
디자인	t i d͡ʑ a̠ i n
농산물	n o̞ ŋ sʰ a̠ n m u ɭ
절대	t͡ɕ ʌ̹ ɭ t͈ e̞
검색	k ɘː m sʰ e̞ k̚
터지다	tʰ ɘː d͡ʑ i d a̠
고통스럽다	k o̞ tʰ o̞ ŋ sʰ ɯ ɾ ʌ̹ p̚ t͈ a̠
네바다	n e̞ b a̠ d a̠
프리토리아	pʰ ɯ ɾ i tʰ o̞ ɾ i a̠
가보로네	k a̠ b o̞ ɾ o̞ n e̞
명하다	m j ɘː ŋ ɦ a̠ d a̠
간악	k a̠ n a̠ k̚
두째	t u t͡ɕ͈ e̞
네덜란드어	n e̞ d ʌ̹ ɭ ɭ a̠ n d ɯ ʌ̹
상대	sʰ a̠ ŋ d e̞
효과	ç j oː k͈ w a̠
부에노스아이레스	p u e̞ n o̞ sʰ ɯ a̠ i ɾ e̞ sʰ ɯ
점점	t͡ɕ ɘː m d͡ʑ ʌ̹ m
무기고	m uː ɡ i ɡ o̞
암캐	a̠ m kʰ e̞
그러니까	k ɯ ɾ ʌ̹ n i k͈ a̠
페티시즘	pʰ e̞ tʰ i ɕʰ i d͡ʑ ɯ m
꼬마청황	k͈ o̞ m a̠ t͡ɕʰ ʌ̹ ŋ β w a̠ ŋ
요리	j o ɾ i
아부자	a̠ b u d͡ʑ a̠
흑로	x ɯ ŋ n o̞
니아메	n i a̠ m e̞
바위	p a̠ ɥ i
도하	t o̞ ɦ a̠
빼빼하다	p͈ e̞ p͈ e̞ ɦ a̠ d a̠
빼놓다	p͈ e̞ː n o̞ tʰ a̠
국한문	k u kʰ a̠ n m u n
클래스	k x ɯ ɭ ɭ e̞ sʰ ɯ
살구	sʰ a̠ ɭ ɡ u
빠이빠이	p͈ a̠ i p͈ a̠ i
신기하다	ɕʰ iː n ɡ i ɦ a̠ d a̠
오케스트라	o̞ kʰ e̞ sʰ ɯ tʰ ɯ ɾ a̠
잇몸	i n m o̞ m
디지털	t i d͡ʑ i tʰ ʌ̹ ɭ
무신론	m u ɕʰ i n n o̞ n
좌우명	t͡ɕ w a̠ː u m j ʌ̹ ŋ
뛰다	t͈ ɥ i d a̠
보고타	p o̞ ɡ o̞ tʰ a̠
태양초	tʰ e̞ j a̠ ŋ t͡ɕʰ o̞
고립지	k o̞ ɾ i p̚ t͡ɕ͈ i
상추	sʰ a̠ ŋ t͡ɕʰ u
저장	t͡ɕ ʌ̹ d͡ʑ a̠ ŋ
잃어버리다	i ɾ ʌ̹ b ʌ̹ ɾ i d a̠
받아들이다	p a̠ d a̠ d ɯ ɾ i d a̠
가득하다	k a̠ d ɯ kʰ a̠ d a̠
법학	p ʌ̹ pʰ a̠ k̚
육분의	j u k̚ p͈ u n ɰ i
매듭	m e̞ d ɯ p̚
대저택	t e̞ d͡ʑ ʌ̹ tʰ e̞ k̚
기역	k i j ʌ̹ k̚
북부	p u k̚ p͈ u
덕천	t ʌ̹ k̚ t͡ɕʰ ʌ̹ n
허베이	h ʌ̹ b e̞ i
공구	k o̞ ŋ ɡ u
부끄럽다	p u k͈ ɯ ɾ ʌ̹ p̚ t͈ a̠
장군	t͡ɕ a̠ ŋ ɡ u n
불굴	p u ɭ ɡ u ɭ
민화	m i n β w a̠
가설법	k a̠ː sʰ ʌ̹ ɭ p͈ ʌ̹ p̚
때로	t͈ e̞ ɾ o̞
민주	m i n d͡ʑ u
종어	t͡ɕ o̞ ŋ ʌ̹
연흔	j ʌ̹ n ɣ ɯ n
혹시	ɸʷ o̞ k ɕ͈ i
독물	t o̞ ŋ m u ɭ
나선형	n a̠ sʰ ʌ̹ n ʝ j ʌ̹ ŋ
새내기	sʰ e̞ n e̞ ɡ i
프라하	pʰ ɯ ɾ a̠ ɦ a̠
똑같다	t͈ o̞ k̚ k͈ a̠ t̚ t͈ a̠
공주	k o̞ ŋ d͡ʑ u
경력	k j ʌ̹ ŋ ɲ j ʌ̹ k̚
치통	t͡ɕʰ i tʰ o̞ ŋ
끄트러기	k͈ ɯ tʰ ɯ ɾ ʌ̹ ɡ i
교미하다	k j o m i ɦ a̠ d a̠
가시납지리	k a̠ ɕʰ i n a̠ p̚ t͡ɕ͈ i ɾ i
샴페인	ɕʰ j a̠ m pʰ e̞ i n
되게	t w e̞ː ɡ e̞
여기다	j ʌ̹ ɡ i d a̠
밀림	m i ɭ ʎ i m
타자기	tʰ a̠ d͡ʑ a̠ ɡ i
반주	p a̠ː n d͡ʑ u
장가	t͡ɕ a̠ː ŋ ɡ a̠
아미노	a̠ m i n o̞
사임	sʰ a̠ i m
후쿠시마	ɸʷ u kʰ u ɕʰ i m a̠
인중	i n d͡ʑ u ŋ
서명하다	sʰ ɘː m j ʌ̹ ŋ ɦ a̠ d a̠
사람들	sʰ a̠ ɾ a̠ m d ɯ ɭ
잠그다	t͡ɕ a̠ m ɡ ɯ d a̠
처지	t͡ɕʰ ɘː d͡ʑ i
배드민턴	p e̞ d ɯ m i n tʰ ʌ̹ n
텔펜	tʰ e̞ ɭ pʰ e̞ n
먼저	m ʌ̹ n d͡ʑ ʌ̹
부분	p u b u n
반치음	p a̠ː n t͡ɕʰ i ɯ m
윤회	j u n β w e̞
연준모치	j ʌ̹ n d͡ʑ u n m o̞ t͡ɕʰ i
성매매	sʰ ɘː ŋ m e̞ m e̞
대왕고래	t e̞ː w a̠ ŋ ɡ o̞ ɾ e̞
꾀꼬리	k͈ w e̞ k͈ o̞ ɾ i
집안	t͡ɕ i b a̠ n
완전하다	w a̠ n d͡ʑ ʌ̹ n ɦ a̠ d a̠
루마니아어	ɾ u m a̠ n i a̠ ʌ̹
창턱	t͡ɕʰ a̠ ŋ tʰ ʌ̹ k̚
적반하장	t͡ɕ ʌ̹ k̚ p͈ a̠ n ɦ a̠ d͡ʑ a̠ ŋ
딸꾹질	t͈ a̠ ɭ k͈ u k̚ t͡ɕ͈ i ɭ
재밌다	t͡ɕ e̞ m i t̚ t͈ a̠
십자고상	ɕʰ i p̚ t͡ɕ͈ a̠ ɡ o̞ sʰ a̠ ŋ
송두리째	sʰ o̞ ŋ d u ɾ i t͡ɕ͈ e̞
니제르	n i d͡ʑ e̞ ɾ ɯ
세탁소	sʰ e̞ː tʰ a̠ k s͈ o̞
고르다	k o̞ ɾ ɯ d a̠
고아원	k o̞ a̠ w ʌ̹ n
넵투늄	n e̞ p̚ tʰ u ɲ j u m
위기	ɥ i ɡ i
볼링	p o̞ ɭ ʎ i ŋ
엽록소	j ʌ̹ m n o̞ k s͈ o̞
방해하다	p a̠ ŋ ɦ e̞ ɦ a̠ d a̠
비행기표	p i ɦ e̞ ŋ ɡ i pʰ j o
유진	j u d͡ʑ i n
성체	sʰ ɘː ŋ t͡ɕʰ e̞
외과	w e̞ː k͈ w a̠
난수	n a̠ n sʰ u
민속	m i n sʰ o̞ k̚
가져오다	k a̠ d͡ʑ j ʌ̹ o̞ d a̠
새롭다	sʰ e̞ ɾ o̞ p̚ t͈ a̠
야식	j a̠ː ɕʰ i k̚
문턱	m u n tʰ ʌ̹ k̚
귀때기	k ɥ i t͈ e̞ ɡ i
누그러뜨리다	n u ɡ ɯ ɾ ʌ̹ t͈ ɯ ɾ i d a̠
리포트	ɾ i pʰ o̞ tʰ ɯ
수음	sʰ u ɯ m
덮개	t ʌ̹ p̚ k͈ e̞
허용하다	h ʌ̹ j o ŋ ɦ a̠ d a̠
랠리	ɾ e̞ ɭ ʎ i
은하	ɯ n ɦ a̠
추밀원	t͡ɕʰ u m i ɾ w ʌ̹ n
미르	m i ɾ ɯ
아프리카	a̠ pʰ ɯ ɾ i kʰ a̠
유괴	j u ɡ w e̞
영광	j ʌ̹ ŋ ɡ w a̠ ŋ
먹다	m ʌ̹ k̚ t͈ a̠
해변	h e̞ː b j ʌ̹ n
미안하다	m i a̠ n ɦ a̠ d a̠
모국어	m o̞ ɡ u ɡ ʌ̹
헛소리	h ʌ̹ t̚ s͈ o̞ ɾ i
웅변	u ŋ b j ʌ̹ n
끼다	k͈ i d a̠
엿기름	j ʌ̹ t̚ k͈ i ɾ ɯ m
건드리다	k ɘː n d ɯ ɾ i d a̠
느끼다	n ɯ k͈ i d a̠
강대국	k a̠ ŋ d e̞ ɡ u k̚
근처	k ɯː n t͡ɕʰ ʌ̹
하십시오체	h a̠ ɕʰ i p ɕ͈ i o̞ t͡ɕʰ e̞
속칭	sʰ o̞ k̚ t͡ɕʰ i ŋ
실제	ɕʰ i ɭ t͡ɕ͈ e̞
카란	kʰ a̠ ɾ a̠ n
플루트	pʰ ɯ ɭ ɭ u tʰ ɯ
쓰다듬다	s͈ ɯ d a̠ d ɯ m d a̠
대학원생	t e̞ ɦ a̠ ɡ w ʌ̹ n sʰ e̞ ŋ
목마르다	m o̞ ŋ m a̠ ɾ ɯ d a̠
우러러보다	u ɾ ʌ̹ ɾ ʌ̹ b o̞ d a̠
존나	t͡ɕ o̞ n n a̠
등산	t ɯ ŋ sʰ a̠ n
종양	t͡ɕ o̞ː ŋ j a̠ ŋ
제우스	t͡ɕ e̞ u sʰ ɯ
함께하다	h a̠ m k͈ e̞ ɦ a̠ d a̠
랍비	ɾ a̠ p̚ p͈ i
승하	sʰ ɯ ŋ ɦ a̠
교수대	k j o sʰ u d e̞
에잇	e̞ i t̚
우산	uː sʰ a̠ n
재규어	t͡ɕ e̞ ɡ j u ʌ̹
파고다	pʰ a̠ ɡ o̞ d a̠
미음	m i ɯ m
제품	t͡ɕ e̞ː pʰ u m
올바르다	o̞ ɭ b a̠ ɾ ɯ d a̠
카드뮴	kʰ a̠ d ɯ m j u m
떼다	t͈ e̞ː d a̠
신체	ɕʰ i n t͡ɕʰ e̞
용언	j oː ŋ ʌ̹ n
운동	uː n d o̞ ŋ
폭탄	pʰ o̞ k̚ tʰ a̠ n
대륙송사리	t e̞ː ɾ j u k s͈ o̞ ŋ sʰ a̠ ɾ i
누이	n u i
나프티리딘	n a̠ pʰ ɯ tʰ i ɾ i d i n
해방	h e̞ b a̠ ŋ
이산화탄소	iː sʰ a̠ n β w a̠ tʰ a̠ n sʰ o̞
어찌	ʌ̹ t͡ɕ͈ i
물어보다	m u ɾ ʌ̹ b o̞ d a̠
미래	m iː ɾ e̞
패스워드	pʰ e̞ sʰ ɯ w ʌ̹ d ɯ
매국노	m e̞ː ɡ u ŋ n o̞
초고추장	t͡ɕʰ o̞ ɡ o̞ t͡ɕʰ u d͡ʑ a̠ ŋ
이크라	i k x ɯ ɾ a̠
적외선	t͡ɕ ʌ̹ ɡ w e̞ sʰ ʌ̹ n
전함	t͡ɕ ʌ̹ n ɦ a̠ m
분리주의	p u ɭ ʎ i d͡ʑ u ɰ i
피페라진	pʰ i pʰ e̞ ɾ a̠ d͡ʑ i n
잠시	t͡ɕ a̠ː m ɕʰ i
콘스탄티누스	kʰ o̞ n sʰ ɯ tʰ a̠ n tʰ i n u sʰ ɯ
간곡	k a̠ː n ɡ o̞ k̚
정상위	t͡ɕ ʌ̹ ŋ sʰ a̠ ŋ ɥ i
건너편	k ɘː n n ʌ̹ pʰ j ʌ̹ n
강계	k a̠ ŋ ɡ j e̞
분모	p u n m o̞
나절	n a̠ d͡ʑ ʌ̹ ɭ
올빼미	o̞ ɭ p͈ e̞ m i
실시하다	ɕʰ i ɭ ɕʰ i ɦ a̠ d a̠
개인	k e̞ː i n
이곳	i ɡ o̞ t̚
비롯하다	p i ɾ o̞ tʰ a̠ d a̠
리을	ɾ i ɯ ɭ
이튿날	i tʰ ɯ n n a̠ ɭ
코끼리	kʰ o̞ k͈ i ɾ i
한물	h a̠ n m u ɭ
회교	ɸ w e̞ ɡ j o
다양하다	t a̠ j a̠ ŋ ɦ a̠ d a̠
용과	j o ŋ ɡ w a̠
재해	t͡ɕ e̞ ɦ e̞
자음	t͡ɕ a̠ ɯ m
배고프다	p e̞ ɡ o̞ pʰ ɯ d a̠
종교	t͡ɕ o̞ ŋ ɡ j o
남녀노소	n a̠ m ɲ j ʌ̹ n o̞ sʰ o̞
주문하다	t͡ɕ uː m u n ɦ a̠ d a̠
사원	sʰ a̠ w ʌ̹ n
쌀미꾸리	s͈ a̠ ɭ m i k͈ u ɾ i
책들	t͡ɕʰ e̞ k̚ t͈ ɯ ɭ
지옥	t͡ɕ i o̞ k̚
선물	sʰ ɘː n m u ɭ
존경	t͡ɕ o̞ n ɡ j ʌ̹ ŋ
사용하다	sʰ a̠ː j o ŋ ɦ a̠ d a̠
고집스럽다	k o̞ d͡ʑ i p s͈ ɯ ɾ ʌ̹ p̚ t͈ a̠
신청자	ɕʰ i n t͡ɕʰ ʌ̹ ŋ d͡ʑ a̠
프테린	pʰ ɯ tʰ e̞ ɾ i n
편도	pʰ j ʌ̹ n d o̞
말라위	m a̠ ɭ ɭ a̠ ɥ i
야쿠츠크	j a̠ kʰ u t͡ɕʰ ɯ k x ɯ
염세주의	j ɘː m sʰ e̞ d͡ʑ u ɰ i
명란	m j ʌ̹ ŋ n a̠ n
코토레타	kʰ o̞ tʰ o̞ ɾ e̞ tʰ a̠
한자	h a̠ː n t͡ɕ͈ a̠
폭발	pʰ o̞ k̚ p͈ a̠ ɭ
찰밥	t͡ɕʰ a̠ ɭ b a̠ p̚
토착	tʰ o̞ t͡ɕʰ a̠ k̚
글꼴	k ɯ ɭ k͈ o̞ ɭ
그때	k ɯ t͈ e̞
멍멍	m ʌ̹ ŋ m ʌ̹ ŋ
항공사	h a̠ː ŋ ɡ o̞ ŋ sʰ a̠
정황	t͡ɕ ʌ̹ ŋ β w a̠ ŋ
두근두근	t u ɡ ɯ n d u ɡ ɯ n
실천하다	ɕʰ i ɭ t͡ɕʰ ʌ̹ n ɦ a̠ d a̠
버들개	p ʌ̹ d ɯ ɭ ɡ e̞
검질기다	k ɘː m d͡ʑ i ɭ ɡ i d a̠
란타넘	ɾ a̠ n tʰ a̠ n ʌ̹ m
희생	ç i sʰ e̞ ŋ
하얗다	h a̠ː j a̠ tʰ a̠
남빙양	n a̠ m b i ŋ ɲ j a̠ ŋ
마리화나	m a̠ ɾ i β w a̠ n a̠
구덩이	k u d ʌ̹ ŋ i
중적분	t͡ɕ u ŋ d͡ʑ ʌ̹ k̚ p͈ u n
열다섯째	j ʌ̹ ɭ t͈ a̠ sʰ ʌ̹ t̚ t͡ɕ͈ e̞
하드웨어	h a̠ d ɯ w e̞ ʌ̹
견과	k j ʌ̹ n ɡ w a̠
자작	t͡ɕ a̠ d͡ʑ a̠ k̚
휴전	ç j u d͡ʑ ʌ̹ n
목재	m o̞ k̚ t͡ɕ͈ e̞
바닷가재	p a̠ d a̠ t̚ k͈ a̠ d͡ʑ e̞
철퇴	t͡ɕʰ ʌ̹ ɭ tʰ w e̞
라며	ɾ a̠ m j ʌ̹
바자회	p a̠ d͡ʑ a̠ β w e̞
청각	t͡ɕʰ ʌ̹ ŋ ɡ a̠ k̚
심산유곡	ɕʰ iː m sʰ a̠ n ɲ j u ɡ o̞ k̚
사설	sʰ a̠ sʰ ʌ̹ ɭ
알파	a̠ ɭ pʰ a̠
엄지	ʌ̹ m d͡ʑ i
과제	k w a̠ d͡ʑ e̞
지혜	t͡ɕ i ʝ j e̞
마일	m a̠ i ɭ
방식	p a̠ ŋ ɕʰ i k̚
짱개	t͡ɕ͈ a̠ ŋ ɡ e̞
인수	i n sʰ u
알켄	a̠ ɭ kʰ e̞ n
청소년	t͡ɕʰ ʌ̹ ŋ sʰ o̞ ɲ j ʌ̹ n
신도	ɕʰ i n d o̞
광장	k w a̠ː ŋ d͡ʑ a̠ ŋ
쿠데타	kʰ u d e̞ tʰ a̠
거리다	k ʌ̹ ɾ i d a̠
명령하다	m j ɘː ŋ ɲ j ʌ̹ ŋ ɦ a̠ d a̠
외면	w e̞ː m j ʌ̹ n
비교	p iː ɡ j o
냉면	n e̞ː ŋ m j ʌ̹ n
무지개	m u d͡ʑ i ɡ e̞
출혈	t͡ɕʰ u ɾ ʝ j ʌ̹ ɭ
맺음말	m e̞ d͡ʑ ɯ m m a̠ ɭ
진동수	t͡ɕ i n d o̞ ŋ sʰ u
바깥	p a̠ k͈ a̠ t̚
논문	n o̞ n m u n
제동기	t͡ɕ e̞ː d o̞ ŋ ɡ i
찻주전자	t͡ɕʰ a̠ t̚ t͡ɕ͈ u d͡ʑ ʌ̹ n d͡ʑ a̠
비추다	p i t͡ɕʰ u d a̠
브레이크	p ɯ ɾ e̞ i k x ɯ
급료	k ɯ m ɲ j o
엘니노	e̞ ɭ ʎ i n o̞
삼십	sʰ a̠ m ɕʰ i p̚
수치	sʰ u t͡ɕʰ i
시골	ɕʰ i ɡ o̞ ɭ
복습	p o̞ k s͈ ɯ p̚
사냥개	sʰ a̠ ɲ j a̠ ŋ k͈ e̞
잠자다	t͡ɕ a̠ m d͡ʑ a̠ d a̠
유목민	j u m o̞ ŋ m i n
무섭다	m u sʰ ʌ̹ p̚ t͈ a̠
기소	k i sʰ o̞
창조자	t͡ɕʰ a̠ː ŋ d͡ʑ o̞ d͡ʑ a̠
베른	p e̞ ɾ ɯ n
광합성	k w a̠ ŋ ɦ a̠ p s͈ ʌ̹ ŋ
혈압	ç j ʌ̹ ɾ a̠ p̚
동성	t o̞ ŋ sʰ ʌ̹ ŋ
하강	h a̠ː ɡ a̠ ŋ
젊은이	t͡ɕ ʌ̹ ɭ m ɯ n i
염통	j ʌ̹ m tʰ o̞ ŋ
기꺼이	k i k͈ ʌ̹ i
양우	j a̠ ŋ u
호주	ɸʷ o̞ d͡ʑ u
주방장	t͡ɕ u b a̠ ŋ d͡ʑ a̠ ŋ
뺄셈	p͈ e̞ː ɭ sʰ e̞ m
친삼촌	t͡ɕʰ i n sʰ a̠ m t͡ɕʰ o̞ n
방수	p a̠ ŋ sʰ u
비키니	p i k ç i n i
리우데자네이루	ɾ i u d e̞ d͡ʑ a̠ n e̞ i ɾ u
숨다	sʰ uː m t͈ a̠
일본국	i ɭ b o̞ n ɡ u k̚
번역	p ʌ̹ ɲ j ʌ̹ k̚
떨어지다	t͈ ʌ̹ ɾ ʌ̹ d͡ʑ i d a̠
피곤하다	pʰ i ɡ o̞ n ɦ a̠ d a̠
청바지	t͡ɕʰ ʌ̹ ŋ b a̠ d͡ʑ i
대부분	t e̞ː b u b u n
귀리	k ɥ iː ɾ i
특별하다	tʰ ɯ k̚ p͈ j ʌ̹ ɾ ɦ a̠ d a̠
개구리매	k e̞ ɡ u ɾ i m e̞
모자	m o̞ d͡ʑ a̠
중대백로	t͡ɕ u ŋ d e̞ b e̞ ŋ n o̞
하키	h a̠ k ç i
본색	p o̞ n sʰ e̞ k̚
지금	t͡ɕ i ɡ ɯ m
지내다	t͡ɕ iː n e̞ d a̠
닭갈비	t a̠ k̚ k͈ a̠ ɭ b i
직발	t͡ɕ i k̚ p͈ a̠ ɭ
구석	k u sʰ ʌ̹ k̚
아말감	a̠ m a̠ ɭ ɡ a̠ m
비단털들쥐	p i d a̠ n tʰ ʌ̹ ɭ d ɯ ɭ d͡ʑ ɥ i
예언자	j e̞ː ʌ̹ n d͡ʑ a̠
제주모치망둑	t͡ɕ e̞ː d͡ʑ u m o̞ t͡ɕʰ i m a̠ ŋ d u k̚
현무암	ç j ʌ̹ n m u a̠ m
열도	j ʌ̹ ɭ t͈ o̞
망둑	m a̠ ŋ d u k̚
거부하다	k ɘː b u ɦ a̠ d a̠
압력	a̠ m ɲ j ʌ̹ k̚
최근	t͡ɕʰ w e̞ː ɡ ɯ n
아이스하키	a̠ i sʰ ɯ ɦ a̠ k ç i
아일랜드	a̠ i ɭ ɭ e̞ n d ɯ
은하계	ɯ n ɦ a̠ ɡ j e̞
공교	k o̞ː ŋ ɡ j o
돈까스	t o̞ n k͈ a̠ sʰ ɯ
과학관	k w a̠ ɦ a̠ k̚ k͈ w a̠ n
깻잎	k͈ e̞ n n i p̚
발뒤꿈치	p a̠ ɭ t͈ ɥ i k͈ u m t͡ɕʰ i
흥륭	x ɯ ŋ ɲ j u ŋ
스며들다	sʰ ɯ m j ʌ̹ d ɯ ɭ d a̠
나루	n a̠ ɾ u
친족	t͡ɕʰ i n d͡ʑ o̞ k̚
판공실	pʰ a̠ n ɡ o̞ ŋ ɕʰ i ɭ
시상	ɕʰ iː sʰ a̠ ŋ
따라가다	t͈ a̠ ɾ a̠ ɡ a̠ d a̠
대지	t e̞ː d͡ʑ i
표준	pʰ j o d͡ʑ u n
규칙	k j u t͡ɕʰ i k̚
예술	j e̞ː sʰ u ɭ
주무시다	t͡ɕ u m u ɕʰ i d a̠
재앙	t͡ɕ e̞ a̠ ŋ
양태	j a̠ ŋ tʰ e̞
열한째	j ʌ̹ ɾ ɦ a̠ n t͡ɕ͈ e̞
타이틀	tʰ a̠ i tʰ ɯ ɭ
배우자	p e̞ː u d͡ʑ a̠
아이누어	a̠ i n u ʌ̹
저지	t͡ɕ ʌ̹ d͡ʑ i
베스트셀러	p e̞ sʰ ɯ tʰ ɯ sʰ e̞ ɭ ɭ ʌ̹
칼리파	kʰ a̠ ɭ ʎ i pʰ a̠
수영하다	sʰ u j ʌ̹ ŋ ɦ a̠ d a̠
오늘	o̞ n ɯ ɭ
간부	k a̠ n b u
국수뱅어	k u k s͈ u b e̞ ŋ ʌ̹
구부러지다	k u b u ɾ ʌ̹ d͡ʑ i d a̠
영원하다	j ɘː ŋ w ʌ̹ n ɦ a̠ d a̠
깔리다	k͈ a̠ ɭ ʎ i d a̠
음역	ɯ m j ʌ̹ k̚
또다시	t͈ o̞ d a̠ ɕʰ i
여색	j ʌ̹ sʰ e̞ k̚
소개팅	sʰ o̞ ɡ e̞ tʰ i ŋ
모처럼	m o̞ t͡ɕʰ ʌ̹ ɾ ʌ̹ m
분투	p uː n tʰ u
홀어미	ɸʷ o̞ ɾ ʌ̹ m i
속담	sʰ o̞ k̚ t͈ a̠ m
시작	ɕʰ iː d͡ʑ a̠ k̚
고리	k o̞ ɾ i
근원	k ɯ n w ʌ̹ n
마그네슘	m a̠ ɡ ɯ n e̞ ɕʰ j u m
의자	ɰ i d͡ʑ a̠
도와주다	t o̞ w a̠ d͡ʑ u d a̠
전보	t͡ɕ ɘː n b o̞
이울다	i u ɭ d a̠
잡신	t͡ɕ a̠ p ɕ͈ i n
부문	p u m u n
도우미	t o̞ u m i
그토록	k ɯ tʰ o̞ ɾ o̞ k̚
과테말라	k w a̠ tʰ e̞ m a̠ ɭ ɭ a̠
떠들썩하다	t͈ ʌ̹ d ɯ ɭ s͈ ʌ̹ kʰ a̠ d a̠
이슬비	i sʰ ɯ ɭ b i
깨우다	k͈ e̞ u d a̠
묵은지	m u ɡ ɯ n d͡ʑ i
인질	i n d͡ʑ i ɭ
혼인	ɸʷ o̞ n i n
체코슬로바키아	t͡ɕʰ e̞ kʰ o̞ sʰ ɯ ɭ ɭ o̞ b a̠ k ç i a̠
현대적	ç j ɘː n d e̞ d͡ʑ ʌ̹ k̚
같잖다	k a̠ t̚ t͡ɕ͈ a̠ n tʰ a̠
매춘부	m e̞ː t͡ɕʰ u n b u
칭찬하다	t͡ɕʰ i ŋ t͡ɕʰ a̠ n ɦ a̠ d a̠
공모	k o̞ː ŋ m o̞
멈칫	m ʌ̹ m t͡ɕʰ i t̚
자수하다	t͡ɕ a̠ sʰ u ɦ a̠ d a̠
장려금	t͡ɕ a̠ː ŋ ɲ j ʌ̹ ɡ ɯ m
생각	sʰ e̞ ŋ ɡ a̠ k̚
플러그	pʰ ɯ ɭ ɭ ʌ̹ ɡ ɯ
흰기러기	ç i n ɡ i ɾ ʌ̹ ɡ i
스풀	sʰ ɯ pʰ u ɭ
염기	j ʌ̹ m ɡ i
잠깐	t͡ɕ a̠ m k͈ a̠ n
신포	ɕʰ i n pʰ o̞
젓가락	t͡ɕ ʌ̹ t̚ k͈ a̠ ɾ a̠ k̚
팸플릿	pʰ e̞ m pʰ ɯ ɭ ʎ i t̚
스프링클러	sʰ ɯ pʰ ɯ ɾ i ŋ k x ɯ ɭ ɭ ʌ̹
결혼	k j ʌ̹ ɾ β o̞ n
갸웃	k j a̠ u t̚
삿갓	sʰ a̠ t̚ k͈ a̠ t̚
넓다	n ʌ̹ ɭ t͈ a̠
논평	n o̞ n pʰ j ʌ̹ ŋ
드레스	t ɯ ɾ e̞ sʰ ɯ
천만에요	t͡ɕʰ ʌ̹ n m a̠ n e̞ j o
메터	m e̞ tʰ ʌ̹
기저귀	k i d͡ʑ ʌ̹ ɡ ɥ i
여든째	j ʌ̹ d ɯ n t͡ɕ͈ e̞
눈웃음	n u n u sʰ ɯ m
샌디에이고	sʰ e̞ n d i e̞ i ɡ o̞
얼마	ʌ̹ ɭ m a̠
단체	t a̠ n t͡ɕʰ e̞
부정하다	p u d͡ʑ ʌ̹ ŋ ɦ a̠ d a̠
오가네손	o̞ ɡ a̠ n e̞ sʰ o̞ n
만포	m a̠ː n pʰ o̞
무려	m u ɾ j ʌ̹
다묵장어	t a̠ m u k̚ t͡ɕ͈ a̠ ŋ ʌ̹
삼수	sʰ a̠ m sʰ u
아르곤	a̠ ɾ ɯ ɡ o̞ n
라듐	ɾ a̠ d j u m
증기선	t͡ɕ ɯ ŋ ɡ i sʰ ʌ̹ n
돋다	t o̞ t̚ t͈ a̠
탁아소	tʰ a̠ ɡ a̠ sʰ o̞
산스크리트어	sʰ a̠ n sʰ ɯ k x ɯ ɾ i tʰ ɯ ʌ̹
등받이	t ɯ ŋ b a̠ d i
왕가	w a̠ ŋ ɡ a̠
종일	t͡ɕ o̞ ŋ i ɭ
라이터돌	ɾ a̠ i tʰ ʌ̹ d o̞ ɭ
연기자	j ɘː n ɡ i d͡ʑ a̠
이라크어	i ɾ a̠ k x ɯ ʌ̹
불치다	p u ɭ t͡ɕʰ i d a̠
트랜스젠더	tʰ ɯ ɾ e̞ n sʰ ɯ d͡ʑ e̞ n d ʌ̹
반다르세리베가완	p a̠ n d a̠ ɾ ɯ sʰ e̞ ɾ i b e̞ ɡ a̠ w a̠ n
간호사	k a̠ n β o̞ sʰ a̠
혈압계	ç j ʌ̹ ɾ a̠ p̚ k͈ j e̞
모리셔스	m o̞ ɾ i ɕʰ j ʌ̹ sʰ ɯ
티브이	tʰ i b ɯ i
여대생	j ʌ̹ d e̞ sʰ e̞ ŋ
문어다리	m u n ʌ̹ d a̠ ɾ i
날카롭다	n a̠ ɭ kʰ a̠ ɾ o̞ p̚ t͈ a̠
도이췰란드	t o̞ i t͡ɕʰ ɥ i ɭ ɭ a̠ n d ɯ
쓸데없다	s͈ ɯ ɭ t͈ e̞ ʌ̹ p̚ t͈ a̠
애기	e̞ ɡ i
비뚤다	p i t͈ u ɭ d a̠
화학전달물질	ɸ w a̠ ɦ a̠ k̚ t͡ɕ͈ ʌ̹ n d a̠ ɭ m u ɭ t͡ɕ͈ i ɭ
디귿	t i ɡ ɯ t̚
뇌물	n w e̞ m u ɭ
목젖	m o̞ k̚ t͡ɕ͈ ʌ̹ t̚
애도	e̞ d o̞
뒤섞다	t ɥ i sʰ ʌ̹ k̚ t͈ a̠
선생	sʰ ʌ̹ n sʰ e̞ ŋ
노보시비르스크	n o̞ b o̞ ɕʰ i b i ɾ ɯ sʰ ɯ k x ɯ
런던	ɾ ʌ̹ n d ʌ̹ n
한사군	h a̠ː n sʰ a̠ ɡ u n
해빛	h e̞ b i t̚
상아	sʰ a̠ ŋ a̠
군바리	k u n b a̠ ɾ i
그만	k ɯ m a̠ n
추구	t͡ɕʰ u ɡ u
빤쯔	p͈ a̠ n t͡ɕ͈ ɯ
가봉	k a̠ b o̞ ŋ
구라파	k u ɾ a̠ pʰ a̠
살해	sʰ a̠ ɾ ɦ e̞
순수	sʰ u n sʰ u
리버모륨	ɾ i b ʌ̹ m o̞ ɾ j u m
슬기롭다	sʰ ɯ ɭ ɡ i ɾ o̞ p̚ t͈ a̠
창밖	t͡ɕʰ a̠ ŋ b a̠ k̚
서비스	s͈ ʌ̹ b i sʰ ɯ
잔디	t͡ɕ a̠ n d i
멧돼지	m e̞ t̚ t͈ w e̞ d͡ʑ i
서원	sʰ ʌ̹ w ʌ̹ n
여인숙	j ʌ̹ i n sʰ u k̚
연합	j ʌ̹ n ɦ a̠ p̚
어묵	ʌ̹ m u k̚
꿀밤	k͈ u ɭ b a̠ m
흥하다	x ɯ ŋ ɦ a̠ d a̠
어제	ʌ̹ d͡ʑ e̞
굶기다	k u m ɡ i d a̠
짜릿하다	t͡ɕ͈ a̠ ɾ i tʰ a̠ d a̠
진료소	t͡ɕ iː ɭ ʎ j o sʰ o̞
건축	k ɘː n t͡ɕʰ u k̚
조동사	t͡ɕ o̞ d o̞ ŋ sʰ a̠
분포하다	p u n pʰ o̞ ɦ a̠ d a̠
살롱	sʰ a̠ ɭ ɭ o̞ ŋ
저런	t͡ɕ ʌ̹ ɾ ʌ̹ n
메뉴	m e̞ ɲ j u
여사친	j ʌ̹ sʰ a̠ t͡ɕʰ i n
성스럽다	sʰ ɘː ŋ sʰ ɯ ɾ ʌ̹ p̚ t͈ a̠
총알	t͡ɕʰ o̞ ŋ a̠ ɭ
소음순	sʰ o̞ː ɯ m sʰ u n
덕택	t ʌ̹ k̚ tʰ e̞ k̚
정책	t͡ɕ ɘː ŋ t͡ɕʰ e̞ k̚
코튼	kʰ o̞ tʰ ɯ n
가능성	k a̠ː n ɯ ŋ s͈ ʌ̹ ŋ
조리	t͡ɕ o̞ ɾ i
동공	t o̞ː ŋ ɡ o̞ ŋ
포함되다	pʰ o̞ ɦ a̠ m d w e̞ d a̠
불도저	p u ɭ d o̞ d͡ʑ ʌ̹
청가시고기	t͡ɕʰ ʌ̹ ŋ ɡ a̠ ɕʰ i ɡ o̞ ɡ i
구미호	k u m i β o̞
응시	ɯ ŋ ɕʰ i
물기	m u ɭ k͈ i
수레	sʰ u ɾ e̞
ᆯ게	ɭ k͈ e̞
수요	sʰ u j o
입력기	i m ɲ j ʌ̹ k̚ k͈ i
칠면조	t͡ɕʰ i ɭ m j ʌ̹ n d͡ʑ o̞
아도	a̠ d o̞
부엌	p u ʌ̹ k̚
끄다	k͈ ɯ d a̠
세트	sʰ e̞ tʰ ɯ
자르다	t͡ɕ a̠ ɾ ɯ d a̠
잡초	t͡ɕ a̠ p̚ t͡ɕʰ o̞
윁남	w e̞ n n a̠ m
거울	k ʌ̹ u ɭ
오덕후	o̞ d ʌ̹ kʰ u
한겨레	h a̠ n ɡ j ʌ̹ ɾ e̞
연말	j ʌ̹ n m a̠ ɭ
두발	t u b a̠ ɭ
피넨	pʰ i n e̞ n
보증	p o̞ d͡ʑ ɯ ŋ
실마리	ɕʰ iː ɭ m a̠ ɾ i
노면	n o̞ m j ʌ̹ n
갈비	k a̠ ɭ b i
수탉	sʰ u tʰ a̠ k̚
제네바	t͡ɕ e̞ n e̞ b a̠
꾸짖다	k͈ u d͡ʑ i t̚ t͈ a̠
자동사	t͡ɕ a̠ d o̞ ŋ sʰ a̠
큰물	k x ɯ n m u ɭ
금일	k ɯ m i ɭ
햇살	h e̞ t̚ s͈ a̠ ɭ
쓰다	s͈ ɯ d a̠
타밀어	tʰ a̠ m i ɾ ʌ̹
논병아리	n o̞ n b j ʌ̹ ŋ a̠ ɾ i
고식물학	k o̞ ɕʰ i ŋ m u ɾ ɦ a̠ k̚
삐딱하다	p͈ i t͈ a̠ kʰ a̠ d a̠
도넛	t o̞ n ʌ̹ t̚
와이파이	w a̠ i pʰ a̠ i
병아리	p j ʌ̹ ŋ a̠ ɾ i
경이원지	k j ɘː ŋ i w ʌ̹ n d͡ʑ i
늦가을	n ɯ t̚ k͈ a̠ ɯ ɭ
엉덩이	ɘː ŋ d ʌ̹ ŋ i
고추장	k o̞ t͡ɕʰ u d͡ʑ a̠ ŋ
사이즈	sʰ a̠ i d͡ʑ ɯ
세탁	sʰ e̞ː tʰ a̠ k̚
맞흥정	m a̠ tʰ ɯ ŋ d͡ʑ ʌ̹ ŋ
모태	m o̞ tʰ e̞
늑대	n ɯ k̚ t͈ e̞
선배	sʰ ʌ̹ n b e̞
숨쉬다	sʰ u m ʃʰ ɥ i d a̠
돌상어	t o̞ ɭ sʰ a̠ ŋ ʌ̹
평등	pʰ j ʌ̹ ŋ d ɯ ŋ
판매점	pʰ a̠ n m e̞ d͡ʑ ʌ̹ m
식료품점	ɕʰ i ŋ ɲ j o pʰ u m d͡ʑ ʌ̹ m
건반	k ʌ̹ n b a̠ n
피아니스트	pʰ i a̠ n i sʰ ɯ tʰ ɯ
엳아홉	j ʌ̹ d a̠ β o̞ p̚
야무수크로	j a̠ m u sʰ u k x ɯ ɾ o̞
전개되다	t͡ɕ ɘː n ɡ e̞ d w e̞ d a̠
곧다	k o̞ t̚ t͈ a̠
점줄종개	t͡ɕ ʌ̹ m d͡ʑ u ɭ d͡ʑ o̞ ŋ ɡ e̞
필름	pʰ i ɭ ɭ ɯ m
콜레라	kʰ o̞ ɭ ɭ e̞ ɾ a̠
이모지	i m o̞ d͡ʑ i
일부	i ɭ b u
괌도	k w a̠ m d o̞
편하다	pʰ j ʌ̹ n ɦ a̠ d a̠
타이어	tʰ a̠ i ʌ̹
대추	t e̞ t͡ɕʰ u
울퉁불퉁	u ɭ tʰ u ŋ b u ɭ tʰ u ŋ
뚫다	t͈ u ɭ tʰ a̠
큰돌고래	k x ɯ n d o̞ ɭ ɡ o̞ ɾ e̞
의심되다	ɰ i ɕʰ i m d w e̞ d a̠
효소	ç j oː sʰ o̞
해달	h e̞ː d a̠ ɭ
요즈음	j o d͡ʑ ɯ ɯ m
모르핀	m o̞ ɾ ɯ pʰ i n
불륜하다	p u ɭ ʎ j u n ɦ a̠ d a̠
명인	m j ʌ̹ ŋ i n
근래	k ɯː ɭ ɭ e̞
탄약고	tʰ a̠ː ɲ j a̠ k̚ k͈ o̞
아이콘	a̠ i kʰ o̞ n
수송선	sʰ u sʰ o̞ ŋ sʰ ʌ̹ n
은인	ɯ n i n
접미사	t͡ɕ ʌ̹ m m i sʰ a̠
몰라	m o̞ ɭ ɭ a̠
강하다	k a̠ ŋ ɦ a̠ d a̠
이끼	i k͈ i
야곱	j a̠ ɡ o̞ p̚
목욕	m o̞ ɡ j o k̚
소독제	sʰ o̞ d o̞ k̚ t͡ɕ͈ e̞
대두	t e̞ d u
개회식	k e̞ β w e̞ ɕʰ i k̚
질책하다	t͡ɕ i ɭ t͡ɕʰ e̞ kʰ a̠ d a̠
헤라	h e̞ ɾ a̠
은자메나	ɯ n d͡ʑ a̠ m e̞ n a̠
대령	t e̞ː ɾ j ʌ̹ ŋ
퐁뒤	pʰ o̞ ŋ d ɥ i
얼굴	ʌ̹ ɭ ɡ u ɭ
합기도	h a̠ p̚ k͈ i d o̞
이리	i ɾ i
베란다	p e̞ ɾ a̠ n d a̠
자연	t͡ɕ a̠ j ʌ̹ n
살금살금	sʰ a̠ ɭ ɡ ɯ m sʰ a̠ ɭ ɡ ɯ m
간접	k a̠ n d͡ʑ ʌ̹ p̚
구성되다	k u sʰ ʌ̹ ŋ d w e̞ d a̠
교육학	k j oː j u kʰ a̠ k̚
착하다	t͡ɕʰ a̠ kʰ a̠ d a̠
남해	n a̠ m ɦ e̞
표하다	pʰ j oː ɦ a̠ d a̠
이주	i d͡ʑ u
그믐	k ɯ m ɯ m
갈음하다	k a̠ ɾ ɯ m ɦ a̠ d a̠
즐거움	t͡ɕ ɯ ɭ ɡ ʌ̹ u m
소프트웨어	sʰ o̞ pʰ ɯ tʰ ɯ w e̞ ʌ̹
비망록	p iː m a̠ ŋ n o̞ k̚
마스크	m a̠ sʰ ɯ k x ɯ
대학	t e̞ː ɦ a̠ k̚
로렌슘	ɾ o̞ ɾ e̞ n ɕʰ j u m
경제적	k j ʌ̹ ŋ d͡ʑ e̞ d͡ʑ ʌ̹ k̚
장음	t͡ɕ a̠ ŋ ɯ m
우주인	uː d͡ʑ u i n
성별	sʰ ɘː ŋ b j ʌ̹ ɭ
리투아니아	ɾ i tʰ u a̠ n i a̠
카페인	kʰ a̠ pʰ e̞ i n
콘비프	kʰ o̞ n b i pʰ ɯ
미적분	m i d͡ʑ ʌ̹ k̚ p͈ u n
의회	ɰ i β w e̞
등장	t ɯ ŋ d͡ʑ a̠ ŋ
포근하다	pʰ o̞ ɡ ɯ n ɦ a̠ d a̠
사귀다	sʰ a̠ ɡ ɥ i d a̠
해내다	h e̞ː n e̞ d a̠
모임	m o̞ i m
인플레이션	i n pʰ ɯ ɭ ɭ e̞ i ɕʰ j ʌ̹ n
조촐하다	t͡ɕ o̞ t͡ɕʰ o̞ ɾ ɦ a̠ d a̠
나미비아	n a̠ m i b i a̠
목탄	m o̞ k̚ tʰ a̠ n
항라머리검독수리	h a̠ː ŋ n a̠ m ʌ̹ ɾ i ɡ ʌ̹ m d o̞ k s͈ u ɾ i
학과	h a̠ k̚ k͈ w a̠
빠져나가다	p͈ a̠ː d͡ʑ j ʌ̹ n a̠ ɡ a̠ d a̠
읊조리다	ɯ p̚ t͡ɕ͈ o̞ ɾ i d a̠
대역죄	t e̞ː j ʌ̹ k̚ t͡ɕ͈ w e̞
읊다	ɯ p̚ t͈ a̠
필살기	pʰ i ɭ s͈ a̠ ɭ ɡ i
아베크	a̠ b e̞ k x ɯ
불규칙하다	p u ɭ ɡ j u t͡ɕʰ i kʰ a̠ d a̠
돋우다	t o̞ d u d a̠
젓다	t͡ɕ ɘː t̚ t͈ a̠
쓰이다	s͈ ɯ i d a̠
배반	p e̞ː b a̠ n
하얀색	h a̠ j a̠ n sʰ e̞ k̚
가늠하다	k a̠ n ɯ m ɦ a̠ d a̠
빨래	p͈ a̠ ɭ ɭ e̞
교리	k j oː ɾ i
탄도	tʰ a̠ː n d o̞
스틱	sʰ ɯ tʰ i k̚
차돌박이	t͡ɕʰ a̠ d o̞ ɭ b a̠ ɡ i
몰래	m o̞ː ɭ ɭ e̞
너머로	n ʌ̹ m ʌ̹ ɾ o̞
갈리	k a̠ ɭ ʎ i
기생충학	k i sʰ e̞ ŋ t͡ɕʰ u ŋ ɦ a̠ k̚
북극해	p u k̚ k͈ ɯ kʰ e̞
입원	i b w ʌ̹ n
안다	a̠ː n t͈ a̠
창녀	t͡ɕʰ a̠ ŋ ɲ j ʌ̹
썰매	s͈ ʌ̹ ɭ m e̞
이하	iː ɦ a̠
노엽다	n o̞ː j ʌ̹ p̚ t͈ a̠
번개	p ʌ̹ n ɡ e̞
만화책	m a̠ː n β w a̠ t͡ɕʰ e̞ k̚
개구락지	k e̞ ɡ u ɾ a̠ k̚ t͡ɕ͈ i
작성하다	t͡ɕ a̠ k s͈ ʌ̹ ŋ ɦ a̠ d a̠
강력	k a̠ ŋ ɲ j ʌ̹ k̚
알판	a̠ ɭ pʰ a̠ n
적포도주	t͡ɕ ʌ̹ k̚ pʰ o̞ d o̞ d͡ʑ u
알루미늄	a̠ ɭ ɭ u m i ɲ j u m
피난	pʰ iː n a̠ n
이용되다	iː j o ŋ d w e̞ d a̠
진짜	t͡ɕ i n t͡ɕ͈ a̠
소련	sʰ o̞ ɾ j ʌ̹ n
서구	sʰ ʌ̹ ɡ u
이롭다	iː ɾ o̞ p̚ t͈ a̠
후드	ɸʷ u d ɯ
치앙마이	t͡ɕʰ i a̠ ŋ m a̠ i
수급	sʰ u ɡ ɯ p̚
불친절	p u ɭ t͡ɕʰ i n d͡ʑ ʌ̹ ɭ
모래무지	m o̞ ɾ e̞ m u d͡ʑ i
가금	k a̠ ɡ ɯ m
그림엽서	k ɯː ɾ i m j ʌ̹ p s͈ ʌ̹
달라지다	t a̠ ɭ ɭ a̠ d͡ʑ i d a̠
예후	j e̞ː β u
한도	h a̠ː n d o̞
리무진	ɾ i m u d͡ʑ i n
면양	m j ʌ̹ ɲ j a̠ ŋ
삼색	sʰ a̠ m sʰ e̞ k̚
오래되다	o̞ ɾ e̞ d w e̞ d a̠
낭하	n a̠ ŋ ɦ a̠
동거	t o̞ ŋ ɡ ʌ̹
바이블	p a̠ i b ɯ ɭ
재판관	t͡ɕ e̞ pʰ a̠ n ɡ w a̠ n
조류	t͡ɕ o̞ ɾ j u
서넛	sʰ ʌ̹ n ʌ̹ t̚
리더	ɾ i d ʌ̹
크바르크	k x ɯ b a̠ ɾ ɯ k x ɯ
시장하시다	ɕʰ i d͡ʑ a̠ ŋ ɦ a̠ ɕʰ i d a̠
요즘	j o d͡ʑ ɯ m
도예	t o̞ j e̞
릴롱궤	ɾ i ɭ ɭ o̞ ŋ ɡ w e̞
명절	m j ʌ̹ ŋ d͡ʑ ʌ̹ ɭ
체력	t͡ɕʰ e̞ ɾ j ʌ̹ k̚
온라인	o̞ n n a̠ i n
다듬다	t a̠ d ɯ m t͈ a̠
구경하다	k uː ɡ j ʌ̹ ŋ ɦ a̠ d a̠
계층	k j e̞ t͡ɕʰ ɯ ŋ
타이틀곡	tʰ a̠ i tʰ ɯ ɭ ɡ o̞ k̚
관광학	k w a̠ n ɡ w a̠ ŋ ɦ a̠ k̚
산호초	sʰ a̠ n β o̞ t͡ɕʰ o̞
강간	k a̠ː ŋ ɡ a̠ n
짊어지다	t͡ɕ i ɭ m ʌ̹ d͡ʑ i d a̠
흑흑	x ɯ k x ɯ k̚
로스앤젤레스	ɾ o̞ sʰ ɯ e̞ n d͡ʑ e̞ ɭ ɭ e̞ sʰ ɯ
꾸미다	k͈ u m i d a̠
전갈	t͡ɕ ʌ̹ n ɡ a̠ ɭ
여체	j ʌ̹ t͡ɕʰ e̞
식탁	ɕʰ i k̚ tʰ a̠ k̚
왜매치	w e̞ m e̞ t͡ɕʰ i
가미카제	k a̠ m i kʰ a̠ d͡ʑ e̞
군함조	k u n ɦ a̠ m d͡ʑ o̞
작품집	t͡ɕ a̠ k̚ pʰ u m d͡ʑ i p̚
너희	n ʌ̹ ʝ i
포켓	pʰ o̞ kʰ e̞ t̚
분포	p u n pʰ o̞
희끗희끗	ç i k͈ ɯ tʰ i k͈ ɯ t̚
고기떡	k o̞ ɡ i t͈ ʌ̹ k̚
산호세	sʰ a̠ n β o̞ sʰ e̞
형용사	ç j ʌ̹ ŋ j o ŋ sʰ a̠
관련	k w a̠ ɭ ʎ j ʌ̹ n
탄핵	tʰ a̠ː n ɦ e̞ k̚
열여덟	j ʌ̹ ɭ ʎ j ʌ̹ d ʌ̹ ɭ
선거	sʰ ɘː n ɡ ʌ̹
북장	p u k̚ t͡ɕ͈ a̠ ŋ
의문사	ɰ i m u n sʰ a̠
기초	k i t͡ɕʰ o̞
토픽	tʰ o̞ pʰ i k̚
포치	pʰ o̞ t͡ɕʰ i
관료제	k w a̠ ɭ ʎ j o d͡ʑ e̞
시키다	ɕʰ i k ç i d a̠
감동사	k a̠ː m d o̞ ŋ sʰ a̠
도다리	t o̞ d a̠ ɾ i
혼자	ɸʷ o̞ n d͡ʑ a̠
이용	iː j o ŋ
총각김치	t͡ɕʰ o̞ ŋ ɡ a̠ k̚ k͈ i m t͡ɕʰ i
잔뜩	t͡ɕ a̠ n t͈ ɯ k̚
축전기	t͡ɕʰ u k̚ t͡ɕ͈ ʌ̹ n ɡ i
모세	m o̞ sʰ e̞
사악	sʰ a̠ a̠ k̚
전국적	t͡ɕ ʌ̹ n ɡ u k̚ t͡ɕ͈ ʌ̹ k̚
납자루	n a̠ p̚ t͡ɕ͈ a̠ ɾ u
술래	sʰ u ɭ ɭ e̞
추기경	t͡ɕʰ u ɡ i ɡ j ʌ̹ ŋ
감당하다	k a̠ː m d a̠ ŋ ɦ a̠ d a̠
숭고	sʰ u ŋ ɡ o̞
열역학	j ʌ̹ ɭ ʎ j ʌ̹ kʰ a̠ k̚
전골	t͡ɕ ɘː n ɡ o̞ ɭ
삼초	sʰ a̠ m t͡ɕʰ o̞
푸주한	pʰ u d͡ʑ u ɦ a̠ n
키르기스스탄	k ç i ɾ ɯ ɡ i sʰ ɯ sʰ ɯ tʰ a̠ n
칼로리	kʰ a̠ ɭ ɭ o̞ ɾ i
습관	sʰ ɯ p̚ k͈ w a̠ n
요람본	j o ɾ a̠ m b o̞ n
포탈	pʰ o̞ tʰ a̠ ɭ
씨발	ɕ͈ i b a̠ ɭ
국제	k u k̚ t͡ɕ͈ e̞
피읖	pʰ i ɯ p̚
마늘	m a̠ n ɯ ɭ
희망	ç i m a̠ ŋ
비잔티온	p i d͡ʑ a̠ n tʰ i o̞ n
아니메	a̠ n i m e̞
맞춤법	m a̠ t̚ t͡ɕʰ u m p͈ ʌ̹ p̚
귀뿔논병아리	k ɥ i p͈ u ɭ ɭ o̞ n b j ʌ̹ ŋ a̠ ɾ i
건의	k ɘː n ɰ i
확대	ɸ w a̠ k̚ t͈ e̞
나쁘다	n a̠ p͈ ɯ d a̠
프로이센	pʰ ɯ ɾ o̞ i sʰ e̞ n
메이스	m e̞ i sʰ ɯ
저거	t͡ɕ ʌ̹ ɡ ʌ̹
어저께	ʌ̹ d͡ʑ ʌ̹ k͈ e̞
달빛	t a̠ ɭ p͈ i t̚
초록	t͡ɕʰ o̞ ɾ o̞ k̚
기승위	k i sʰ ɯ ŋ ɥ i
스크린	sʰ ɯ k x ɯ ɾ i n
뜨다	t͈ ɯ d a̠
자위하다	t͡ɕ a̠ ɥ i ɦ a̠ d a̠
일본학	i ɭ b o̞ n ɦ a̠ k̚
공정	k o̞ ŋ d͡ʑ ʌ̹ ŋ
어린아이	ʌ̹ ɾ i n a̠ i
승리	sʰ ɯ ŋ n i
시기	ɕʰ i ɡ i
개저씨	k e̞ d͡ʑ ʌ̹ ɕ͈ i
문화어	m u n β w a̠ ʌ̹
넓이	n ʌ̹ ɭ b i
편집하다	pʰ j ʌ̹ n d͡ʑ i pʰ a̠ d a̠
이교도	iː ɡ j o d o̞
깨지다	k͈ e̞ː d͡ʑ i d a̠
목장	m o̞ k̚ t͡ɕ͈ a̠ ŋ
닭싸움	t a̠ k s͈ a̠ u m
품삯	pʰ u m s͈ a̠ k̚
밀월	m i ɾ w ʌ̹ ɭ
가르침	k a̠ ɾ ɯ t͡ɕʰ i m
제공하다	t͡ɕ e̞ ɡ o̞ ŋ ɦ a̠ d a̠
세요	sʰ e̞ j o
현행	ç j ɘː n ɦ e̞ ŋ
군대	k u n d e̞
숨바꼭질	sʰ u m b a̠ k͈ o̞ k̚ t͡ɕ͈ i ɭ
부장	p u d͡ʑ a̠ ŋ
추적하다	t͡ɕʰ u d͡ʑ ʌ̹ kʰ a̠ d a̠
웅어	u ŋ ʌ̹
일본주	i ɭ b o̞ n d͡ʑ u
동일	t o̞ ŋ i ɭ
핸드폰	h e̞ n d ɯ pʰ o̞ n
참몰개	t͡ɕʰ a̠ m m o̞ ɭ ɡ e̞
방문	p a̠ː ŋ m u n
가지가지	k a̠ d͡ʑ i ɡ a̠ d͡ʑ i
주사위	t͡ɕ u sʰ a̠ ɥ i
살아남다	sʰ a̠ ɾ a̠ n a̠ m t͈ a̠
당시	t a̠ ŋ ɕʰ i
피해자	pʰ iː ɦ e̞ d͡ʑ a̠
쑤시다	s͈ u ɕʰ i d a̠
슬로바키아	sʰ ɯ ɭ ɭ o̞ b a̠ k ç i a̠
기니피그	k i n i pʰ i ɡ ɯ
다큐멘터리	t a̠ k ç j u m e̞ n tʰ ʌ̹ ɾ i
롤러코스터	ɾ o̞ ɭ ɭ ʌ̹ kʰ o̞ sʰ ɯ tʰ ʌ̹
구각형	k u ɡ a̠ k ç j ʌ̹ ŋ
궁금하다	k u ŋ ɡ ɯ m ɦ a̠ d a̠
피스톨	pʰ i sʰ ɯ tʰ o̞ ɭ
비판적	p iː pʰ a̠ n d͡ʑ ʌ̹ k̚
새들	sʰ e̞ d ɯ ɭ
두다	t u d a̠
아나키즘	a̠ n a̠ k ç i d͡ʑ ɯ m
뜻하다	t͈ ɯ tʰ a̠ d a̠
운석	uː n sʰ ʌ̹ k̚
그러면	k ɯ ɾ ʌ̹ m j ʌ̹ n
노력	n o̞ ɾ j ʌ̹ k̚
중독	t͡ɕ u ŋ d o̞ k̚
조가비	t͡ɕ o̞ ɡ a̠ b i
페이지	pʰ e̞ i d͡ʑ i
평온	pʰ j ʌ̹ ŋ o̞ n
사바나	sʰ a̠ b a̠ n a̠
낮추다	n a̠ t̚ t͡ɕʰ u d a̠
참회	t͡ɕʰ a̠ m β w e̞
된소리	t w e̞ː n sʰ o̞ ɾ i
시끄럽다	ɕʰ i k͈ ɯ ɾ ʌ̹ p̚ t͈ a̠
써리다	s͈ ɘː ɾ i d a̠
엎지르다	ʌ̹ p̚ t͡ɕ͈ i ɾ ɯ d a̠
음향양자	ɯ m ʝ j a̠ ŋ j a̠ ŋ d͡ʑ a̠
귀엽다	k ɥ iː j ʌ̹ p̚ t͈ a̠
천주	t͡ɕʰ ʌ̹ n d͡ʑ u
착용하다	t͡ɕʰ a̠ ɡ j o ŋ ɦ a̠ d a̠
팝송	pʰ a̠ p s͈ o̞ ŋ
선풍	sʰ ʌ̹ n pʰ u ŋ
사천	sʰ a̠ t͡ɕʰ ʌ̹ n
자루	t͡ɕ a̠ ɾ u
민족학	m i n d͡ʑ o̞ kʰ a̠ k̚
방법론	p a̠ ŋ b ʌ̹ m n o̞ n
대로	t e̞ ɾ o̞
믿음	m i d ɯ m
부모	p u m o̞
접다	t͡ɕ ʌ̹ p̚ t͈ a̠
직원	t͡ɕ i ɡ w ʌ̹ n
가숭어	k a̠ː sʰ u ŋ ʌ̹
패다	pʰ e̞ d a̠
라고스	ɾ a̠ ɡ o̞ sʰ ɯ
달하다	t a̠ ɾ ɦ a̠ d a̠
펴내다	pʰ j ʌ̹ n e̞ d a̠
습하다	sʰ ɯ pʰ a̠ d a̠
동갑	t o̞ ŋ ɡ a̠ p̚
사거리	sʰ a̠ː ɡ ʌ̹ ɾ i
바늘	p a̠ n ɯ ɭ
때리다	t͈ e̞ ɾ i d a̠
황소개구리	ɸ w a̠ ŋ sʰ o̞ ɡ e̞ ɡ u ɾ i
엉덩방아	ɘː ŋ d ʌ̹ ŋ b a̠ ŋ a̠
괴롭히다	k w e̞ ɾ o̞ pʰ i d a̠
관성	k w a̠ n sʰ ʌ̹ ŋ
암석	a̠ m sʰ ʌ̹ k̚
면접	m j ɘː n d͡ʑ ʌ̹ p̚
사도행전	sʰ a̠ d o̞ ɦ e̞ ŋ d͡ʑ ʌ̹ n
발표하다	p a̠ ɭ pʰ j o ɦ a̠ d a̠
일곱	i ɭ ɡ o̞ p̚
남자친구	n a̠ m d͡ʑ a̠ t͡ɕʰ i n ɡ u
옮기다	o̞ m ɡ i d a̠
자몽	t͡ɕ a̠ m o̞ ŋ
붉은부리흰죽지	p u ɭ ɡ ɯ n b u ɾ i ʝ i n d͡ʑ u k̚ t͡ɕ͈ i
아쉽다	a̠ ʃʰ ɥ i p̚ t͈ a̠
청소하다	t͡ɕʰ ʌ̹ ŋ sʰ o̞ ɦ a̠ d a̠
유모차	j u m o̞ t͡ɕʰ a̠
핑퐁	pʰ i ŋ pʰ o̞ ŋ
올려놓다	o̞ ɭ ʎ j ʌ̹ n o̞ tʰ a̠
한담	h a̠ n d a̠ m
판단	pʰ a̠ n d a̠ n
거짓	k ɘː d͡ʑ i t̚
대하다	t e̞ː ɦ a̠ d a̠
중개인	t͡ɕ u ŋ ɡ e̞ i n
공황	k o̞ː ŋ β w a̠ ŋ
진열장	t͡ɕ iː ɲ j ʌ̹ ɭ d͡ʑ a̠ ŋ
완전히	w a̠ n d͡ʑ ʌ̹ n ʝ i
표준어	pʰ j o d͡ʑ u n ʌ̹
잦다	t͡ɕ a̠ t̚ t͈ a̠
제의하다	t͡ɕ e̞ ɰ i ɦ a̠ d a̠
조지아어	t͡ɕ o̞ d͡ʑ i a̠ ʌ̹
범고래	p ʌ̹ m ɡ o̞ ɾ e̞
키보드	k ç i b o̞ d ɯ
누두	n u d u
자꾸	t͡ɕ a̠ k͈ u
공격	k o̞ː ŋ ɡ j ʌ̹ k̚
대가	t e̞ː ɡ a̠
근접	k ɯː n d͡ʑ ʌ̹ p̚
딜리	t i ɭ ʎ i
당대	t a̠ ŋ d e̞
부인하다	p uː i n ɦ a̠ d a̠
직장	t͡ɕ i k̚ t͡ɕ͈ a̠ ŋ
게놈	k e̞ n o̞ m
관목	k w a̠ː n m o̞ k̚
이내	iː n e̞
버섯	p ʌ̹ sʰ ʌ̹ t̚
다래	t a̠ ɾ e̞
접근	t͡ɕ ʌ̹ p̚ k͈ ɯ n
개방	k e̞ b a̠ ŋ
활동	ɸ w a̠ ɭ t͈ o̞ ŋ
연설	j ɘː n sʰ ʌ̹ ɭ
한숨	h a̠ n sʰ u m
소환	sʰ o̞ β w a̠ n
대명사	t e̞ m j ʌ̹ ŋ sʰ a̠
큰첨서	k x ɯ n t͡ɕʰ ʌ̹ m sʰ ʌ̹
필통	pʰ i ɭ tʰ o̞ ŋ
여우비	j ʌ̹ u b i
나아가다	n a̠ a̠ ɡ a̠ d a̠
애기박쥐	e̞ ɡ i b a̠ k̚ t͡ɕ͈ ɥ i
풀다	pʰ u ɭ d a̠
미신	m iː ɕʰ i n
구석차기	k u sʰ ʌ̹ k̚ t͡ɕʰ a̠ ɡ i
까치	k͈ a̠ t͡ɕʰ i
덧붙다	t ʌ̹ t̚ p͈ u t̚ t͈ a̠
정적분	t͡ɕ ʌ̹ ŋ d͡ʑ ʌ̹ k̚ p͈ u n
헛방귀	h ʌ̹ t̚ p͈ a̠ ŋ ɡ ɥ i
떠들다	t͈ ɘː d ɯ ɭ d a̠
하이에나	h a̠ i e̞ n a̠
용감하다	j oː ŋ ɡ a̠ m ɦ a̠ d a̠
괴뢰	k w e̞ː ɾ w e̞
사할린	sʰ a̠ ɦ a̠ ɭ ʎ i n
내보내다	n e̞ː b o̞ n e̞ d a̠
목요일	m o̞ ɡ j o i ɭ
파스텔	pʰ a̠ sʰ ɯ tʰ e̞ ɭ
무르다	m u ɾ ɯ d a̠
비뚤어지다	p i t͈ u ɾ ʌ̹ d͡ʑ i d a̠
귀구멍	k ɥ i ɡ u m ʌ̹ ŋ
비누	p i n u
걸신	k ʌ̹ ɭ ɕ͈ i n
차분몫	t͡ɕʰ a̠ b u n m o̞ k̚
공리	k o̞ ŋ n i
전도	t͡ɕ ʌ̹ n d o̞
암호	a̠ː m β o̞
스피커	s͈ ɯ pʰ i kʰ ʌ̹
드러냄표	t ɯ ɾ ʌ̹ n e̞ m pʰ j o
살짝	sʰ a̠ ɭ t͡ɕ͈ a̠ k̚
움짤	u m t͡ɕ͈ a̠ ɭ
전모	t͡ɕ ʌ̹ n m o̞
불편	p u ɭ pʰ j ʌ̹ n
안방	a̠ n b a̠ ŋ
노트북	n o̞ tʰ ɯ b u k̚
기관총	k i ɡ w a̠ n t͡ɕʰ o̞ ŋ
포옹	pʰ o̞ː o̞ ŋ
고바야시박쥐	k o̞ b a̠ j a̠ ɕʰ i b a̠ k̚ t͡ɕ͈ ɥ i
가엾다	k a̠ː j ʌ̹ p̚ t͈ a̠
미로	m iː ɾ o̞
텐트	tʰ e̞ n tʰ ɯ
집게	t͡ɕ i p̚ k͈ e̞
만년	m a̠ː n ɲ j ʌ̹ n
선박	sʰ ʌ̹ n b a̠ k̚
구절	k u d͡ʑ ʌ̹ ɭ
구십	k u ɕʰ i p̚
불쌍놈	p uː ɭ s͈ a̠ ŋ n o̞ m
모국	m o̞ː ɡ u k̚
화분	ɸ w a̠ b u n
비구름	p i ɡ u ɾ ɯ m
해고	h e̞ː ɡ o̞
스웨터	sʰ ɯ w e̞ tʰ ʌ̹
고개	k o̞ ɡ e̞
지불하다	t͡ɕ i b u ɾ ɦ a̠ d a̠
증상	t͡ɕ ɯ ŋ sʰ a̠ ŋ
배송	p e̞ː sʰ o̞ ŋ
캐다	kʰ e̞ː d a̠
방플	p a̠ː ŋ pʰ ɯ ɭ
자그레브	t͡ɕ a̠ ɡ ɯ ɾ e̞ b ɯ
되다	t w e̞ d a̠
철학	t͡ɕʰ ʌ̹ ɾ ɦ a̠ k̚
허물다	h ʌ̹ m u ɭ d a̠
해석자	h e̞ː sʰ ʌ̹ k̚ t͡ɕ͈ a̠
실천	ɕʰ i ɭ t͡ɕʰ ʌ̹ n
베이컨	p e̞ i kʰ ʌ̹ n
자살	t͡ɕ a̠ sʰ a̠ ɭ
클립	k x ɯ ɭ ʎ i p̚
걸리다	k ʌ̹ ɭ ʎ i d a̠
내강	n e̞ː ɡ a̠ ŋ
파라솔	pʰ a̠ ɾ a̠ sʰ o̞ ɭ
사진기	sʰ a̠ d͡ʑ i n ɡ i
서양자두	sʰ ʌ̹ j a̠ ŋ d͡ʑ a̠ d u
와트	w a̠ tʰ ɯ
간체자	k a̠ n t͡ɕʰ e̞ d͡ʑ a̠
빌리다	p i ɭ ʎ i d a̠
조언하다	t͡ɕ o̞ː ʌ̹ n ɦ a̠ d a̠
이다	i d a̠
별도	p j ʌ̹ ɭ t͈ o̞
파악하다	pʰ a̠ a̠ kʰ a̠ d a̠
자취하다	t͡ɕ a̠ː t͡ɕʰ ɥ i ɦ a̠ d a̠
그라프	k ɯ ɾ a̠ pʰ ɯ
전당포	t͡ɕ ɘː n d a̠ ŋ pʰ o̞
후사	ɸʷ uː sʰ a̠
남존여비	n a̠ m d͡ʑ o̞ n ɲ j ʌ̹ b i
기대다	k iː d e̞ d a̠
반가	p a̠ː n ɡ a̠
집박쥐	t͡ɕ i p̚ p͈ a̠ k̚ t͡ɕ͈ ɥ i
흥미진진하다	x ɯː ŋ m i d͡ʑ i n d͡ʑ i n ɦ a̠ d a̠
잠기다	t͡ɕ a̠ m ɡ i d a̠
영웅	j ʌ̹ ŋ u ŋ
타동사	tʰ a̠ d o̞ ŋ sʰ a̠
규율	k j u j u ɭ
지도책	t͡ɕ i d o̞ t͡ɕʰ e̞ k̚
병음	p j ʌ̹ ŋ ɯ m
늑대인간	n ɯ k̚ t͈ e̞ i n ɡ a̠ n
결정화	k j ʌ̹ ɭ t͡ɕ͈ ʌ̹ ŋ β w a̠
교조	k j oː d͡ʑ o̞
난황	n a̠ː n β w a̠ ŋ
백야	p e̞ ɡ j a̠
중국어	t͡ɕ u ŋ ɡ u ɡ ʌ̹
날씬하다	n a̠ ɭ ɕ͈ i n ɦ a̠ d a̠
유독	j uː d o̞ k̚
카바졸	kʰ a̠ b a̠ d͡ʑ o̞ ɭ
염색체	j ɘː m sʰ e̞ k̚ t͡ɕʰ e̞
목발	m o̞ k̚ p͈ a̠ ɭ
히읗	ç i ɯ t̚
쏨땀	s͈ o̞ m t͈ a̠ m
선거하다	sʰ ɘː n ɡ ʌ̹ ɦ a̠ d a̠
재빠르다	t͡ɕ e̞ p͈ a̠ ɾ ɯ d a̠
모교	m o̞ː ɡ j o
벼락	p j ʌ̹ ɾ a̠ k̚
풀무	pʰ u ɭ m u
리어카	ɾ i ʌ̹ kʰ a̠
하늘색	h a̠ n ɯ ɭ s͈ e̞ k̚
벨라루스어	p e̞ ɭ ɭ a̠ ɾ u sʰ ɯ ʌ̹
규률	k j u ɾ j u ɭ
명령	m j ɘː ŋ ɲ j ʌ̹ ŋ
추리닝	t͡ɕʰ u ɾ i n i ŋ
진행하다	t͡ɕ iː n ɦ e̞ ŋ ɦ a̠ d a̠
장모	t͡ɕ a̠ː ŋ m o̞
체적	t͡ɕʰ e̞ d͡ʑ ʌ̹ k̚
혁신	ç j ʌ̹ k ɕ͈ i n
흰죽지수리	ç i n d͡ʑ u k̚ t͡ɕ͈ i sʰ u ɾ i
자판기	t͡ɕ a̠ pʰ a̠ n ɡ i
십삼	ɕʰ i p s͈ a̠ m
달팽이	t a̠ ɭ pʰ e̞ ŋ i
꽃가루	k͈ o̞ t̚ k͈ a̠ ɾ u
이인칭	i i n t͡ɕʰ i ŋ
문화재	m u n β w a̠ d͡ʑ e̞
기후	k i β u
마카오	m a̠ kʰ a̠ o̞
비읍	p i ɯ p̚
그르치다	k ɯ ɾ ɯ t͡ɕʰ i d a̠
실로폰	ɕʰ i ɭ ɭ o̞ pʰ o̞ n
정장	t͡ɕ ɘː ŋ d͡ʑ a̠ ŋ
아니야	a̠ n i j a̠
헬륨	h e̞ ɭ ʎ j u m
넘기다	n ʌ̹ m ɡ i d a̠
웨이터	w e̞ i tʰ ʌ̹
걸레	k ʌ̹ ɭ ɭ e̞
아래	a̠ ɾ e̞
마스터베이션	m a̠ sʰ ɯ tʰ ʌ̹ b e̞ i ɕʰ j ʌ̹ n
총통	t͡ɕʰ o̞ː ŋ tʰ o̞ ŋ
벨로루시	p e̞ ɭ ɭ o̞ ɾ u ɕʰ i
시험하다	ɕʰ i ɦ ʌ̹ m ɦ a̠ d a̠
흑형	x ɯ k ç j ʌ̹ ŋ
시시덕거리다	ɕʰ i ɕʰ i d ʌ̹ k̚ k͈ ʌ̹ ɾ i d a̠
거두다	k ʌ̹ d u d a̠
체조	t͡ɕʰ e̞ d͡ʑ o̞
결합하다	k j ʌ̹ ɾ ɦ a̠ pʰ a̠ d a̠
시꺼멓다	ɕʰ i k͈ ʌ̹ m ʌ̹ tʰ a̠
패전	pʰ e̞ː d͡ʑ ʌ̹ n
분광학	p u n ɡ w a̠ ŋ ɦ a̠ k̚
투쟁	tʰ u d͡ʑ e̞ ŋ
입장	i p̚ t͡ɕ͈ a̠ ŋ
물결	m u ɭ k͈ j ʌ̹ ɭ
나무	n a̠ m u
포함하다	pʰ o̞ ɦ a̠ m ɦ a̠ d a̠
아요	a̠ j o
스럽다	sʰ ɯ ɾ ʌ̹ p̚ t͈ a̠
다리미판	t a̠ ɾ i m i pʰ a̠ n
주의하다	t͡ɕ u ɰ i ɦ a̠ d a̠
접선	t͡ɕ ʌ̹ p s͈ ʌ̹ n
새벽녘	sʰ e̞ b j ʌ̹ ŋ ɲ j ʌ̹ k̚
개새끼	k e̞ː sʰ e̞ k͈ i
해삼	h e̞ː sʰ a̠ m
덕분	t ʌ̹ k̚ p͈ u n
서서히	sʰ ɘː sʰ ʌ̹ ʝ i
탄화	tʰ a̠ː n β w a̠
왕관	w a̠ ŋ ɡ w a̠ n
살리다	sʰ a̠ ɭ ʎ i d a̠
애인	e̞ː i n
거주	k ʌ̹ d͡ʑ u
외국	w e̞ː ɡ u k̚
인간	i n ɡ a̠ n
물에네르기	m u ɾ e̞ n e̞ ɾ ɯ ɡ i
오뎅	o̞ d e̞ ŋ
한국	h a̠ː n ɡ u k̚
인쇄	i n sʰ w e̞
베이비시터	p e̞ i b i ɕʰ i tʰ ʌ̹
크다	k x ɯ d a̠
소말리아	s͈ o̞ m a̠ ɭ ʎ i a̠
시청	ɕʰ iː t͡ɕʰ ʌ̹ ŋ
방울	p a̠ ŋ u ɭ
부통령	p uː tʰ o̞ ŋ ɲ j ʌ̹ ŋ
그을다	k ɯ ɯ ɭ d a̠
십자	ɕʰ i p̚ t͡ɕ͈ a̠
라이터	ɾ a̠ i tʰ ʌ̹
기총	k i t͡ɕʰ o̞ ŋ
야레	j a̠ ɾ e̞
멎다	m ʌ̹ t̚ t͈ a̠
벌금	p ʌ̹ ɭ ɡ ɯ m
디스플레이	t i sʰ ɯ pʰ ɯ ɭ ɭ e̞ i
맘마	m a̠ m m a̠
지우개	t͡ɕ i u ɡ e̞
디스켓	t i sʰ ɯ kʰ e̞ t̚
사막	sʰ a̠ m a̠ k̚
코퓰러	kʰ o̞ pʰ j u ɭ ɭ ʌ̹
틴에이저	tʰ i n e̞ i d͡ʑ ʌ̹
우정	uː d͡ʑ ʌ̹ ŋ
강주걱양태	k a̠ ŋ t͡ɕ͈ u ɡ ʌ̹ ɡ j a̠ ŋ tʰ e̞
천부적	t͡ɕʰ ʌ̹ n b u d͡ʑ ʌ̹ k̚
위험	ɥ i ɦ ʌ̹ m
다리미질	t a̠ ɾ i m i d͡ʑ i ɭ
강당	k a̠ː ŋ d a̠ ŋ
굵다	k uː k̚ t͈ a̠
미륵보살	m i ɾ ɯ k̚ p͈ o̞ sʰ a̠ ɭ
만능	m a̠ n n ɯ ŋ
북빙양	p u k̚ p͈ i ŋ ɲ j a̠ ŋ
호리	ɸʷ o̞ ɾ i
검증	k ɘː m d͡ʑ ɯ ŋ
주장하다	t͡ɕ u d͡ʑ a̠ ŋ ɦ a̠ d a̠
슈퍼맨	ɕʰ j u pʰ ʌ̹ m e̞ n
필수	pʰ i ɭ sʰ u
로조	ɾ o̞ d͡ʑ o̞
우편번호	u pʰ j ʌ̹ n b ʌ̹ n β o̞
영양탕	j ʌ̹ ŋ j a̠ ŋ tʰ a̠ ŋ
코냑	kʰ o̞ ɲ j a̠ k̚
사자고추	sʰ a̠ d͡ʑ a̠ ɡ o̞ t͡ɕʰ u
나소	n a̠ sʰ o̞
쪽발이	t͡ɕ͈ o̞ k̚ p͈ a̠ ɾ i
충청북도	t͡ɕʰ u ŋ t͡ɕʰ ʌ̹ ŋ b u k̚ t͈ o̞
캡슐	kʰ e̞ p ɕ͈ j u ɭ
움직이다	u m d͡ʑ i ɡ i d a̠
포르토프랭스	pʰ o̞ ɾ ɯ tʰ o̞ pʰ ɯ ɾ e̞ ŋ sʰ ɯ
충청남도	t͡ɕʰ u ŋ t͡ɕʰ ʌ̹ ŋ n a̠ m d o̞
생활	sʰ e̞ ŋ β w a̠ ɭ
살림	sʰ a̠ ɭ ʎ i m
필획	pʰ i ɾ β w e̞ k̚
수술	sʰ u sʰ u ɭ
물론입니다	m u ɭ ɭ o̞ n i m n i d a̠
협곡	ç j ʌ̹ p̚ k͈ o̞ k̚
출발	t͡ɕʰ u ɭ b a̠ ɭ
경쟁	k j ɘː ŋ d͡ʑ e̞ ŋ
훌륭하다	ɸʷ u ɭ ʎ j u ŋ ɦ a̠ d a̠
콜롬비아	kʰ o̞ ɭ ɭ o̞ m b i a̠
목수	m o̞ k s͈ u
자녀	t͡ɕ a̠ ɲ j ʌ̹
테러리스트	tʰ e̞ ɾ ʌ̹ ɾ i sʰ ɯ tʰ ɯ
풍자문	pʰ u ŋ d͡ʑ a̠ m u n
빗장뼈	p i t̚ t͡ɕ͈ a̠ ŋ p͈ j ʌ̹
급여	k ɯ b j ʌ̹
안내하다	a̠ n n e̞ ɦ a̠ d a̠
약물	j a̠ ŋ m u ɭ
유튜브	j u tʰ j u b ɯ
똥양인	t͈ o̞ ŋ j a̠ ŋ i n
찧다	t͡ɕ͈ i tʰ a̠
포드고리차	pʰ o̞ d ɯ ɡ o̞ ɾ i t͡ɕʰ a̠
함부로	h a̠ m b u ɾ o̞
에스터	e̞ sʰ ɯ tʰ ʌ̹
패거리	pʰ e̞ ɡ ʌ̹ ɾ i
자매	t͡ɕ a̠ m e̞
구부리다	k u b u ɾ i d a̠
감히	k a̠ː m ʝ i
짝짓다	t͡ɕ͈ a̠ k̚ t͡ɕ͈ i t̚ t͈ a̠
조금	t͡ɕ o̞ ɡ ɯ m
까다	k͈ a̠ d a̠
대프리카	t e̞ pʰ ɯ ɾ i kʰ a̠
빈트후크	p i n tʰ ɯ β u k x ɯ
퀴녹살린	kʰ ɥ i n o̞ k s͈ a̠ ɭ ʎ i n
웃음소리	u sʰ ɯ m s͈ o̞ ɾ i
안되다	a̠ n d w e̞ d a̠
외딸	w e̞ t͈ a̠ ɭ
과장	k w a̠ d͡ʑ a̠ ŋ
최선	t͡ɕʰ w e̞ː sʰ ʌ̹ n
사신	sʰ a̠ː ɕʰ i n
가리키다	k a̠ ɾ i k ç i d a̠
고려말	k o̞ ɾ j ʌ̹ m a̠ ɭ
가없다	k a̠ː ʌ̹ p̚ t͈ a̠
개소겡	k e̞ sʰ o̞ ɡ e̞ ŋ
이달	i d a̠ ɭ
부산	p u sʰ a̠ n
예방	j e̞ː b a̠ ŋ
윷놀이	j uː n n o̞ ɾ i
권투	k w ʌ̹ n tʰ u
해석하다	h e̞ː sʰ ʌ̹ kʰ a̠ d a̠
특성	tʰ ɯ k s͈ ʌ̹ ŋ
데이터	t e̞ i tʰ ʌ̹
등록기	t ɯ ŋ n o̞ k̚ k͈ i
마드리드	m a̠ d ɯ ɾ i d ɯ
되풀이	t w e̞ pʰ u ɾ i
공정하다	k o̞ ŋ d͡ʑ ʌ̹ ŋ ɦ a̠ d a̠
언어	ʌ̹ n ʌ̹
형제자매	ç j ʌ̹ ŋ d͡ʑ e̞ d͡ʑ a̠ m e̞
성적	sʰ ʌ̹ ŋ d͡ʑ ʌ̹ k̚
무조건	m u d͡ʑ o̞ k͈ ʌ̹ n
어족	ɘː d͡ʑ o̞ k̚
조차	t͡ɕ o̞ t͡ɕʰ a̠
예술가	j e̞ː sʰ u ɭ ɡ a̠
언론학자	ʌ̹ ɭ ɭ o̞ n ɦ a̠ k̚ t͡ɕ͈ a̠
비상사태	p iː sʰ a̠ ŋ sʰ a̠ tʰ e̞
과떼말라	k w a̠ t͈ e̞ m a̠ ɭ ɭ a̠
아나테마	a̠ n a̠ tʰ e̞ m a̠
여드레	j ʌ̹ d ɯ ɾ e̞
나선	n a̠ sʰ ʌ̹ n
발휘하다	p a̠ ɾ ɦ ɥ i ɦ a̠ d a̠
어떠하다	ʌ̹ t͈ ʌ̹ ɦ a̠ d a̠
예상되다	j e̞ː sʰ a̠ ŋ d w e̞ d a̠
학회	h a̠ kʰ w e̞
밝다	p a̠ k̚ t͈ a̠
자위	t͡ɕ a̠ ɥ i
조합	t͡ɕ o̞ ɦ a̠ p̚
악담	a̠ k̚ t͈ a̠ m
중국말	t͡ɕ u ŋ ɡ u ŋ m a̠ ɭ
감칠맛	k a̠ː m t͡ɕʰ i ɭ m a̠ t̚
감금	k a̠ m ɡ ɯ m
레닌그라드	ɾ e̞ n i n ɡ ɯ ɾ a̠ d ɯ
룩셈부르크	ɾ u k s͈ e̞ m b u ɾ ɯ k x ɯ
바이오	p a̠ i o̞
처벌	t͡ɕʰ ɘː b ʌ̹ ɭ
일쑤	i ɭ s͈ u
천리마	t͡ɕʰ ʌ̹ ɭ ʎ i m a̠
종달새	t͡ɕ o̞ ŋ d a̠ ɭ sʰ e̞
마침내	m a̠ t͡ɕʰ i m n e̞
반딧불이	p a̠ n d i t̚ p͈ u ɾ i
밤새	p a̠ m s͈ e̞
샘플	sʰ e̞ m pʰ ɯ ɭ
민스크	m i n sʰ ɯ k x ɯ
비엔티안	p i e̞ n tʰ i a̠ n
티셔츠	tʰ i ɕʰ j ʌ̹ t͡ɕʰ ɯ
특별	tʰ ɯ k̚ p͈ j ʌ̹ ɭ
머저리	m ʌ̹ d͡ʑ ʌ̹ ɾ i
잔소리	t͡ɕ a̠ n sʰ o̞ ɾ i
셔터	ɕʰ j ʌ̹ tʰ ʌ̹
고집하다	k o̞ d͡ʑ i pʰ a̠ d a̠
콜롬보	kʰ o̞ ɭ ɭ o̞ m b o̞
낙지	n a̠ k̚ t͡ɕ͈ i
독자	t o̞ k̚ t͡ɕ͈ a̠
형수	ç j ʌ̹ ŋ sʰ u
할퀴다	h a̠ ɭ kʰ ɥ i d a̠
회복하다	ɸ w e̞ b o̞ kʰ a̠ d a̠
꽃봉오리	k͈ o̞ t̚ p͈ o̞ ŋ o̞ ɾ i
수성	sʰ u sʰ ʌ̹ ŋ
안정	a̠ n d͡ʑ ʌ̹ ŋ
활용	ɸ w a̠ ɾ j o ŋ
뒤떨어지다	t ɥ iː t͈ ʌ̹ ɾ ʌ̹ d͡ʑ i d a̠
갈문망둑	k a̠ ɭ m u n m a̠ ŋ d u k̚
범죄	p ɘː m d͡ʑ w e̞
야민정음	j a̠ m i n d͡ʑ ʌ̹ ŋ ɯ m
꿰매다	k͈ w e̞ː m e̞ d a̠
키프로스	k ç i pʰ ɯ ɾ o̞ sʰ ɯ
보다	p o̞ d a̠
흰머리기러기	ç i n m ʌ̹ ɾ i ɡ i ɾ ʌ̹ ɡ i
별일	p j ʌ̹ ɾ i ɭ
남루	n a̠ː m n u
노새	n o̞ sʰ e̞
바륨	p a̠ ɾ j u m
한가위	h a̠ n ɡ a̠ ɥ i
누님	n u n i m
감소	k a̠ː m sʰ o̞
냄새	n e̞ː m sʰ e̞
폭포	pʰ o̞ k̚ pʰ o̞
박동	p a̠ː k̚ t͈ o̞ ŋ
유머	j u m ʌ̹
전화하다	t͡ɕ ʌ̹ n β w a̠ ɦ a̠ d a̠
껍질	k͈ ʌ̹ p̚ t͡ɕ͈ i ɭ
듯하다	t ɯ tʰ a̠ d a̠
하여간	h a̠ j ʌ̹ ɡ a̠ n
마중하다	m a̠ d͡ʑ u ŋ ɦ a̠ d a̠
열정	j ʌ̹ ɭ d͡ʑ ʌ̹ ŋ
암흑	a̠ː m ɣ ɯ k̚
생물학	sʰ e̞ ŋ m u ɾ ɦ a̠ k̚
막걸리	m a̠ k̚ k͈ ʌ̹ ɭ ʎ i
비료	p iː ɾ j o
겉핥다	k ʌ̹ tʰ a̠ ɭ t͈ a̠
사냥	sʰ a̠ ɲ j a̠ ŋ
사회	sʰ a̠ β w e̞
역사적	j ʌ̹ k s͈ a̠ d͡ʑ ʌ̹ k̚
노인	n o̞ː i n
그래도	k ɯ ɾ e̞ d o̞
칠성장어	t͡ɕʰ i ɭ s͈ ʌ̹ ŋ d͡ʑ a̠ ŋ ʌ̹
식료품	ɕʰ i ŋ ɲ j o pʰ u m
노다지	n o̞ d a̠ d͡ʑ i
개월	k e̞ w ʌ̹ ɭ
접골	t͡ɕ ʌ̹ p̚ k͈ o̞ ɭ
보건	p o̞ ɡ ʌ̹ n
명자	m j ʌ̹ ŋ t͡ɕ͈ a̠
침입	t͡ɕʰ iː m i p̚
산달	sʰ a̠ n d a̠ ɭ
나가다	n a̠ ɡ a̠ d a̠
캠페인	kʰ e̞ m pʰ e̞ i n
참고	t͡ɕʰ a̠ m ɡ o̞
국경	k u k̚ k͈ j ʌ̹ ŋ
기름사탕	k i ɾ ɯ m sʰ a̠ tʰ a̠ ŋ
넘치다	n ɘː m t͡ɕʰ i d a̠
소송	sʰ o̞ sʰ o̞ ŋ
샹들리에	ɕʰ j a̠ ŋ d ɯ ɭ ʎ i e̞
해탄	h e̞ tʰ a̠ n
나란히	n a̠ ɾ a̠ n ʝ i
불곰	p u ɭ ɡ o̞ m
직전	t͡ɕ i k̚ t͡ɕ͈ ʌ̹ n
유가증권	j uː ɡ a̠ d͡ʑ ɯ ŋ k͈ w ʌ̹ n
요크셔	j o k x ɯ ɕʰ j ʌ̹
불완전하다	p u ɾ w a̠ n d͡ʑ ʌ̹ n ɦ a̠ d a̠
비율	p iː j u ɭ
제과점	t͡ɕ e̞ː ɡ w a̠ d͡ʑ ʌ̹ m
탄트라	tʰ a̠ n tʰ ɯ ɾ a̠
일고여덟	i ɭ ɡ o̞ j ʌ̹ d ʌ̹ ɭ
마이크로파	m a̠ i k x ɯ ɾ o̞ pʰ a̠
그렇지만	k ɯ ɾ ʌ̹ t͡ɕʰ i m a̠ n
뜻밖	t͈ ɯ t̚ p͈ a̠ k̚
지리학	t͡ɕ i ɾ i ɦ a̠ k̚
그림책	k ɯː ɾ i m t͡ɕʰ e̞ k̚
치즈	t͡ɕʰ i d͡ʑ ɯ
부끄러움	p u k͈ ɯ ɾ ʌ̹ u m
넘어지다	n ʌ̹ m ʌ̹ d͡ʑ i d a̠
달리다	t a̠ ɭ ʎ i d a̠
악대	a̠ k̚ t͈ e̞
과녁	k w a̠ː ɲ j ʌ̹ k̚
발열	p a̠ ɾ j ʌ̹ ɭ
재빨리	t͡ɕ e̞ p͈ a̠ ɭ ʎ i
펭귄	pʰ e̞ ŋ ɡ ɥ i n
등자	t ɯ ŋ d͡ʑ a̠
아첨	a̠ t͡ɕʰ ʌ̹ m
필드	pʰ i ɭ d ɯ
성생활	sʰ ɘː ŋ sʰ e̞ ŋ β w a̠ ɭ
이미	i m i
나누이다	n a̠ n u i d a̠
노고지리	n o̞ ɡ o̞ d͡ʑ i ɾ i
인기	i n k͈ i
강수량	k a̠ː ŋ sʰ u ɾ j a̠ ŋ
기념비	k i ɲ j ʌ̹ m b i
침략자	t͡ɕʰ iː m ɲ j a̠ k̚ t͡ɕ͈ a̠
신청	ɕʰ i n t͡ɕʰ ʌ̹ ŋ
한식	h a̠ n ɕ͈ i k̚
애벌레	e̞ː b ʌ̹ ɭ ɭ e̞
텔레비전	tʰ e̞ ɭ ɭ e̞ b i d͡ʑ ʌ̹ n
코너	kʰ o̞ n ʌ̹
허난	h ʌ̹ n a̠ n
열셋	j ʌ̹ ɭ s͈ e̞ t̚
기쁘다	k i p͈ ɯ d a̠
드물다	t ɯ m u ɭ d a̠
지불	t͡ɕ i b u ɭ
탑파	tʰ a̠ p̚ pʰ a̠
직관	t͡ɕ i k̚ k͈ w a̠ n
북미	p u ŋ m i
오데사	o̞ d e̞ sʰ a̠
국수	k u k s͈ u
군중가요	k u n d͡ʑ u ŋ ɡ a̠ j o
보장하다	p o̞ː d͡ʑ a̠ ŋ ɦ a̠ d a̠
지폐	t͡ɕ i pʰ j e̞
틀림없다	tʰ ɯ ɭ ʎ i m ʌ̹ p̚ t͈ a̠
맞이하다	m a̠ d͡ʑ i ɦ a̠ d a̠
생각나다	sʰ e̞ ŋ ɡ a̠ ŋ n a̠ d a̠
생선회	sʰ e̞ ŋ sʰ ʌ̹ n β w e̞
세종	sʰ e̞ d͡ʑ o̞ ŋ
에스컬레이터	e̞ sʰ ɯ kʰ ʌ̹ ɭ ɭ e̞ i tʰ ʌ̹
근일점	k ɯː n i ɭ t͡ɕ͈ ʌ̹ m
아미노산	a̠ m i n o̞ sʰ a̠ n
두드러지다	t u d ɯ ɾ ʌ̹ d͡ʑ i d a̠
화강암	ɸ w a̠ ɡ a̠ ŋ a̠ m
우주론	u d͡ʑ u ɾ o̞ n
스웨리예	sʰ ɯ w e̞ ɾ i j e̞
창세기	t͡ɕʰ a̠ ŋ sʰ e̞ ɡ i
꺽지	k͈ ʌ̹ k̚ t͡ɕ͈ i
밧줄	p a̠ t̚ t͡ɕ͈ u ɭ
감비아	k a̠ m b i a̠
체크어	t͡ɕʰ e̞ k x ɯ ʌ̹
중대하다	t͡ɕ u ŋ d e̞ ɦ a̠ d a̠
영역	j ʌ̹ ŋ j ʌ̹ k̚
뒤쥐	t ɥ i d͡ʑ ɥ i
신랑	ɕʰ i ɭ ɭ a̠ ŋ
사용자	sʰ a̠ j o ŋ d͡ʑ a̠
백두산	p e̞ k̚ t͈ u sʰ a̠ n
지팡이	t͡ɕ i pʰ a̠ ŋ i
작은두꺼비	t͡ɕ a̠ː ɡ ɯ n d u k͈ ʌ̹ b i
원시	w ɘː n ɕʰ i
다리미	t a̠ ɾ i m i
귀염둥이	k ɥ iː j ʌ̹ m d u ŋ i
견디다	k j ʌ̹ n d i d a̠
브뤼셀	p ɯ ɾ ɥ i sʰ e̞ ɭ
비스켓	p i sʰ ɯ kʰ e̞ t̚
유라시아	j u ɾ a̠ ɕʰ i a̠
부두	p u d u
꼬마	k͈ o̞ m a̠
맛보다	m a̠ t̚ p͈ o̞ d a̠
페놀	pʰ e̞ n o̞ ɭ
월일	w ʌ̹ ɾ i ɭ
릴리스	ɾ i ɭ ʎ i sʰ ɯ
칼파스	kʰ a̠ ɭ pʰ a̠ sʰ ɯ
고리도롱뇽	k o̞ ɾ i d o̞ ɾ o̞ ŋ ɲ j o ŋ
슈트	ɕʰ j u tʰ ɯ
들쇠고래	t ɯ ɭ sʰ w e̞ ɡ o̞ ɾ e̞
자유	t͡ɕ a̠ j u
북방긴수염고래	p u k̚ p͈ a̠ ŋ ɡ i n sʰ u j ʌ̹ m ɡ o̞ ɾ e̞
결장	k j ʌ̹ ɭ t͡ɕ͈ a̠ ŋ
푸나푸티	pʰ u n a̠ pʰ u tʰ i
변변하다	p j ʌ̹ n b j ʌ̹ n ɦ a̠ d a̠
교실	k j oː ɕʰ i ɭ
물냉면	m u ɭ ɭ e̞ ŋ m j ʌ̹ n
섹스하다	s͈ e̞ k s͈ ɯ ɦ a̠ d a̠
월요일	w ʌ̹ ɾ j o i ɭ
털다	tʰ ɘː ɭ d a̠
절반	t͡ɕ ʌ̹ ɭ b a̠ n
분명하다	p u n m j ʌ̹ ŋ ɦ a̠ d a̠
도꾜	t o̞ k͈ j o
둥지	t u ŋ d͡ʑ i
꽃꽂이	k͈ o̞ t̚ k͈ o̞ d͡ʑ i
발견	p a̠ ɭ ɡ j ʌ̹ n
연결되다	j ʌ̹ n ɡ j ʌ̹ ɭ d w e̞ d a̠
위주	ɥ i d͡ʑ u
서양	sʰ ʌ̹ j a̠ ŋ
휴대폰	ç j u d e̞ pʰ o̞ n
나이팅게일	n a̠ i tʰ i ŋ ɡ e̞ i ɭ
인촨	i n t͡ɕʰ w a̠ n
텍스트	tʰ e̞ k s͈ ɯ tʰ ɯ
음가	ɯ m ɡ a̠
비고	p iː ɡ o̞
의혹	ɰ i β o̞ k̚
코트디부아르	kʰ o̞ tʰ ɯ d i b u a̠ ɾ ɯ
치한	t͡ɕʰ i ɦ a̠ n
분명	p u n m j ʌ̹ ŋ
망가니즈	m a̠ ŋ ɡ a̠ n i d͡ʑ ɯ
우주선	uː d͡ʑ u sʰ ʌ̹ n
발레타	p a̠ ɭ ɭ e̞ tʰ a̠
다름슈타튬	t a̠ ɾ ɯ m ɕʰ j u tʰ a̠ tʰ j u m
삼월	sʰ a̠ m w ʌ̹ ɭ
황줄망둑	ɸ w a̠ ŋ d͡ʑ u ɭ m a̠ ŋ d u k̚
유니폼	j u n i pʰ o̞ m
비날론	p i n a̠ ɭ ɭ o̞ n
세르보크로아트어	sʰ e̞ ɾ ɯ b o̞ k x ɯ ɾ o̞ a̠ tʰ ɯ ʌ̹
큰줄납자루	k x ɯ n d͡ʑ u ɭ ɭ a̠ p̚ t͡ɕ͈ a̠ ɾ u
검질	k ʌ̹ m d͡ʑ i ɭ
파렴치하다	pʰ a̠ː ɾ j ʌ̹ m t͡ɕʰ i ɦ a̠ d a̠
간식	k a̠ː n ɕʰ i k̚
산판	sʰ a̠ː n pʰ a̠ n
면도하다	m j ɘː n d o̞ ɦ a̠ d a̠
로사리오	ɾ o̞ sʰ a̠ ɾ i o̞
가락지빵	k a̠ ɾ a̠ k̚ t͡ɕ͈ i p͈ a̠ ŋ
별자리	p j ɘː ɭ d͡ʑ a̠ ɾ i
악덕	a̠ k̚ t͈ ʌ̹ k̚
남극대륙	n a̠ m ɡ ɯ k̚ t͈ e̞ ɾ j u k̚
힙합	ç i pʰ a̠ p̚
병법	p j ʌ̹ ŋ b ʌ̹ p̚
교외	k j oː w e̞
행사	h e̞ ŋ sʰ a̠
희천	ç i t͡ɕʰ ʌ̹ n
브라티슬라바	p ɯ ɾ a̠ tʰ i sʰ ɯ ɭ ɭ a̠ b a̠
염소	j ʌ̹ m sʰ o̞
고프다	k o̞ pʰ ɯ d a̠
마요네즈	m a̠ j o n e̞ d͡ʑ ɯ
예절	j e̞ d͡ʑ ʌ̹ ɭ
아크리딘	a̠ k x ɯ ɾ i d i n
견해	k j ɘː n ɦ e̞
살아오다	sʰ a̠ ɾ a̠ o̞ d a̠
조심스럽다	t͡ɕ o̞ː ɕʰ i m sʰ ɯ ɾ ʌ̹ p̚ t͈ a̠
잿빛개구리매	t͡ɕ e̞ t̚ p͈ i t̚ k͈ e̞ ɡ u ɾ i m e̞
헤아리다	h e̞ː a̠ ɾ i d a̠
화차	ɸ w a̠ː t͡ɕʰ a̠
다투다	t a̠ tʰ u d a̠
육자진언	j u k̚ t͡ɕ͈ a̠ d͡ʑ i n ʌ̹ n
존댓말	t͡ɕ o̞ n d e̞ n m a̠ ɭ
재미없다	t͡ɕ e̞ m i ʌ̹ p̚ t͈ a̠
감탄사	k a̠ m tʰ a̠ n sʰ a̠
축배	t͡ɕʰ u k̚ p͈ e̞
사진사	sʰ a̠ d͡ʑ i n sʰ a̠
비둘기조롱이	p i d u ɭ ɡ i d͡ʑ o̞ ɾ o̞ ŋ i
깜짝	k͈ a̠ m t͡ɕ͈ a̠ k̚
운검	u n ɡ ʌ̹ m
하이퍼링크	h a̠ i pʰ ʌ̹ ɾ i ŋ k x ɯ
게임	k͈ e̞ i m
에티켓	e̞ tʰ i kʰ e̞ t̚
소용	sʰ o̞ː j o ŋ
향신료	ç j a̠ ŋ ɕʰ i n ɲ j o
열리다	j ʌ̹ ɭ ʎ i d a̠
어긋나다	ʌ̹ ɡ ɯ n n a̠ d a̠
얘기하다	j e̞ː ɡ i ɦ a̠ d a̠
후회하다	ɸʷ uː β w e̞ ɦ a̠ d a̠
장애인	t͡ɕ a̠ ŋ e̞ i n
궁극적	k u ŋ ɡ ɯ k̚ t͡ɕ͈ ʌ̹ k̚
짐작하다	t͡ɕ i m d͡ʑ a̠ kʰ a̠ d a̠
조금씩	t͡ɕ o̞ ɡ ɯ m ɕ͈ i k̚
헤이그	h e̞ i ɡ ɯ
퍼지다	pʰ ɘː d͡ʑ i d a̠
도파민	t o̞ pʰ a̠ m i n
철저히	t͡ɕʰ ʌ̹ ɭ t͡ɕ͈ ʌ̹ ʝ i
비평	p iː pʰ j ʌ̹ ŋ
구혼	k u β o̞ n
학년	h a̠ ŋ ɲ j ʌ̹ n
가강수량	k a̠ ɡ a̠ ŋ sʰ u ɾ j a̠ ŋ
참중고기	t͡ɕʰ a̠ m d͡ʑ u ŋ ɡ o̞ ɡ i
믿다	m i t̚ t͈ a̠
환멸	ɸ w a̠ː n m j ʌ̹ ɭ
안녕하세요	a̠ n ɲ j ʌ̹ ŋ ɦ a̠ sʰ e̞ j o
쇠돌고래	sʰ w e̞ d o̞ ɭ ɡ o̞ ɾ e̞
킬로그람	k ç i ɭ ɭ o̞ ɡ ɯ ɾ a̠ m
안내장	a̠ː n n e̞ t͡ɕ͈ a̠ ŋ
책략	t͡ɕʰ e̞ ŋ ɲ j a̠ k̚
질녀	t͡ɕ i ɭ ʎ j ʌ̹
함흥	h a̠ m ɣ ɯ ŋ
계속하다	k j e̞ː sʰ o̞ kʰ a̠ d a̠
작곡가	t͡ɕ a̠ k̚ k͈ o̞ k̚ k͈ a̠
달러	t a̠ ɭ ɭ ʌ̹
하하	h a̠ ɦ a̠
굴비	k u ɭ b i
브로커	p ɯ ɾ o̞ kʰ ʌ̹
얼굴빛	ʌ̹ ɭ ɡ u ɭ p͈ i t̚
감정	k a̠ː m d͡ʑ ʌ̹ ŋ
내다	n e̞ː d a̠
다각형	t a̠ ɡ a̠ k ç j ʌ̹ ŋ
속자	sʰ o̞ k̚ t͡ɕ͈ a̠
창고	t͡ɕʰ a̠ ŋ k͈ o̞
가닛	k a̠ n i t̚
랩톱	ɾ e̞ p̚ tʰ o̞ p̚
분묘	p u n m j o
그다음	k ɯ d a̠ ɯ m
테스트	tʰ e̞ sʰ ɯ tʰ ɯ
크로아티아어	k x ɯ ɾ o̞ a̠ tʰ i a̠ ʌ̹
콩나물	kʰ o̞ ŋ n a̠ m u ɭ
군국주의	k u n ɡ u k̚ t͡ɕ͈ u ɰ i
소스	sʰ o̞ sʰ ɯ
화나다	ɸ w a̠ː n a̠ d a̠
현미	ç j ʌ̹ n m i
수식어	sʰ u ɕʰ i ɡ ʌ̹
달려가다	t a̠ ɭ ʎ j ʌ̹ ɡ a̠ d a̠
시나브로	ɕʰ i n a̠ b ɯ ɾ o̞
옥색	o̞ k s͈ e̞ k̚
스쿠터	sʰ ɯ kʰ u tʰ ʌ̹
아쟁	a̠ d͡ʑ e̞ ŋ
로맨스	ɾ o̞ m e̞ n sʰ ɯ
미생물	m i sʰ e̞ ŋ m u ɭ
탁치	tʰ a̠ k̚ t͡ɕʰ i
주저앉다	t͡ɕ u d͡ʑ ʌ̹ a̠ n t͈ a̠
야운데	j a̠ u n d e̞
가야금	k a̠ j a̠ ɡ ɯ m
채소밭	t͡ɕʰ e̞ː sʰ o̞ b a̠ t̚
점검	t͡ɕ ʌ̹ m ɡ ʌ̹ m
알밥	a̠ ɭ b a̠ p̚
승용차	sʰ ɯ ŋ j o ŋ t͡ɕʰ a̠
함부르크	h a̠ m b u ɾ ɯ k x ɯ
담황	t a̠ː m β w a̠ ŋ
랴오닝	ɾ j a̠ o̞ n i ŋ
헤매다	h e̞ m e̞ d a̠
불쌍하다	p u ɭ s͈ a̠ ŋ ɦ a̠ d a̠
주요하다	t͡ɕ u j o ɦ a̠ d a̠
말차	m a̠ ɭ t͡ɕʰ a̠
암컷	a̠ m kʰ ʌ̹ t̚
지원하다	t͡ɕ i w ʌ̹ n ɦ a̠ d a̠
교장	k j oː d͡ʑ a̠ ŋ
근질근질하다	k ɯ n d͡ʑ i ɭ ɡ ɯ n d͡ʑ i ɾ ɦ a̠ d a̠
집사람	t͡ɕ i p s͈ a̠ ɾ a̠ m
머그잔	m ʌ̹ ɡ ɯ d͡ʑ a̠ n
홍차	ɸʷ o̞ ŋ t͡ɕʰ a̠
프랑스빵	pʰ ɯ ɾ a̠ ŋ sʰ ɯ p͈ a̠ ŋ
변압기	p j ʌ̹ n a̠ p̚ k͈ i
제탄	t͡ɕ e̞ː tʰ a̠ n
만세	m a̠ː n sʰ e̞
붕소	p u ŋ sʰ o̞
망명	m a̠ ŋ m j ʌ̹ ŋ
가정법	k a̠ː d͡ʑ ʌ̹ ŋ p͈ ʌ̹ p̚
파운데이션	pʰ a̠ u n d e̞ i ɕʰ j ʌ̹ n
말라깽이	m a̠ ɭ ɭ a̠ k͈ e̞ ŋ i
귀엣말	k ɥ i e̞ n m a̠ ɭ
핸드백	h e̞ n d ɯ b e̞ k̚
시카고	ɕʰ i kʰ a̠ ɡ o̞
한자어	h a̠ː n t͡ɕ͈ a̠ ʌ̹
연출	j ɘː n t͡ɕʰ u ɭ
광명성절	k w a̠ ŋ m j ʌ̹ ŋ sʰ ʌ̹ ŋ d͡ʑ ʌ̹ ɭ
멋지다	m ʌ̹ t̚ t͡ɕ͈ i d a̠
결정	k j ʌ̹ ɭ t͡ɕ͈ ʌ̹ ŋ
기똥차다	k i t͈ o̞ ŋ t͡ɕʰ a̠ d a̠
생식	sʰ e̞ ŋ ɕʰ i k̚
착각	t͡ɕʰ a̠ k̚ k͈ a̠ k̚
갇히다	k a̠ tʰ i d a̠
페난트렌	pʰ e̞ n a̠ n tʰ ɯ ɾ e̞ n
간쑤	k a̠ n s͈ u
두꺼비	t u k͈ ʌ̹ b i
맞은편	m a̠ d͡ʑ ɯ n pʰ j ʌ̹ n
참여하다	t͡ɕʰ a̠ m j ʌ̹ ɦ a̠ d a̠
엄마	ʌ̹ m m a̠
우려	u ɾ j ʌ̹
모터	m o̞ tʰ ʌ̹
키릴	k ç i ɾ i ɭ
낙하산	n a̠ kʰ a̠ sʰ a̠ n
지껄이다	t͡ɕ i k͈ ʌ̹ ɾ i d a̠
구약성경	k u j a̠ k s͈ ʌ̹ ŋ ɡ j ʌ̹ ŋ
가따까나	k a̠ t͈ a̠ k͈ a̠ n a̠
가문	k a̠ m u n
짝사랑	t͡ɕ͈ a̠ k s͈ a̠ ɾ a̠ ŋ
책임지다	t͡ɕʰ e̞ ɡ i m d͡ʑ i d a̠
이소시아니드	i sʰ o̞ ɕʰ i a̠ n i d ɯ
감마	k a̠ m m a̠
메히꼬	m e̞ ʝ i k͈ o̞
불꽃	p u ɭ k͈ o̞ t̚
사냥꾼	sʰ a̠ ɲ j a̠ ŋ k͈ u n
위성	ɥ i sʰ ʌ̹ ŋ
반장	p a̠ n d͡ʑ a̠ ŋ
나서다	n a̠ sʰ ʌ̹ d a̠
네모	n e̞ː m o̞
퇴근	tʰ w e̞ː ɡ ɯ n
곰쥐	k o̞ː m d͡ʑ ɥ i
감사합니다	k a̠ː m sʰ a̠ ɦ a̠ m n i d a̠
물수리	m u ɭ s͈ u ɾ i
진행되다	t͡ɕ iː n ɦ e̞ ŋ d w e̞ d a̠
왕새매	w a̠ ŋ sʰ e̞ m e̞
조선옷	t͡ɕ o̞ sʰ ʌ̹ n o̞ t̚
의식	ɰ iː ɕʰ i k̚
드럼	t ɯ ɾ ʌ̹ m
얼룩새코미꾸리	ʌ̹ ɭ ɭ u k s͈ e̞ kʰ o̞ m i k͈ u ɾ i
타이머	tʰ a̠ i m ʌ̹
탐험가	tʰ a̠ m ɦ ʌ̹ m ɡ a̠
비빔밥	p i b i m p͈ a̠ p̚
편찮으시다	pʰ j ʌ̹ n t͡ɕʰ a̠ n ɯ ɕʰ i d a̠
정보	t͡ɕ ʌ̹ ŋ b o̞
태양계의	tʰ e̞ j a̠ ŋ ɡ j e̞ ɰ i
망아지	m a̠ ŋ a̠ d͡ʑ i
소화전	sʰ o̞ β w a̠ d͡ʑ ʌ̹ n
대응하다	t e̞ː ɯ ŋ ɦ a̠ d a̠
누에	n u e̞
매출	m e̞ː t͡ɕʰ u ɭ
나침반	n a̠ t͡ɕʰ i m b a̠ n
나무껍질	n a̠ m u k͈ ʌ̹ p̚ t͡ɕ͈ i ɭ
과학적	k w a̠ ɦ a̠ k̚ t͡ɕ͈ ʌ̹ k̚
네발가락도롱뇽	n e̞ː b a̠ ɭ k͈ a̠ ɾ a̠ k̚ t͈ o̞ ɾ o̞ ŋ ɲ j o ŋ
영사관	j ʌ̹ ŋ sʰ a̠ ɡ w a̠ n
자동판매기	t͡ɕ a̠ d o̞ ŋ pʰ a̠ n m e̞ ɡ i
따사롭다	t͈ a̠ sʰ a̠ ɾ o̞ p̚ t͈ a̠
한국어	h a̠ː n ɡ u ɡ ʌ̹
매독	m e̞ d o̞ k̚
척량	t͡ɕʰ ʌ̹ ŋ ɲ j a̠ ŋ
수조	sʰ u d͡ʑ o̞
액수	e̞ k s͈ u
말갛다	m a̠ː ɭ ɡ a̠ tʰ a̠
사실상	sʰ a̠ː ɕʰ i ɭ s͈ a̠ ŋ
강사	k a̠ː ŋ sʰ a̠
아프가니스탄	a̠ pʰ ɯ ɡ a̠ n i sʰ ɯ tʰ a̠ n
정기	t͡ɕ ɘː ŋ ɡ i
깁다	k iː p̚ t͈ a̠
템플렛	tʰ e̞ m pʰ ɯ ɭ ɭ e̞ t̚
미술	m iː sʰ u ɭ
형광등	ç j ʌ̹ ŋ ɡ w a̠ ŋ d ɯ ŋ
베니스	p e̞ n i sʰ ɯ
팔라우	pʰ a̠ ɭ ɭ a̠ u
비소	p i sʰ o̞
인감	i n ɡ a̠ m
가타카나	k a̠ tʰ a̠ kʰ a̠ n a̠
조이스틱	t͡ɕ o̞ i sʰ ɯ tʰ i k̚
위선	w i s ə n
담백	t a̠ m b e̞ k̚
권총	k w ɘː n t͡ɕʰ o̞ ŋ
기침하다	k i t͡ɕʰ i m ɦ a̠ d a̠
풀네임	pʰ u ɭ ɭ e̞ i m
바다꿩	p a̠ d a̠ k͈ w ʌ̹ ŋ
줄박이돌고래	t͡ɕ u ɭ b a̠ ɡ i d o̞ ɭ ɡ o̞ ɾ e̞
털어놓다	tʰ ʌ̹ ɾ ʌ̹ n o̞ tʰ a̠
방콕	p a̠ ŋ kʰ o̞ k̚
직기	t͡ɕ i k̚ k͈ i
설날	sʰ ɘː ɭ ɭ a̠ ɭ
시조새	ɕʰ iː d͡ʑ o̞ sʰ e̞
아줄렌	a̠ d͡ʑ u ɭ ɭ e̞ n
지질	t͡ɕ i d͡ʑ i ɭ
구마모또	k u m a̠ m o̞ t͈ o̞
평창	pʰ j ʌ̹ ŋ t͡ɕʰ a̠ ŋ
고모부	k o̞ m o̞ b u
침술	t͡ɕʰ i m sʰ u ɭ
붓다	p uː t̚ t͈ a̠
르네상스	ɾ ɯ n e̞ sʰ a̠ ŋ sʰ ɯ
진원지	t͡ɕ i n w ʌ̹ n d͡ʑ i
궤도	k w e̞ː d o̞
벤치	p e̞ n t͡ɕʰ i
고요하다	k o̞ j o ɦ a̠ d a̠
에모지	e̞ m o̞ d͡ʑ i
고집불통	k o̞ d͡ʑ i p̚ p͈ u ɭ tʰ o̞ ŋ
획득하다	ɸ w e̞ k̚ t͈ ɯ kʰ a̠ d a̠
파친코	pʰ a̠ t͡ɕʰ i n kʰ o̞
엽록체	j ʌ̹ m n o̞ k̚ t͡ɕʰ e̞
하게체	h a̠ ɡ e̞ t͡ɕʰ e̞
복싱	p o̞ k ɕ͈ i ŋ
뜨거워지다	t͈ ɯ ɡ ʌ̹ w ʌ̹ d͡ʑ i d a̠
부전자전	p u d͡ʑ ʌ̹ n d͡ʑ a̠ d͡ʑ ʌ̹ n
접전	t͡ɕ ʌ̹ p̚ t͡ɕ͈ ʌ̹ n
올챙이	o̞ ɭ t͡ɕʰ e̞ ŋ i
불리다	p u ɭ ʎ i d a̠
군단	k u n d a̠ n
반열반	p a̠ ɲ j ʌ̹ ɭ b a̠ n
돌아오다	t o̞ ɾ a̠ o̞ d a̠
열아홉	j ʌ̹ ɾ a̠ β o̞ p̚
아이스	a̠ i sʰ ɯ
조례	t͡ɕ o̞ ɾ j e̞
콘스탄티노폴리스	kʰ o̞ n sʰ ɯ tʰ a̠ n tʰ i n o̞ pʰ o̞ ɭ ʎ i sʰ ɯ
귀밑털	k ɥ i m i t̚ tʰ ʌ̹ ɭ
브라질	p ɯ ɾ a̠ d͡ʑ i ɭ
실례하다	ɕʰ i ɭ ʎ j e̞ ɦ a̠ d a̠
여친	j ʌ̹ t͡ɕʰ i n
십일월	ɕʰ i b i ɾ w ʌ̹ ɭ
끄집다	k͈ ɯː d͡ʑ i p̚ t͈ a̠
시중	ɕʰ iː d͡ʑ u ŋ
머뭇거리다	m ʌ̹ m u t̚ k͈ ʌ̹ ɾ i d a̠
소유물	sʰ o̞ː j u m u ɭ
망연하다	m a̠ ŋ j ʌ̹ n ɦ a̠ d a̠
신교도	ɕʰ i n ɡ j o d o̞
흘러나오다	x ɯ ɭ ɭ ʌ̹ n a̠ o̞ d a̠
관계어	k w a̠ n ɡ j e̞ ʌ̹
관광객	k w a̠ n ɡ w a̠ ŋ ɡ e̞ k̚
단계	t a̠ n ɡ j e̞
저급	t͡ɕ ɘː ɡ ɯ p̚
숙녀	sʰ u ŋ ɲ j ʌ̹
성가	sʰ ɘː ŋ ɡ a̠
소유하다	sʰ o̞ː j u ɦ a̠ d a̠
니은	n i ɯ n
정욕	t͡ɕ ʌ̹ ŋ j o k̚
이쪽	i t͡ɕ͈ o̞ k̚
빠듯하다	p͈ a̠ d ɯ tʰ a̠ d a̠
홍진	ɸʷ o̞ ŋ d͡ʑ i n
미륵	m i ɾ ɯ k̚
증정	t͡ɕ ɯ ŋ d͡ʑ ʌ̹ ŋ
만경대	m a̠ː n ɡ j ʌ̹ ŋ d e̞
기자	k i d͡ʑ a̠
머리통	m ʌ̹ ɾ i tʰ o̞ ŋ
기타	k i tʰ a̠
담그다	t a̠ m ɡ ɯ d a̠
참주	t͡ɕʰ a̠ː m d͡ʑ u
대리석	t e̞ː ɾ i sʰ ʌ̹ k̚
통증	tʰ o̞ː ŋ d͡ʑ ɯ ŋ
황오리	ɸ w a̠ ŋ o̞ ɾ i
세계적	sʰ e̞ː ɡ j e̞ d͡ʑ ʌ̹ k̚
부드럽다	p u d ɯ ɾ ʌ̹ p̚ t͈ a̠
나물	n a̠ m u ɭ
동작	t o̞ː ŋ d͡ʑ a̠ k̚
빨강	p͈ a̠ ɭ ɡ a̠ ŋ
디스코	t i sʰ ɯ kʰ o̞
파충	pʰ a̠ t͡ɕʰ u ŋ
상념	sʰ a̠ː ŋ ɲ j ʌ̹ m
골탄	k o̞ ɭ tʰ a̠ n
아스타나	a̠ sʰ ɯ tʰ a̠ n a̠
정조대	t͡ɕ ʌ̹ ŋ d͡ʑ o̞ d e̞
립스틱	ɾ i p s͈ ɯ tʰ i k̚
김치찌개	k i m t͡ɕʰ i t͡ɕ͈ i ɡ e̞
명주	m j ʌ̹ ŋ d͡ʑ u
모음조화	m o̞ ɯ m d͡ʑ o̞ β w a̠
참사	t͡ɕʰ a̠ m sʰ a̠
밝히다	p a̠ ɭ k ç i d a̠
형성하다	ç j ʌ̹ ŋ sʰ ʌ̹ ŋ ɦ a̠ d a̠
두세	t u sʰ e̞
평야	pʰ j ʌ̹ ŋ j a̠
서양배	sʰ ʌ̹ j a̠ ŋ b e̞
사냥하다	sʰ a̠ ɲ j a̠ ŋ ɦ a̠ d a̠
일자리	iː ɭ d͡ʑ a̠ ɾ i
비행기	p i ɦ e̞ ŋ ɡ i
군인	k u n i n
스커트	sʰ ɯ kʰ ʌ̹ tʰ ɯ
궁핍	k u ŋ pʰ i p̚
전위	t͡ɕ ʌ̹ n ɥ i
다가오다	t a̠ ɡ a̠ o̞ d a̠
발표되다	p a̠ ɭ pʰ j o d w e̞ d a̠
가벌	k a̠ b ʌ̹ ɭ
고추자지	k o̞ t͡ɕʰ u d͡ʑ a̠ d͡ʑ i
할아버지	h a̠ ɾ a̠ b ʌ̹ d͡ʑ i
열다	j ɘː ɭ d a̠
하북	h a̠ b u k̚
기법	k i p͈ ʌ̹ p̚
미어캣	m i ʌ̹ kʰ e̞ t̚
핀란드	pʰ i ɭ ɭ a̠ n d ɯ
부정적분	p u d͡ʑ ʌ̹ ŋ d͡ʑ ʌ̹ k̚ p͈ u n
요한	j o ɦ a̠ n
외출하다	w e̞ː t͡ɕʰ u ɾ ɦ a̠ d a̠
수도사	sʰ u d o̞ sʰ a̠
드디어	t ɯ d i ʌ̹
뚜쟁이	t͈ u d͡ʑ e̞ ŋ i
물다	m u ɭ d a̠
회답	ɸ w e̞ d a̠ p̚
입학	i pʰ a̠ k̚
카메룬	kʰ a̠ m e̞ ɾ u n
간선도로	k a̠ n sʰ ʌ̹ n d o̞ ɾ o̞
특수	tʰ ɯ k s͈ u
팔미트산	pʰ a̠ ɭ m i tʰ ɯ sʰ a̠ n
메일	m e̞ i ɭ
서버	s͈ ʌ̹ b ʌ̹
다정하다	t a̠ d͡ʑ ʌ̹ ŋ ɦ a̠ d a̠
여객	j ʌ̹ ɡ e̞ k̚
아레스	a̠ ɾ e̞ sʰ ɯ
외부	w e̞ː b u
시작되다	ɕʰ iː d͡ʑ a̠ k̚ t͈ w e̞ d a̠
완료	w a̠ ɭ ʎ j o
자업자득	t͡ɕ a̠ ʌ̹ p̚ t͡ɕ͈ a̠ d ɯ k̚
네댓	n e̞ː d e̞ t̚
그리스	k ɯ ɾ i sʰ ɯ
등유	t ɯ ŋ j u
레일	ɾ e̞ i ɭ
돌고래	t o̞ ɭ ɡ o̞ ɾ e̞
해발	h e̞ː b a̠ ɭ
전문화	t͡ɕ ʌ̹ n m u n β w a̠
방귀뀌다	p a̠ ŋ ɡ ɥ i k͈ ɥ i d a̠
서고	sʰ ʌ̹ ɡ o̞
고생물학	k o̞ sʰ e̞ ŋ m u ɾ ɦ a̠ k̚
노년	n o̞ː ɲ j ʌ̹ n
주무르다	t͡ɕ u m u ɾ ɯ d a̠
평범하다	pʰ j ʌ̹ ŋ b ʌ̹ m ɦ a̠ d a̠
지구본	t͡ɕ i ɡ u b o̞ n
ㅇㄱㄹㅇ	i ɡ ʌ̹ ɾ e̞ a̠ ɭ
삽입곡	sʰ a̠ b i p̚ k͈ o̞ k̚
지난해	t͡ɕ i n a̠ n ɦ e̞
투숙하다	tʰ u sʰ u kʰ a̠ d a̠
청개구리	t͡ɕʰ ʌ̹ ŋ ɡ e̞ ɡ u ɾ i
쑥갓	s͈ u k̚ k͈ a̠ t̚
부족	p u d͡ʑ o̞ k̚
북극곰	p u k̚ k͈ ɯ k̚ k͈ o̞ m
원자	w ʌ̹ n d͡ʑ a̠
담백하다	t a̠ m b e̞ kʰ a̠ d a̠
부탁하다	p uː tʰ a̠ kʰ a̠ d a̠
홍역	ɸʷ o̞ ŋ j ʌ̹ k̚
견습생	k j ʌ̹ n sʰ ɯ p s͈ e̞ ŋ
파트타임	pʰ a̠ tʰ ɯ tʰ a̠ i m
슈퍼	ɕʰ j u pʰ ʌ̹
파두츠	pʰ a̠ d u t͡ɕʰ ɯ
타입	tʰ a̠ i p̚
복사기	p o̞ k s͈ a̠ ɡ i
해동	h e̞ː d o̞ ŋ
확대하다	ɸ w a̠ k̚ t͈ e̞ ɦ a̠ d a̠
유용	j uː j o ŋ
타자하다	tʰ a̠ː d͡ʑ a̠ ɦ a̠ d a̠
케냐	kʰ e̞ ɲ j a̠
여과	j ɘː ɡ w a̠
육십	j u k ɕ͈ i p̚
대학교	t e̞ː ɦ a̠ k̚ k͈ j o
호모포비아	ɸʷ o̞ m o̞ pʰ o̞ b i a̠
외국인	w e̞ ɡ u ɡ i n
하즈	h a̠ d͡ʑ ɯ
끌다	k͈ ɯː ɭ d a̠
큰낫	k x ɯ n n a̠ t̚
산살바도르	sʰ a̠ n sʰ a̠ ɭ b a̠ d o̞ ɾ ɯ
초상	t͡ɕʰ o̞ sʰ a̠ ŋ
기대하다	k i d e̞ ɦ a̠ d a̠
부러지다	p u ɾ ʌ̹ d͡ʑ i d a̠
머구리	m ʌ̹ ɡ u ɾ i
그래서	k ɯ ɾ e̞ sʰ ʌ̹
스모그	sʰ ɯ m o̞ ɡ ɯ
작용	t͡ɕ a̠ ɡ j o ŋ
자정	t͡ɕ a̠ d͡ʑ ʌ̹ ŋ
금방	k ɯ m b a̠ ŋ
롭다	ɾ o̞ p̚ t͈ a̠
큰볏말뚝망둥어	k x ɯ n b j ʌ̹ n m a̠ ɭ t͈ u ŋ m a̠ ŋ d u ŋ ʌ̹
앉다	a̠ n t͈ a̠
자본	t͡ɕ a̠ b o̞ n
그렇게	k ɯ ɾ ʌ̹ kʰ e̞
아시아	a̠ ɕʰ i a̠
습도	sʰ ɯ p̚ t͈ o̞
태양절	tʰ e̞ j a̠ ŋ d͡ʑ ʌ̹ ɭ
부패	p u pʰ e̞
공산주의	k o̞ː ŋ sʰ a̠ n d͡ʑ u ɰ i
몽둥이	m o̞ ŋ d u ŋ i
떠나다	t͈ ʌ̹ n a̠ d a̠
입구	i p̚ k͈ u
장마	t͡ɕ a̠ ŋ m a̠
도롱뇽	t o̞ ɾ o̞ ŋ ɲ j o ŋ
천둥	t͡ɕʰ ʌ̹ n d u ŋ
이란	i ɾ a̠ n
가공하다	k a̠ ɡ o̞ ŋ ɦ a̠ d a̠
퇴근하다	tʰ w e̞ː ɡ ɯ n ɦ a̠ d a̠
목청껏	m o̞ k̚ t͡ɕʰ ʌ̹ ŋ k͈ ʌ̹ t̚
건강히	k ɘː n ɡ a̠ ŋ ʝ i
페닐기	pʰ e̞ n i ɭ ɡ i
곤충학	k o̞ n t͡ɕʰ u ŋ ɦ a̠ k̚
귓불	k ɥ i t̚ p͈ u ɭ
농부	n o̞ ŋ b u
앨리게이터	e̞ ɭ ʎ i ɡ e̞ i tʰ ʌ̹
상상하다	sʰ a̠ː ŋ sʰ a̠ ŋ ɦ a̠ d a̠
로맨틱하다	ɾ o̞ m e̞ n tʰ i kʰ a̠ d a̠
잡지	t͡ɕ a̠ p̚ t͡ɕ͈ i
함묵증	h a̠ m m u k̚ t͡ɕ͈ ɯ ŋ
장갑	t͡ɕ a̠ː ŋ ɡ a̠ p̚
체중	t͡ɕʰ e̞ d͡ʑ u ŋ
숙이다	sʰ u ɡ i d a̠
주위	t͡ɕ u ɥ i
미분몫	m i b u n m o̞ k̚
평성	pʰ j ʌ̹ ŋ sʰ ʌ̹ ŋ
와셔	w a̠ ɕʰ j ʌ̹
부여하다	p uː j ʌ̹ ɦ a̠ d a̠
공병	k o̞ ŋ b j ʌ̹ ŋ
바스테르	p a̠ sʰ ɯ tʰ e̞ ɾ ɯ
영하	j ʌ̹ ŋ ɦ a̠
나트륨	n a̠ tʰ ɯ ɾ j u m
풍수	pʰ u ŋ sʰ u
걸핏걸핏	k ʌ̹ ɭ pʰ i t̚ k͈ ʌ̹ ɭ pʰ i t̚
성남	sʰ ʌ̹ ŋ n a̠ m
건너오다	k ɘː n n ʌ̹ o̞ d a̠
해질녘	h e̞ d͡ʑ i ɭ ʎ j ʌ̹ k̚
으스러뜨리다	ɯ sʰ ɯ ɾ ʌ̹ t͈ ɯ ɾ i d a̠
사탕수수	sʰ a̠ tʰ a̠ ŋ sʰ u sʰ u
소년	sʰ o̞ː ɲ j ʌ̹ n
심정	ɕʰ i m d͡ʑ ʌ̹ ŋ
풀망둑	pʰ u ɭ m a̠ ŋ d u k̚
사춘기	sʰ a̠ t͡ɕʰ u n ɡ i
날개	n a̠ ɭ ɡ e̞
멜로디	m e̞ ɭ ɭ o̞ d i
이빨	i p͈ a̠ ɭ
전라남도	t͡ɕ ʌ̹ ɭ ɭ a̠ n a̠ m d o̞
아우구스투스	a̠ u ɡ u sʰ ɯ tʰ u sʰ ɯ
클리닝	k x ɯ ɭ ʎ i n i ŋ
깡패	k͈ a̠ ŋ pʰ e̞
버마어	p ʌ̹ m a̠ ʌ̹
소나타	sʰ o̞ n a̠ tʰ a̠
자유주의	t͡ɕ a̠ j u d͡ʑ u ɰ i
원통	w ʌ̹ n tʰ o̞ ŋ
하이픈	h a̠ i pʰ ɯ n
후배	ɸʷ uː b e̞
음렬	ɯ m ɲ j ʌ̹ ɭ
뙤약볕	t͈ w e̞ j a̠ k̚ p͈ j ʌ̹ t̚
친절	t͡ɕʰ i n d͡ʑ ʌ̹ ɭ
상상	sʰ a̠ː ŋ sʰ a̠ ŋ
식당	ɕʰ i k̚ t͈ a̠ ŋ
희생양	ç i sʰ e̞ ŋ j a̠ ŋ
비싸다	p i s͈ a̠ d a̠
호남	ɸʷ o̞ n a̠ m
금고	k ɯ m ɡ o̞
훈련	ɸʷ uː ɭ ʎ j ʌ̹ n
수도권	sʰ u d o̞ k͈ w ʌ̹ n
총명	t͡ɕʰ o̞ ŋ m j ʌ̹ ŋ
전주	t͡ɕ ʌ̹ n d͡ʑ u
브리지	p ɯ ɾ i d͡ʑ i
농업	n o̞ ŋ ʌ̹ p̚
고속	k o̞ sʰ o̞ k̚
관자놀이	k w a̠ n d͡ʑ a̠ n o̞ ɾ i
자다	t͡ɕ a̠ d a̠
모토	m o̞ tʰ o̞
흰점복	ç i n d͡ʑ ʌ̹ m b o̞ k̚
뉴트리아	ɲ j u tʰ ɯ ɾ i a̠
잠비아	t͡ɕ a̠ m b i a̠
아메리슘	a̠ m e̞ ɾ i ɕʰ j u m
과일	k w a̠ː i ɭ
설문지	sʰ ʌ̹ ɭ m u n d͡ʑ i
탈의실	tʰ a̠ ɾ ɰ i ɕʰ i ɭ
가자	k a̠ d͡ʑ a̠
음침하다	ɯ m t͡ɕʰ i m ɦ a̠ d a̠
객기	k e̞ k̚ k͈ i
지푸라기	t͡ɕ i pʰ u ɾ a̠ ɡ i
성체성사	sʰ ɘː ŋ t͡ɕʰ e̞ sʰ ʌ̹ ŋ sʰ a̠
언제	ɘː n d͡ʑ e̞
무대	m uː d e̞
흩다	x ɯ t̚ t͈ a̠
겁먹다	k ʌ̹ m m ʌ̹ k̚ t͈ a̠
모치망둑	m o̞ t͡ɕʰ i m a̠ ŋ d u k̚
일등	i ɭ t͈ ɯ ŋ
확보	ɸ w a̠ k̚ p͈ o̞
계승	k j e̞ sʰ ɯ ŋ
직접	t͡ɕ i k̚ t͡ɕ͈ ʌ̹ p̚
보살	p o̞ sʰ a̠ ɭ
함경	h a̠ m ɡ j ʌ̹ ŋ
모사	m o̞ sʰ a̠
벼락부자	p j ʌ̹ ɾ a̠ k̚ p͈ u d͡ʑ a̠
흰쌀	ç i n s͈ a̠ ɭ
입장료	i p̚ t͡ɕ͈ a̠ ŋ ɲ j o
싸울아비	s͈ a̠ u ɾ a̠ b i
킨샤사	k ç i n ɕʰ j a̠ sʰ a̠
안테나	a̠ n tʰ e̞ n a̠
보물	p o̞ː m u ɭ
유기체	j uː ɡ i t͡ɕʰ e̞
가시나	k a̠ ɕʰ i n a̠
놀이터	n o̞ ɾ i tʰ ʌ̹
걱정	k ʌ̹ k̚ t͡ɕ͈ ʌ̹ ŋ
뾰족하다	p͈ j o d͡ʑ o̞ kʰ a̠ d a̠
자라다	t͡ɕ a̠ ɾ a̠ d a̠
민주화	m i n d͡ʑ u β w a̠
참종개	t͡ɕʰ a̠ m d͡ʑ o̞ ŋ ɡ e̞
경마	k j ɘː ŋ m a̠
베닌	p e̞ n i n
어색	ɘː sʰ e̞ k̚
알라	a̠ ɭ ɭ a̠
대량	t e̞ː ɾ j a̠ ŋ
블라디미르	p ɯ ɭ ɭ a̠ d i m i ɾ ɯ
세계관	sʰ e̞ː ɡ j e̞ ɡ w a̠ n
원자폭탄	w ʌ̹ n d͡ʑ a̠ pʰ o̞ k̚ tʰ a̠ n
엘리베이터	e̞ ɭ ʎ i b e̞ i tʰ ʌ̹
고체	k o̞ t͡ɕʰ e̞
범재신론	p ʌ̹ m d͡ʑ e̞ ɕʰ i ɭ ɭ o̞ n
산양	sʰ a̠ ɲ j a̠ ŋ
빼다	p͈ e̞ː d a̠
세력	sʰ e̞ ɾ j ʌ̹ k̚
수확	sʰ u β w a̠ k̚
환전	ɸ w a̠ n d͡ʑ ʌ̹ n
사나이	sʰ a̠ n a̠ i
이름	i ɾ ɯ m
걸음	k ʌ̹ ɾ ɯ m
헬멧	h e̞ ɭ m e̞ t̚
마이크	m a̠ i k x ɯ
기치	k i t͡ɕʰ i
에테르	e̞ tʰ e̞ ɾ ɯ
프라이팬	pʰ ɯ ɾ a̠ i pʰ e̞ n
이사악	i sʰ a̠ a̠ k̚
녹말	n o̞ ŋ m a̠ ɭ
운하	uː n ɦ a̠
활성탄	ɸ w a̠ ɭ s͈ ʌ̹ ŋ tʰ a̠ n
깨인절미	k͈ e̞ i n d͡ʑ ʌ̹ ɭ m i
택하다	tʰ e̞ kʰ a̠ d a̠
응원	ɯː ŋ w ʌ̹ n
백악관	p e̞ ɡ a̠ k̚ k͈ w a̠ n
반항하다	p a̠ n ɦ a̠ ŋ ɦ a̠ d a̠
필요	pʰ i ɾ j o
주변	t͡ɕ u b j ʌ̹ n
난처하다	n a̠ n t͡ɕʰ ʌ̹ ɦ a̠ d a̠
미래시제	m iː ɾ e̞ ɕʰ i d͡ʑ e̞
버클	p ʌ̹ k x ɯ ɭ
문해	m u n ɦ e̞
량반	ɾ j a̠ ŋ b a̠ n
꼬챙이	k͈ o̞ t͡ɕʰ e̞ ŋ i
양귀비	j a̠ ŋ ɡ ɥ i b i
쇼윈도	ɕʰ j o ɥ i n d o̞
집회서	t͡ɕ i pʰ w e̞ sʰ ʌ̹
경도	k j ɘː ŋ d o̞
존재	t͡ɕ o̞ n d͡ʑ e̞
별세하다	p j ʌ̹ ɭ s͈ e̞ ɦ a̠ d a̠
규약	k j u j a̠ k̚
미스터리	m i sʰ ɯ tʰ ʌ̹ ɾ i
어린이집	ʌ̹ ɾ i n i d͡ʑ i p̚
왕국	w a̠ ŋ ɡ u k̚
평형	pʰ j ʌ̹ ŋ ʝ j ʌ̹ ŋ
날아오르다	n a̠ ɾ a̠ o̞ ɾ ɯ d a̠
멘델레븀	m e̞ n d e̞ ɭ ɭ e̞ b j u m
선교사	sʰ ʌ̹ n ɡ j o sʰ a̠
갈까마귀	k a̠ ɭ k͈ a̠ m a̠ ɡ ɥ i
신수	ɕʰ i n sʰ u
순박하다	sʰ u n b a̠ kʰ a̠ d a̠
퇴학	tʰ w e̞ː ɦ a̠ k̚
아이오딘	a̠ i o̞ d i n
뱃사람	p e̞ t̚ s͈ a̠ ɾ a̠ m
니케아	n i kʰ e̞ a̠
환승하다	ɸ w a̠ː n sʰ ɯ ŋ ɦ a̠ d a̠
증거	t͡ɕ ɯ ŋ ɡ ʌ̹
민족	m i n d͡ʑ o̞ k̚
꺽저구	k͈ ʌ̹ k̚ t͡ɕ͈ ʌ̹ ɡ u
정치가	t͡ɕ ʌ̹ ŋ t͡ɕʰ i ɡ a̠
아리수	a̠ ɾ i sʰ u
지구	t͡ɕ i ɡ u
일컫다	i ɭ kʰ ʌ̹ t̚ t͈ a̠
문법	m u n p͈ ʌ̹ p̚
탄자니아	tʰ a̠ n d͡ʑ a̠ n i a̠
그램	k ɯ ɾ e̞ m
교회론	k j oː β w e̞ ɾ o̞ n
들러리	t ɯ ɭ ɭ ʌ̹ ɾ i
폴리머	pʰ o̞ ɭ ʎ i m ʌ̹
참외	t͡ɕʰ a̠ m w e̞
낯익다	n a̠ n n i k̚ t͈ a̠
기름종개	k i ɾ ɯ m d͡ʑ o̞ ŋ ɡ e̞
십사	ɕʰ i p s͈ a̠
소중하다	sʰ o̞ː d͡ʑ u ŋ ɦ a̠ d a̠
기뻐하다	k i p͈ ʌ̹ ɦ a̠ d a̠
물망초	m u ɭ m a̠ ŋ t͡ɕʰ o̞
부수다	p u sʰ u d a̠
녹다	n o̞ k̚ t͈ a̠
가산	k a̠ sʰ a̠ n
상하다	sʰ a̠ ŋ ɦ a̠ d a̠
반입자	p a̠ː n i p̚ t͡ɕ͈ a̠
노랑부리저어새	n o̞ ɾ a̠ ŋ b u ɾ i d͡ʑ ʌ̹ ʌ̹ sʰ e̞
하품	h a̠ pʰ u m
이모	i m o̞
눕다	n uː p̚ t͈ a̠
보다도	p o̞ d a̠ d o̞
명령법	m j ɘː ŋ ɲ j ʌ̹ ŋ b ʌ̹ p̚
콩고	kʰ o̞ ŋ ɡ o̞
적분	t͡ɕ ʌ̹ k̚ p͈ u n
레코드	ɾ e̞ kʰ o̞ d ɯ
방지	p a̠ ŋ d͡ʑ i
토스터	tʰ o̞ sʰ ɯ tʰ ʌ̹
민첩성	m i n t͡ɕʰ ʌ̹ p s͈ ʌ̹ ŋ
노화	n o̞ β w a̠
구레나룻	k u ɾ e̞ n a̠ ɾ u t̚
비다	p i d a̠
산둥	sʰ a̠ n d u ŋ
피아노	pʰ i a̠ n o̞
험담	h ɘː m d a̠ m
겁쟁이	k ʌ̹ p̚ t͡ɕ͈ e̞ ŋ i
안내문	a̠ n n e̞ m u n
특정하다	tʰ ɯ k̚ t͡ɕ͈ ʌ̹ ŋ ɦ a̠ d a̠
길림	k i ɭ ʎ i m
윤리	j u ɭ ʎ i
까치복	k͈ a̠ː t͡ɕʰ i b o̞ k̚
장교	t͡ɕ a̠ː ŋ ɡ j o
관장	k w a̠ n d͡ʑ a̠ ŋ
놓치다	n o̞ t̚ t͡ɕʰ i d a̠
방망이	p a̠ ŋ m a̠ ŋ i
수태	sʰ u tʰ e̞
원반	w ʌ̹ n b a̠ n
초은하단	t͡ɕʰ o̞ ɯ n ɦ a̠ d a̠ n
피크닉	pʰ i k x ɯ n i k̚
방언	p a̠ ŋ ʌ̹ n
크리켓	k x ɯ ɾ i kʰ e̞ t̚
쐬다	s͈ w e̞ː d a̠
맹렬하다	m e̞ː ŋ ɲ j ʌ̹ ɾ ɦ a̠ d a̠
테헤란	tʰ e̞ ɦ e̞ ɾ a̠ n
주거	t͡ɕ uː ɡ ʌ̹
성감	sʰ ɘː ŋ ɡ a̠ m
누치	n u t͡ɕʰ i
칼럼	kʰ a̠ ɭ ɭ ʌ̹ m
원자력발전소	w ʌ̹ n d͡ʑ a̠ ɾ j ʌ̹ k̚ p͈ a̠ ɭ d͡ʑ ʌ̹ n sʰ o̞
새기다	sʰ e̞ ɡ i d a̠
번역자	p ʌ̹ ɲ j ʌ̹ k̚ t͡ɕ͈ a̠
죽다	t͡ɕ u k̚ t͈ a̠
천만	t͡ɕʰ ʌ̹ n m a̠ n
한중	h a̠ː n d͡ʑ u ŋ
오토메이션	o̞ tʰ o̞ m e̞ i ɕʰ j ʌ̹ n
입맞추다	i m m a̠ t̚ t͡ɕʰ u d a̠
양즈	j a̠ ŋ d͡ʑ ɯ
남녘	n a̠ m ɲ j ʌ̹ k̚
이쑤시개	i s͈ u ɕʰ i ɡ e̞
오키나와어	o̞ k ç i n a̠ w a̠ ʌ̹
개천	k e̞ː t͡ɕʰ ʌ̹ n
튀니스	tʰ ɥ i n i sʰ ɯ
같이	k a̠ t͡ɕʰ i
신의주	ɕʰ i n ɰ i d͡ʑ u
비핵화	p iː ɦ e̞ kʰ w a̠
끝내	k͈ ɯ n n e̞
호루라기	ɸʷ o̞ ɾ u ɾ a̠ ɡ i
참전	t͡ɕʰ a̠ m d͡ʑ ʌ̹ n
아비	a̠ b i
세수하다	sʰ e̞ː sʰ u ɦ a̠ d a̠
팥빙수	pʰ a̠ t̚ p͈ i ŋ sʰ u
수저	sʰ u d͡ʑ ʌ̹
알렉산드리아	a̠ ɭ ɭ e̞ k s͈ a̠ n d ɯ ɾ i a̠
입법자	i p̚ p͈ ʌ̹ p̚ t͡ɕ͈ a̠
기중기	k i d͡ʑ u ŋ ɡ i
경매	k j ɘː ŋ m e̞
말하다	m a̠ː ɾ ɦ a̠ d a̠
줄몰개	t͡ɕ u ɭ m o̞ ɭ ɡ e̞
햇무리	h e̞ n m u ɾ i
세례	sʰ e̞ː ɾ j e̞
무사	m uː sʰ a̠
수정체	sʰ u d͡ʑ ʌ̹ ŋ t͡ɕʰ e̞
날짜	n a̠ ɭ t͡ɕ͈ a̠
닭살	t a̠ k s͈ a̠ ɭ
계급	k j e̞ ɡ ɯ p̚
혹부리오리	ɸʷ o̞ k̚ p͈ u ɾ i o̞ ɾ i
응집력	ɯː ŋ d͡ʑ i m ɲ j ʌ̹ k̚
말썽꾸러기	m a̠ː ɭ s͈ ʌ̹ ŋ k͈ u ɾ ʌ̹ ɡ i
납줄개	n a̠ p̚ t͡ɕ͈ u ɭ ɡ e̞
핵심부	h e̞ k ɕ͈ i m b u
그레이트브리튼	k ɯ ɾ e̞ i tʰ ɯ b ɯ ɾ i tʰ ɯ n
피라미	pʰ i ɾ a̠ m i
코미디	kʰ o̞ m i d i
결정짓다	k j ʌ̹ ɭ t͡ɕ͈ ʌ̹ ŋ d͡ʑ i t̚ t͈ a̠
효자손	ç j oː d͡ʑ a̠ sʰ o̞ n
흑인	x ɯ ɡ i n
아가	a̠ː ɡ a̠
진하다	t͡ɕ i n ɦ a̠ d a̠
한숨짓다	h a̠ n sʰ u m d͡ʑ i t̚ t͈ a̠
따뜻	t͈ a̠ t͈ ɯ t̚
소파	s͈ o̞ pʰ a̠
트롱프뢰유	tʰ ɯ ɾ o̞ ŋ pʰ ɯ ɾ w e̞ j u
언론가	ʌ̹ ɭ ɭ o̞ n ɡ a̠
멕시코시티	m e̞ k ɕ͈ i kʰ o̞ ɕʰ i tʰ i
교정	k j o d͡ʑ ʌ̹ ŋ
퇴비	tʰ w e̞ b i
만족	m a̠ n d͡ʑ o̞ k̚
유독하다	j uː d o̞ kʰ a̠ d a̠
양자전기역학	j a̠ ŋ d͡ʑ a̠ d͡ʑ ʌ̹ n ɡ i j ʌ̹ kʰ a̠ k̚
거만	k ɘː m a̠ n
우스갯소리	u sʰ ɯ ɡ e̞ t̚ s͈ o̞ ɾ i
깨닫다	k͈ e̞ d a̠ t̚ t͈ a̠
면역학	m j ʌ̹ ɲ j ʌ̹ kʰ a̠ k̚
협력	ç j ʌ̹ m ɲ j ʌ̹ k̚
쏜살같이	s͈ o̞ n sʰ a̠ ɭ ɡ a̠ t͡ɕʰ i
대모	t e̞ː m o̞
계집년	k j e̞ː d͡ʑ i m ɲ j ʌ̹ n
제시하다	t͡ɕ e̞ ɕʰ i ɦ a̠ d a̠
내심	n e̞ː ɕʰ i m
사이클링	sʰ a̠ i k x ɯ ɭ ʎ i ŋ
유비무환	j uː b i m u β w a̠ n
산마리노	s͈ a̠ n m a̠ ɾ i n o̞
귀주	k ɥ i d͡ʑ u
빨대	p͈ a̠ ɭ t͈ e̞
열없쟁이	j ɘː ɾ ʌ̹ p̚ t͡ɕ͈ e̞ ŋ i
미국오리	m i ɡ u ɡ o̞ ɾ i
우리집	u ɾ i d͡ʑ i p̚
한꺼번에	h a̠ n k͈ ʌ̹ b ʌ̹ n e̞
제안하다	t͡ɕ e̞ a̠ n ɦ a̠ d a̠
흰줄납줄개	ç i n d͡ʑ u ɭ ɭ a̠ p̚ t͡ɕ͈ u ɭ ɡ e̞
인증	i n d͡ʑ ɯ ŋ
사백어	sʰ a̠ː b e̞ ɡ ʌ̹
이루다	i ɾ u d a̠
땃쥐	t͈ a̠ t̚ t͡ɕ͈ ɥ i
반영	p a̠ː ɲ j ʌ̹ ŋ
협력하다	ç j ʌ̹ m ɲ j ʌ̹ kʰ a̠ d a̠
물러서다	m u ɭ ɭ ʌ̹ sʰ ʌ̹ d a̠
시내	ɕʰ iː n e̞
유언	j u ʌ̹ n
반면	p a̠ː n m j ʌ̹ n
광부	k w a̠ ŋ b u
애교살	e̞ ɡ j o sʰ a̠ ɭ
라트비아어	ɾ a̠ tʰ ɯ b i a̠ ʌ̹
포럼	pʰ o̞ ɾ ʌ̹ m
사립	sʰ a̠ ɾ i p̚
흰꼬리수리	ç i n k͈ o̞ ɾ i sʰ u ɾ i
여행	j ʌ̹ ɦ e̞ ŋ
후뇌	ɸʷ u n w e̞
염복	j ɘː m b o̞ k̚
마술	m a̠ sʰ u ɭ
굳다	k u t̚ t͈ a̠
가명	k a̠ː m j ʌ̹ ŋ
메카	m e̞ kʰ a̠
인식하다	i n ɕʰ i kʰ a̠ d a̠
칭호	t͡ɕʰ i ŋ β o̞
줄이다	t͡ɕ u ɾ i d a̠
각각	k a̠ k̚ k͈ a̠ k̚
사모아	sʰ a̠ m o̞ a̠
다대기	t a̠ d e̞ ɡ i
아리땁다	a̠ ɾ i t͈ a̠ p̚ t͈ a̠
누나	n uː n a̠
슬프다	sʰ ɯ ɭ pʰ ɯ d a̠
고릴라	k o̞ ɾ i ɭ ɭ a̠
카이만	kʰ a̠ i m a̠ n
관하다	k w a̠ n ɦ a̠ d a̠
택배	tʰ e̞ k̚ p͈ e̞
쏘다	s͈ o̞ː d a̠
신임하다	ɕʰ iː n i m ɦ a̠ d a̠
쇠백로	sʰ w e̞ b e̞ ŋ n o̞
파티	pʰ a̠ tʰ i
장난꾸러기	t͡ɕ a̠ ŋ n a̠ n k͈ u ɾ ʌ̹ ɡ i
그러므로	k ɯ ɾ ʌ̹ m ɯ ɾ o̞
효모	ç j oː m o̞
승하하다	sʰ ɯ ŋ ɦ a̠ ɦ a̠ d a̠
폐회식	pʰ j e̞ː β w e̞ ɕʰ i k̚
야기하다	j a̠ː ɡ i ɦ a̠ d a̠
던지럽다	t ɘː n d͡ʑ i ɾ ʌ̹ p̚ t͈ a̠
활발하다	ɸ w a̠ ɭ b a̠ ɾ ɦ a̠ d a̠
안전	a̠ n d͡ʑ ʌ̹ n
응회암	ɯ ŋ β w e̞ a̠ m
중년	t͡ɕ u ŋ ɲ j ʌ̹ n
대퇴	t e̞ː tʰ w e̞
형사	ç j ʌ̹ ŋ sʰ a̠
우편	u pʰ j ʌ̹ n
상놈	sʰ a̠ ŋ n o̞ m
백만	p e̞ ŋ m a̠ n
강도	k a̠ː ŋ d o̞
저주하다	t͡ɕ ɘː d͡ʑ u ɦ a̠ d a̠
세포학	sʰ e̞ː pʰ o̞ ɦ a̠ k̚
구두쇠	k u d u sʰ w e̞
네온	n e̞ o̞ n
못살다	m o̞ t̚ s͈ a̠ ɭ d a̠
일체	i ɭ t͡ɕʰ e̞
프리타운	pʰ ɯ ɾ i tʰ a̠ u n
섞다	sʰ ʌ̹ k̚ t͈ a̠
황혼	ɸ w a̠ ŋ β o̞ n
푸껫	pʰ u k͈ e̞ t̚
수도꼭지	sʰ u d o̞ k͈ o̞ k̚ t͡ɕ͈ i
졸업생	t͡ɕ o̞ ɾ ʌ̹ p s͈ e̞ ŋ
에스빠냐	e̞ sʰ ɯ p͈ a̠ ɲ j a̠
형화	ç j ʌ̹ ŋ β w a̠
엄격	ʌ̹ m k͈ j ʌ̹ k̚
아름답다	a̠ ɾ ɯ m d a̠ p̚ t͈ a̠
웰링턴	w e̞ ɭ ʎ i ŋ tʰ ʌ̹ n
눈치	n u n t͡ɕʰ i
대콴	t e̞ kʰ w a̠ n
불가피하다	p u ɭ ɡ a̠ pʰ i ɦ a̠ d a̠
논의하다	n o̞ n ɰ i ɦ a̠ d a̠
궁전	k u ŋ d͡ʑ ʌ̹ n
봉사	p o̞ː ŋ sʰ a̠
거웃	k ʌ̹ u t̚
음목	ɯ m m o̞ k̚
라오어	ɾ a̠ o̞ ʌ̹
닭고기	t a̠ k̚ k͈ o̞ ɡ i
곤들매기	k o̞ n d ɯ ɭ m e̞ ɡ i
가만	k a̠ m a̠ n
씨앗	ɕ͈ i a̠ t̚
걱정하다	k ʌ̹ k̚ t͡ɕ͈ ʌ̹ ŋ ɦ a̠ d a̠
옛한글	j e̞ː tʰ a̠ n ɡ ɯ ɭ
거만하다	k ɘː m a̠ n ɦ a̠ d a̠
범어	p ɘː m ʌ̹
도가니	t o̞ ɡ a̠ n i
이끼도롱뇽	i k͈ i d o̞ ɾ o̞ ŋ ɲ j o ŋ
들어서다	t ɯ ɾ ʌ̹ sʰ ʌ̹ d a̠
의상	ɰ i sʰ a̠ ŋ
낚싯대	n a̠ k ɕ͈ i t̚ t͈ e̞
이맘	i m a̠ m
형편	ç j ʌ̹ ŋ pʰ j ʌ̹ n
이구아나	i ɡ u a̠ n a̠
수다쟁이	sʰ uː d a̠ d͡ʑ e̞ ŋ i
코페르니슘	kʰ o̞ pʰ e̞ ɾ ɯ n i ɕʰ j u m
본격적	p o̞ n k͈ j ʌ̹ k̚ t͡ɕ͈ ʌ̹ k̚
박차	p a̠ k̚ t͡ɕʰ a̠
윤곽	j u n ɡ w a̠ k̚
여정	j ʌ̹ d͡ʑ ʌ̹ ŋ
상세하다	sʰ a̠ ŋ sʰ e̞ ɦ a̠ d a̠
사촌	sʰ a̠ː t͡ɕʰ o̞ n
인권	i n k͈ w ʌ̹ n
포인트	pʰ o̞ i n tʰ ɯ
강아지	k a̠ ŋ a̠ d͡ʑ i
우리들	u ɾ i d ɯ ɭ
설레이다	sʰ ʌ̹ ɭ ɭ e̞ i d a̠
사마귀	sʰ a̠ː m a̠ ɡ ɥ i
띄다	t͈ iː d a̠
비키다	p iː k ç i d a̠
코스	kʰ o̞ sʰ ɯ
글루텐	k ɯ ɭ ɭ u tʰ e̞ n
점심	t͡ɕ ɘː m ɕʰ i m
어려움	ʌ̹ ɾ j ʌ̹ u m
됭경모치	t w e̞ ŋ ɡ j ʌ̹ ŋ m o̞ t͡ɕʰ i
토마스	tʰ o̞ m a̠ sʰ ɯ
전달하다	t͡ɕ ʌ̹ n d a̠ ɾ ɦ a̠ d a̠
후회	ɸʷ uː β w e̞
리눅스	ɾ i n u k s͈ ɯ
수리아	sʰ u ɾ i a̠
북방중고기	p u k̚ p͈ a̠ ŋ d͡ʑ u ŋ ɡ o̞ ɡ i
모텔	m o̞ tʰ e̞ ɭ
김치전	k i m t͡ɕʰ i d͡ʑ ʌ̹ n
보배	p o̞ː b e̞
정신	t͡ɕ ʌ̹ ŋ ɕʰ i n
상속인	sʰ a̠ ŋ sʰ o̞ ɡ i n
얼쑤	ʌ̹ ɭ s͈ u
갈등	k a̠ ɭ t͈ ɯ ŋ
반대어	p a̠ː n d e̞ ʌ̹
싸이다	s͈ a̠ i d a̠
아비달마	a̠ b i d a̠ ɭ m a̠
여울마자	j ʌ̹ u ɭ m a̠ d͡ʑ a̠
실수하다	ɕʰ i ɭ s͈ u ɦ a̠ d a̠
잔점박이물범	t͡ɕ a̠ n d͡ʑ ʌ̹ m b a̠ ɡ i m u ɭ b ʌ̹ m
불과	p u ɭ ɡ w a̠
벌새	p ɘː ɭ sʰ e̞
터빈	tʰ ʌ̹ b i n
눈엣가시	n u n e̞ t̚ k͈ a̠ ɕʰ i
카인	kʰ a̠ i n
차트	t͡ɕʰ a̠ tʰ ɯ
픽업	pʰ i ɡ ʌ̹ p̚
에멜무지로	e̞ m e̞ ɭ m u d͡ʑ i ɾ o̞
창포검	t͡ɕʰ a̠ ŋ pʰ o̞ ɡ ʌ̹ m
불륜	p u ɭ ʎ j u n
짬뽕	t͡ɕ͈ a̠ m p͈ o̞ ŋ
계산	k j e̞ː sʰ a̠ n
낚시	n a̠ k ɕ͈ i
관형사	k w a̠ n ʝ j ʌ̹ ŋ sʰ a̠
이자	i d͡ʑ a̠
머리말	m ʌ̹ ɾ i m a̠ ɭ
슬리퍼	sʰ ɯ ɭ ʎ i pʰ ʌ̹
포그롬	pʰ o̞ ɡ ɯ ɾ o̞ m
비법	p iː p͈ ʌ̹ p̚
향항	ç j a̠ ŋ ɦ a̠ ŋ
아라사	a̠ ɾ a̠ sʰ a̠
경쟁력	k j ɘː ŋ d͡ʑ e̞ ŋ ɲ j ʌ̹ k̚
알리다	a̠ ɭ ʎ i d a̠
비슈케크	p i ɕʰ j u kʰ e̞ k x ɯ
예외	j e̞ː w e̞
구성원	k u sʰ ʌ̹ ŋ w ʌ̹ n
이슬람교	i sʰ ɯ ɭ ɭ a̠ m ɡ j o
도박	t o̞ b a̠ k̚
카운터	kʰ a̠ u n tʰ ʌ̹
와가두구	w a̠ ɡ a̠ d u ɡ u
힘쓰다	ç i m s͈ ɯ d a̠
연료	j ʌ̹ ɭ ʎ j o
새우젓	sʰ e̞ u d͡ʑ ʌ̹ t̚
울음	u ɾ ɯ m
온두라스	o̞ n d u ɾ a̠ sʰ ɯ
미라	m i ɾ a̠
안녕하십니까	a̠ n ɲ j ʌ̹ ŋ ɦ a̠ ɕʰ i m n i k͈ a̠
다거다	t a̠ ɡ ʌ̹ d a̠
허리케인	h ʌ̹ ɾ i kʰ e̞ i n
개정	k e̞ː d͡ʑ ʌ̹ ŋ
축일	t͡ɕʰ u ɡ i ɭ
부상	p u sʰ a̠ ŋ
화폐	ɸ w a̠ː pʰ j e̞
벌거벗다	p ʌ̹ ɭ ɡ ʌ̹ b ʌ̹ t̚ t͈ a̠
백화점	p e̞ kʰ w a̠ d͡ʑ ʌ̹ m
외투	w e̞ː tʰ u
표절	pʰ j o d͡ʑ ʌ̹ ɭ
베드로	p e̞ d ɯ ɾ o̞
전류	t͡ɕ ɘː ɭ ʎ j u
적용하다	t͡ɕ ʌ̹ ɡ j o ŋ ɦ a̠ d a̠
생일	sʰ e̞ ŋ i ɭ
쿠바	kʰ u b a̠
거짓말하다	k ɘː d͡ʑ i n m a̠ ɾ ɦ a̠ d a̠
토론	tʰ o̞ː ɾ o̞ n
몸통	m o̞ m tʰ o̞ ŋ
오히려	o̞ ʝ i ɾ j ʌ̹
솔직하다	sʰ o̞ ɭ d͡ʑ i kʰ a̠ d a̠
속삭임	sʰ o̞ k s͈ a̠ ɡ i m
간음	k a̠ː n ɯ m
팔월	pʰ a̠ ɾ w ʌ̹ ɭ
동안	t o̞ ŋ a̠ n
리비도	ɾ i b i d o̞
안주	a̠ n d͡ʑ u
닥치다	t a̠ k̚ t͡ɕʰ i d a̠
정수	t͡ɕ ʌ̹ ŋ sʰ u
큰일	k x ɯ n n i ɭ
섞이다	sʰ ʌ̹ k͈ i d a̠
속눈썹	sʰ o̞ː ŋ n u n s͈ ʌ̹ p̚
악인	a̠ ɡ i n
키스	k ç i sʰ ɯ
문명	m u n m j ʌ̹ ŋ
젖가공품	t͡ɕ ʌ̹ t̚ k͈ a̠ ɡ o̞ ŋ pʰ u m
위험하다	ɥ i ɦ ʌ̹ m ɦ a̠ d a̠
인연	i ɲ j ʌ̹ n
합금	h a̠ p̚ k͈ ɯ m
수리남	sʰ u ɾ i n a̠ m
기차역	k i t͡ɕʰ a̠ j ʌ̹ k̚
가죽끈	k a̠ d͡ʑ u k̚ k͈ ɯ n
출산	t͡ɕʰ u ɭ s͈ a̠ n
기사	k i sʰ a̠
마케도니아	m a̠ kʰ e̞ d o̞ n i a̠
막바지	m a̠ k̚ p͈ a̠ d͡ʑ i
발가락	p a̠ ɭ k͈ a̠ ɾ a̠ k̚
음력	ɯ m ɲ j ʌ̹ k̚
해양학	h e̞ j a̠ ŋ ɦ a̠ k̚
저기	t͡ɕ ʌ̹ ɡ i
산업	sʰ a̠ː n ʌ̹ p̚
유교	j u ɡ j o
재채기하다	t͡ɕ e̞ t͡ɕʰ e̞ ɡ i ɦ a̠ d a̠
서럽다	sʰ ɘː ɾ ʌ̹ p̚ t͈ a̠
찬넬동자개	t͡ɕʰ a̠ n n e̞ ɭ d o̞ ŋ d͡ʑ a̠ ɡ e̞
아마도	a̠ m a̠ d o̞
북방	p u k̚ p͈ a̠ ŋ
사다	sʰ a̠ d a̠
세대	sʰ e̞ː d e̞
룸메이트	ɾ u m m e̞ i tʰ ɯ
한가	h a̠ n ɡ a̠
시점	ɕʰ i d͡ʑ ʌ̹ m
실시되다	ɕʰ i ɭ ɕʰ i d w e̞ d a̠
상수	sʰ a̠ ŋ sʰ u
요소	j o sʰ o̞
바텐더	p a̠ tʰ e̞ n d ʌ̹
학기	h a̠ k̚ k͈ i
잘되다	t͡ɕ a̠ ɭ d w e̞ d a̠
마육	m a̠ː j u k̚
지름	t͡ɕ i ɾ ɯ m
깔끔하다	k͈ a̠ ɭ k͈ ɯ m ɦ a̠ d a̠
아주머니	a̠ d͡ʑ u m ʌ̹ n i
댕댕이	t e̞ ŋ d e̞ ŋ i
심심하다	ɕʰ i m ɕʰ i m ɦ a̠ d a̠
잘잘못	t͡ɕ a̠ ɭ d͡ʑ a̠ ɭ m o̞ t̚
키우다	k ç i u d a̠
수수께끼	sʰ u sʰ u k͈ e̞ k͈ i
부줌부라	p u d͡ʑ u m b u ɾ a̠
약간	j a̠ k̚ k͈ a̠ n
섭씨	sʰ ʌ̹ p ɕ͈ i
물리치다	m u ɭ ʎ i t͡ɕʰ i d a̠
그럼	k ɯ ɾ ʌ̹ m
라이플	ɾ a̠ i pʰ ɯ ɭ
영토	j ʌ̹ ŋ tʰ o̞
하시다	h a̠ ɕʰ i d a̠
들것	t ɯ ɭ ɡ ʌ̹ t̚
물질	m u ɭ t͡ɕ͈ i ɭ
정교회	t͡ɕ ɘː ŋ ɡ j o β w e̞
지주	t͡ɕ i d͡ʑ u
오미자	o̞ː m i d͡ʑ a̠
바하마	p a̠ ɦ a̠ m a̠
하이드록실아민	h a̠ i d ɯ ɾ o̞ k ɕ͈ i ɾ a̠ m i n
틀림없이	tʰ ɯ ɭ ʎ i m ʌ̹ p ɕ͈ i
떨잠	t͈ ɘː ɭ d͡ʑ a̠ m
신자	ɕʰ iː n d͡ʑ a̠
놀리다	n o̞ ɭ ʎ i d a̠
어느새	ʌ̹ n ɯ sʰ e̞
값어치	k a̠ b ʌ̹ t͡ɕʰ i
희곡	ç i ɡ o̞ k̚
바이트	p a̠ i tʰ ɯ
섧다	sʰ ɘː ɭ t͈ a̠
반갑다	p a̠ n ɡ a̠ p̚ t͈ a̠
칼상어	kʰ a̠ ɭ sʰ a̠ ŋ ʌ̹
아연	a̠ j ʌ̹ n
양자	j a̠ ŋ d͡ʑ a̠
곳곳	k o̞ t̚ k͈ o̞ t̚
차례차례	t͡ɕʰ a̠ ɾ j e̞ t͡ɕʰ a̠ ɾ j e̞
연속	j ʌ̹ n sʰ o̞ k̚
다섯	t a̠ sʰ ʌ̹ t̚
한어	h a̠ː n ʌ̹
갈밭쥐	k a̠ ɭ b a̠ t̚ t͡ɕ͈ ɥ i
미사	m i sʰ a̠
마이너스	m a̠ i n ʌ̹ sʰ ɯ
각도	k a̠ k̚ t͈ o̞
소금	sʰ o̞ ɡ ɯ m
강렬하다	k a̠ ŋ ɲ j ʌ̹ ɾ ɦ a̠ d a̠
후추	ɸʷ u t͡ɕʰ u
멍청하다	m ʌ̹ ŋ t͡ɕʰ ʌ̹ ŋ ɦ a̠ d a̠
과태료	k w a̠ː tʰ e̞ ɾ j o
빨다	p͈ a̠ ɭ d a̠
취흥	t͡ɕʰ ɥ iː ɣ ɯ ŋ
주권	t͡ɕ u k͈ w ʌ̹ n
파피루스	pʰ a̠ pʰ i ɾ u sʰ ɯ
초반	t͡ɕʰ o̞ b a̠ n
밴드	p e̞ n d ɯ
주부	t͡ɕ u b u
그러하다	k ɯ ɾ ʌ̹ ɦ a̠ d a̠
살아가다	sʰ a̠ ɾ a̠ ɡ a̠ d a̠
극단주의	k ɯ k̚ t͈ a̠ n d͡ʑ u ɰ i
파단	pʰ a̠ː d a̠ n
이민	i m i n
근무하다	k ɯː n m u ɦ a̠ d a̠
필업	pʰ i ɾ ʌ̹ p̚
양동이	j a̠ ŋ d o̞ ŋ i
회기	ɸ w e̞ː ɡ i
나이프	n a̠ i pʰ ɯ
초대하다	t͡ɕʰ o̞ d e̞ ɦ a̠ d a̠
베네수엘라	p e̞ n e̞ sʰ u e̞ ɭ ɭ a̠
쏘가리	s͈ o̞ ɡ a̠ ɾ i
붇다	p uː t̚ t͈ a̠
띄어쓰기	t͈ i ʌ̹ s͈ ɯ ɡ i
심혼	ɕʰ i m β o̞ n
닷새	t a̠ t̚ s͈ e̞
변환	p j ɘː n β w a̠ n
켜다	k ç j ʌ̹ d a̠
도구	t o̞ː ɡ u
동력	t o̞ː ŋ ɲ j ʌ̹ k̚
받아쓰기	p a̠ d a̠ s͈ ɯ ɡ i
그런	k ɯ ɾ ʌ̹ n
유서	j u sʰ ʌ̹
내용	n e̞ː j o ŋ
그리고	k ɯ ɾ i ɡ o̞
컬트	kʰ ʌ̹ ɭ tʰ ɯ
콧수염	kʰ o̞ t̚ s͈ u j ʌ̹ m
감돌고기	k a̠ m d o̞ ɭ ɡ o̞ ɡ i
특권	tʰ ɯ k̚ k͈ w ʌ̹ n
관사	k w a̠ n sʰ a̠
부르트다	p u ɾ ɯ tʰ ɯ d a̠
뚝섬	t͈ u k s͈ ʌ̹ m
너무	n ʌ̹ m u
제거하다	t͡ɕ e̞ ɡ ʌ̹ ɦ a̠ d a̠
밀랍	m i ɭ ɭ a̠ p̚
어머니	ʌ̹ m ʌ̹ n i
인공지능	i n ɡ o̞ ŋ d͡ʑ i n ɯ ŋ
피부	pʰ i b u
메시지	m e̞ ɕʰ i d͡ʑ i
내외	n e̞ː w e̞
톈진	tʰ j e̞ n d͡ʑ i n
맹장염	m e̞ ŋ d͡ʑ a̠ ŋ j ʌ̹ m
메가나	m e̞ ɡ a̠ n a̠
작업	t͡ɕ a̠ ɡ ʌ̹ p̚
로켓	ɾ o̞ kʰ e̞ t̚
사향	sʰ a̠ː ʝ j a̠ ŋ
고백	k o̞ b e̞ k̚
장쑤	t͡ɕ a̠ ŋ s͈ u
왜몰개	w e̞ m o̞ ɭ ɡ e̞
조리개	t͡ɕ o̞ ɾ i ɡ e̞
동의	t o̞ ŋ ɰ i
쫓다	t͡ɕ͈ o̞ t̚ t͈ a̠
약혼	j a̠ kʰ o̞ n
려권	ɾ j ʌ̹ ɡ w ʌ̹ n
진리	t͡ɕ i ɭ ʎ i
어댑터	ʌ̹ d e̞ p̚ tʰ ʌ̹
토하다	tʰ o̞ː ɦ a̠ d a̠
형성되다	ç j ʌ̹ ŋ sʰ ʌ̹ ŋ d w e̞ d a̠
샤프펜실	ɕʰ j a̠ pʰ ɯ pʰ e̞ n ɕʰ i ɭ
다카르	t a̠ kʰ a̠ ɾ ɯ
암기	a̠ː m ɡ i
음역자	ɯ m j ʌ̹ k̚ t͡ɕ͈ a̠
여인	j ʌ̹ i n
꾸리다	k͈ u ɾ i d a̠
코쟁이	kʰ o̞ d͡ʑ e̞ ŋ i
슴새	sʰ ɯ m sʰ e̞
수상	sʰ u sʰ a̠ ŋ
턱뼈	tʰ ʌ̹ k̚ p͈ j ʌ̹
금요일	k ɯ m j o i ɭ
독일	t o̞ ɡ i ɭ
갈증	k a̠ ɭ t͡ɕ͈ ɯ ŋ
유대	j u d e̞
하품하다	h a̠ pʰ u m ɦ a̠ d a̠
서술	sʰ ɘː sʰ u ɭ
납땜인두	n a̠ p̚ t͈ e̞ m i n d u
척하다	t͡ɕʰ ʌ̹ kʰ a̠ d a̠
아르메니아어	a̠ ɾ ɯ m e̞ n i a̠ ʌ̹
소방수	sʰ o̞ b a̠ ŋ sʰ u
벚꽃뱅어	p ʌ̹ t̚ k͈ o̞ t̚ p͈ e̞ ŋ ʌ̹
무서움	m u sʰ ʌ̹ u m
찾아보다	t͡ɕʰ a̠ d͡ʑ a̠ b o̞ d a̠
도대체	t o̞ d e̞ t͡ɕʰ e̞
추다	t͡ɕʰ u d a̠
사파리	sʰ a̠ pʰ a̠ ɾ i
바람둥이	p a̠ ɾ a̠ m d u ŋ i
원숭이	w ɘː n sʰ u ŋ i
업그레이드	ʌ̹ p̚ k͈ ɯ ɾ e̞ i d ɯ
깨끗한	k͈ e̞ k͈ ɯ tʰ a̠ n
운전하다	u n d͡ʑ ʌ̹ n ɦ a̠ d a̠
고혈압	k o̞ ʝ j ʌ̹ ɾ a̠ p̚
까뀌	k͈ a̠ː k͈ ɥ i
하이드라진	h a̠ i d ɯ ɾ a̠ d͡ʑ i n
아련	a̠ ɾ j ʌ̹ n
멀리	m ɘː ɭ ʎ i
반신반인	p a̠ː n ɕʰ i n b a̠ n i n
이탄	iː tʰ a̠ n
가치관	k a̠ t͡ɕʰ i ɡ w a̠ n
코카인	kʰ o̞ kʰ a̠ i n
보행자	p o̞ː ɦ e̞ ŋ d͡ʑ a̠
뒷간	t ɥ iː t̚ k͈ a̠ n
개선	k e̞ː sʰ ʌ̹ n
동버들개	t o̞ ŋ b ʌ̹ d ɯ ɭ ɡ e̞
유럽짱깨	j u ɾ ʌ̹ p̚ t͡ɕ͈ a̠ ŋ k͈ e̞
진부하다	t͡ɕ i n b u ɦ a̠ d a̠
사제	sʰ a̠ d͡ʑ e̞
조선봉건왕조	t͡ɕ o̞ sʰ ʌ̹ n b o̞ ŋ ɡ ʌ̹ n w a̠ ŋ d͡ʑ o̞
법정	p ʌ̹ p̚ t͡ɕ͈ ʌ̹ ŋ
갈림길	k a̠ ɭ ʎ i m k͈ i ɭ
수출	sʰ u t͡ɕʰ u ɭ
등허리	t ɯ ŋ ɦ ʌ̹ ɾ i
적응도	t͡ɕ ʌ̹ ɡ ɯ ŋ d o̞
에스파냐	e̞ sʰ ɯ pʰ a̠ ɲ j a̠
죽음	t͡ɕ u ɡ ɯ m
존맛	t͡ɕ o̞ n m a̠ t̚
워싱턴	w ʌ̹ ɕʰ i ŋ tʰ ʌ̹ n
개시	k e̞ ɕʰ i
해치다	h e̞ː t͡ɕʰ i d a̠
해라체	h e̞ ɾ a̠ t͡ɕʰ e̞
접속	t͡ɕ ʌ̹ p s͈ o̞ k̚
깃털	k i t̚ tʰ ʌ̹ ɭ
말라보	m a̠ ɭ ɭ a̠ b o̞
비트박스	p i tʰ ɯ b a̠ k s͈ ɯ
티탄	tʰ i tʰ a̠ n
아흐레	a̠ ɣ ɯ ɾ e̞
문제	m uː n d͡ʑ e̞
다다르다	t a̠ d a̠ ɾ ɯ d a̠
관절	k w a̠ n d͡ʑ ʌ̹ ɭ
두덩	t u d ʌ̹ ŋ
덤불해오라기	t ʌ̹ m b u ɾ ɦ e̞ o̞ ɾ a̠ ɡ i
이집트	i d͡ʑ i p̚ tʰ ɯ
상황	sʰ a̠ ŋ β w a̠ ŋ
천재	t͡ɕʰ ʌ̹ n d͡ʑ e̞
재주	t͡ɕ e̞ d͡ʑ u
생애	sʰ e̞ ŋ e̞
체모	t͡ɕʰ e̞ m o̞
매니큐어	m e̞ n i k ç j u ʌ̹
박테리아	p a̠ k̚ tʰ e̞ ɾ i a̠
무겁다	m u ɡ ʌ̹ p̚ t͈ a̠
흥정	x ɯ ŋ d͡ʑ ʌ̹ ŋ
축복하다	t͡ɕʰ u k̚ p͈ o̞ kʰ a̠ d a̠
코치	kʰ o̞ t͡ɕʰ i
관심	k w a̠ n ɕʰ i m
결정하다	k j ʌ̹ ɭ t͡ɕ͈ ʌ̹ ŋ ɦ a̠ d a̠
주택	t͡ɕ uː tʰ e̞ k̚
자궁	t͡ɕ a̠ ɡ u ŋ
사령부	sʰ a̠ ɾ j ʌ̹ ŋ b u
간질이다	k a̠ n d͡ʑ i ɾ i d a̠
진압하다	t͡ɕ i n a̠ pʰ a̠ d a̠
캔디	kʰ e̞ n d i
채용하다	t͡ɕʰ e̞ː j o ŋ ɦ a̠ d a̠
타이타늄	tʰ a̠ i tʰ a̠ ɲ j u m
불다	p uː ɭ d a̠
춘절	t͡ɕʰ u n d͡ʑ ʌ̹ ɭ
단순	t a̠ n sʰ u n
반드시	p a̠ n d ɯ ɕʰ i
직업	t͡ɕ i ɡ ʌ̹ p̚
겁대가리	k ʌ̹ p̚ t͈ e̞ ɡ a̠ ɾ i
차갑다	t͡ɕʰ a̠ ɡ a̠ p̚ t͈ a̠
유모	j u m o̞
투사지	tʰ u sʰ a̠ d͡ʑ i
종아리뼈	t͡ɕ o̞ː ŋ a̠ ɾ i p͈ j ʌ̹
가라데	k a̠ ɾ a̠ d e̞
일군	i ɭ k͈ u n
내놓다	n e̞ː n o̞ tʰ a̠
아랍에미리트	a̠ ɾ a̠ b e̞ m i ɾ i tʰ ɯ
승객	sʰ ɯ ŋ ɡ e̞ k̚
시작하다	ɕʰ iː d͡ʑ a̠ kʰ a̠ d a̠
게이기	k e̞ i ɡ i
만들다	m a̠ n d ɯ ɭ d a̠
선글라스	sʰ ʌ̹ n ɡ ɯ ɭ ɭ a̠ sʰ ɯ
연락	j ʌ̹ ɭ ɭ a̠ k̚
세젤귀	sʰ e̞ d͡ʑ e̞ ɭ ɡ ɥ i
다방	t a̠ b a̠ ŋ
적자	t͡ɕ ʌ̹ k̚ t͡ɕ͈ a̠
끔찍하다	k͈ ɯ m t͡ɕ͈ i kʰ a̠ d a̠
두어	t u ʌ̹
지적되다	t͡ɕ i d͡ʑ ʌ̹ k̚ t͈ w e̞ d a̠
성명	sʰ ɘː ŋ m j ʌ̹ ŋ
골수	k o̞ ɭ s͈ u
반려	p a̠ː ɭ ʎ j ʌ̹
이나	i n a̠
크로뮴	k x ɯ ɾ o̞ m j u m
대회	t e̞ː β w e̞
양유	j a̠ ŋ j u
가족	k a̠ d͡ʑ o̞ k̚
저녁밥	t͡ɕ ʌ̹ ɲ j ʌ̹ k̚ p͈ a̠ p̚
고스트	k o̞ sʰ ɯ tʰ ɯ
피라냐	pʰ i ɾ a̠ ɲ j a̠
포트모르즈비	pʰ o̞ tʰ ɯ m o̞ ɾ ɯ d͡ʑ ɯ b i
저것	t͡ɕ ʌ̹ ɡ ʌ̹ t̚
편리	pʰ j ʌ̹ ɭ ʎ i
흰뺨오리	ç i n p͈ j a̠ m o̞ ɾ i
기획	k i β w e̞ k̚
깜둥이	k͈ a̠ m d u ŋ i
플루오린	pʰ ɯ ɭ ɭ u o̞ ɾ i n
페난트리딘	pʰ e̞ n a̠ n tʰ ɯ ɾ i d i n
결심	k j ʌ̹ ɭ ɕ͈ i m
배우다	p e̞ u d a̠
묵은해	m u ɡ ɯ n ɦ e̞
윈도	ɥ i n d o̞
사법	sʰ a̠ b ʌ̹ p̚
딸딸이	t͈ a̠ ɭ t͈ a̠ ɾ i
강요	k a̠ː ŋ j o
베트남	p e̞ tʰ ɯ n a̠ m
바나듐	p a̠ n a̠ d j u m
심각하다	ɕʰ iː m ɡ a̠ kʰ a̠ d a̠
하트	h a̠ tʰ ɯ
빛깔	p i t̚ k͈ a̠ ɭ
기운	k i u n
여섯	j ʌ̹ sʰ ʌ̹ t̚
글쎄요	k ɯ ɭ s͈ e̞ j o
바다비오리	p a̠ d a̠ b i o̞ ɾ i
살펴보다	sʰ a̠ ɭ pʰ j ʌ̹ b o̞ d a̠
망연	m a̠ ŋ j ʌ̹ n
ㅋㅋㅋ	k x ɯ k x ɯ k x ɯ
냉전	n e̞ ŋ d͡ʑ ʌ̹ n
목성	m o̞ k s͈ ʌ̹ ŋ
ᆸ니다	m n i d a̠
각본	k a̠ k̚ p͈ o̞ n
난쟁이	n a̠ n d͡ʑ e̞ ŋ i
뽈스까	p͈ o̞ ɭ sʰ ɯ k͈ a̠
서랍	sʰ ʌ̹ ɾ a̠ p̚
후지	ɸʷ u d͡ʑ i
파하다	pʰ a̠ː ɦ a̠ d a̠
봇짐	p o̞ t̚ t͡ɕ͈ i m
발기다	p a̠ ɭ ɡ i d a̠
독서실	t o̞ k s͈ ʌ̹ ɕʰ i ɭ
에뮤	e̞ m j u
밥상	p a̠ p s͈ a̠ ŋ
여행하다	j ʌ̹ ɦ e̞ ŋ ɦ a̠ d a̠
집단	t͡ɕ i p̚ t͈ a̠ n
십육	ɕʰ i m ɲ j u k̚
스타일	sʰ ɯ tʰ a̠ i ɭ
년대	ɲ j ʌ̹ n d e̞
찻집	t͡ɕʰ a̠ t̚ t͡ɕ͈ i p̚
투표	tʰ u pʰ j o
교통	k j o tʰ o̞ ŋ
전화	t͡ɕ ɘː n β w a̠
수록	sʰ u ɾ o̞ k̚
퇴진	tʰ w e̞ː d͡ʑ i n
착석	t͡ɕʰ a̠ k s͈ ʌ̹ k̚
골상학	k o̞ ɭ sʰ a̠ ŋ ɦ a̠ k̚
마르크스주의	m a̠ ɾ ɯ k x ɯ sʰ ɯ d͡ʑ u ɰ i
예루살렘	j e̞ ɾ u sʰ a̠ ɭ ɭ e̞ m
목청	m o̞ k̚ t͡ɕʰ ʌ̹ ŋ
모드	m o̞ d ɯ
모래주사	m o̞ ɾ e̞ d͡ʑ u sʰ a̠
챌린지	t͡ɕʰ e̞ ɭ ʎ i n d͡ʑ i
경련	k j ʌ̹ ŋ ɲ j ʌ̹ n
용돈	j oː ŋ d o̞ n
위치하다	ɥ i t͡ɕʰ i ɦ a̠ d a̠
벙어리	p ʌ̹ ŋ ʌ̹ ɾ i
떳떳하다	t͈ ʌ̹ t̚ t͈ ʌ̹ tʰ a̠ d a̠
상투메	sʰ a̠ ŋ tʰ u m e̞
붕어빵	p u ŋ ʌ̹ p͈ a̠ ŋ
정오	t͡ɕ ɘː ŋ o̞
국밥	k u k̚ p͈ a̠ p̚
신명기	ɕʰ i n m j ʌ̹ ŋ ɡ i
신분	ɕʰ i n b u n
술집	sʰ u ɭ t͡ɕ͈ i p̚
판단하다	pʰ a̠ n d a̠ n ɦ a̠ d a̠
축제일	t͡ɕʰ u k̚ t͡ɕ͈ e̞ i ɭ
동반자	t o̞ ŋ b a̠ n d͡ʑ a̠
맨션	m e̞ n ɕʰ j ʌ̹ n
아나운서	a̠ n a̠ u n sʰ ʌ̹
상처	sʰ a̠ ŋ t͡ɕʰ ʌ̹
아점	a̠ d͡ʑ ʌ̹ m
우아하다	u a̠ ɦ a̠ d a̠
겨울	k j ʌ̹ u ɭ
도미니카	t o̞ m i n i kʰ a̠
파일	pʰ a̠ i ɭ
강설	k a̠ː ŋ sʰ ʌ̹ ɭ
괴다	k w e̞ː d a̠
크로아티아	k x ɯ ɾ o̞ a̠ tʰ i a̠
카자흐어	kʰ a̠ d͡ʑ a̠ ɣ ɯ ʌ̹
방안	p a̠ ŋ a̠ n
버클륨	p ʌ̹ k x ɯ ɭ ʎ j u m
캄판	kʰ a̠ m pʰ a̠ n
환율	ɸ w a̠ ɲ j u ɭ
몸짓	m o̞ m t͡ɕ͈ i t̚
성교하다	sʰ ɘː ŋ ɡ j o ɦ a̠ d a̠
카르보닐기	kʰ a̠ ɾ ɯ b o̞ n i ɭ ɡ i
한민족	h a̠ː n m i n d͡ʑ o̞ k̚
마침표	m a̠ t͡ɕʰ i m pʰ j o
코스모스	kʰ o̞ sʰ ɯ m o̞ sʰ ɯ
빨래집게	p͈ a̠ ɭ ɭ e̞ d͡ʑ i p̚ k͈ e̞
여럿	j ʌ̹ ɾ ʌ̹ t̚
수평선	sʰ u pʰ j ʌ̹ ŋ sʰ ʌ̹ n
스물	sʰ ɯ m u ɭ
소식	sʰ o̞ ɕʰ i k̚
식성	ɕʰ i k s͈ ʌ̹ ŋ
무수	m u sʰ u
두마	t u m a̠
혈액형	ç j ʌ̹ ɾ e̞ k ç j ʌ̹ ŋ
시계	ɕʰ iː ɡ j e̞
콘서트	kʰ o̞ n sʰ ʌ̹ tʰ ɯ
려관	ɾ j ʌ̹ ɡ w a̠ n
배트맨	p e̞ tʰ ɯ m e̞ n
에이즈	e̞ i d͡ʑ ɯ
불쌍	p u ɭ s͈ a̠ ŋ
도중	t o̞ː d͡ʑ u ŋ
폭격기	pʰ o̞ k̚ k͈ j ʌ̹ k̚ k͈ i
열매	j ʌ̹ ɭ m e̞
제주도	t͡ɕ e̞ː d͡ʑ u d o̞
조직학	t͡ɕ o̞ d͡ʑ i kʰ a̠ k̚
무예	m uː j e̞
관찰하다	k w a̠ n t͡ɕʰ a̠ ɾ ɦ a̠ d a̠
노서아	n o̞ sʰ ʌ̹ a̠
알제리	a̠ ɭ d͡ʑ e̞ ɾ i
불지르다	p u ɭ d͡ʑ i ɾ ɯ d a̠
아버님	a̠ b ʌ̹ n i m
가식	k a̠ː ɕʰ i k̚
허락	h ʌ̹ ɾ a̠ k̚
양국	j a̠ ŋ ɡ u k̚
삶다	sʰ a̠ː m t͈ a̠
연고	j ɘː n ɡ o̞
외래어	w e̞ː ɾ e̞ ʌ̹
미터	m i tʰ ʌ̹
굶주림	k uː m d͡ʑ u ɾ i m
동방	t o̞ ŋ b a̠ ŋ
흰배윗수염박쥐	ç i n b e̞ ɥ i t̚ s͈ u j ʌ̹ m b a̠ k̚ t͡ɕ͈ ɥ i
유릿조각	j u ɾ i t̚ t͡ɕ͈ o̞ ɡ a̠ k̚
흑기사	x ɯ k̚ k͈ i sʰ a̠
이발	iː b a̠ ɭ
떫디떫다	t͈ ɘː ɭ t͈ i t͈ ʌ̹ ɭ t͈ a̠
군디	k u n d i
단순히	t a̠ n sʰ u n ʝ i
고요	k o̞ j o
아비장	a̠ b i d͡ʑ a̠ ŋ
발구지	p a̠ ɭ ɡ u d͡ʑ i
축구	t͡ɕʰ u k̚ k͈ u
자가사리	t͡ɕ a̠ ɡ a̠ sʰ a̠ ɾ i
촌놈	t͡ɕʰ o̞ n n o̞ m
덧셈	t ʌ̹ t̚ s͈ e̞ m
높이	n o̞ pʰ i
예컨대	j e̞ː kʰ ʌ̹ n d e̞
위구르어	ɥ i ɡ u ɾ ɯ ʌ̹
뛰어다니다	t͈ ɥ i ʌ̹ d a̠ n i d a̠
밤낮	p a̠ m n a̠ t̚
판소리	pʰ a̠ n s͈ o̞ ɾ i
숲들쥐	sʰ u p̚ t͈ ɯ ɭ d͡ʑ ɥ i
오빠	o̞ p͈ a̠
발전하다	p a̠ ɭ t͡ɕ͈ ʌ̹ n ɦ a̠ d a̠
야구	j a̠ː ɡ u
적극적	t͡ɕ ʌ̹ k̚ k͈ ɯ k̚ t͡ɕ͈ ʌ̹ k̚
출납계	t͡ɕʰ u ɭ ɭ a̠ p̚ k͈ j e̞
대규모	t e̞ː ɡ j u m o̞
오슬로	o̞ sʰ ɯ ɭ ɭ o̞
오스트레일리아	o̞ sʰ ɯ tʰ ɯ ɾ e̞ i ɭ ʎ i a̠
쌀국수	s͈ a̠ ɭ ɡ u k s͈ u
티슈	tʰ i ɕʰ j u
변소	p j ʌ̹ n sʰ o̞
북괴	p u k̚ k͈ w e̞
본관	p o̞ n ɡ w a̠ n
앨범	e̞ ɭ b ʌ̹ m
얕보다	j a̠ t̚ p͈ o̞ d a̠
설교자	sʰ ʌ̹ ɭ ɡ j o d͡ʑ a̠
감사	k a̠ː m sʰ a̠
즉시	t͡ɕ ɯ k ɕ͈ i
착륙	t͡ɕʰ a̠ ŋ ɲ j u k̚
간통	k a̠ː n tʰ o̞ ŋ
후배위	ɸʷ u b e̞ ɥ i
토치카	tʰ o̞ t͡ɕʰ i kʰ a̠
웃기다	u t̚ k͈ i d a̠
두리안	t u ɾ i a̠ n
네오디뮴	n e̞ o̞ d i m j u m
디제이	t i d͡ʑ e̞ i
지중해	t͡ɕ i d͡ʑ u ŋ ɦ e̞
곤밥	k o̞ n b a̠ p̚
데려가다	t e̞ ɾ j ʌ̹ ɡ a̠ d a̠
서른	sʰ ʌ̹ ɾ ɯ n
니켈	n i kʰ e̞ ɭ
꼬마뒤쥐	k͈ o̞ m a̠ d ɥ i d͡ʑ ɥ i
이윽고	i ɯ k̚ k͈ o̞
큰이빨부리고래	k x ɯ n i p͈ a̠ ɭ b u ɾ i ɡ o̞ ɾ e̞
어울리다	ʌ̹ u ɭ ʎ i d a̠
목욕하다	m o̞ ɡ j o kʰ a̠ d a̠
산토끼	sʰ a̠ n tʰ o̞ k͈ i
음운론	ɯ m u ɭ ɭ o̞ n
근삿값	k ɯː n sʰ a̠ t̚ k͈ a̠ p̚
불거지다	p u ɭ ɡ ʌ̹ d͡ʑ i d a̠
쓰리	s͈ ɯ ɾ i
키릴문자	k ç i ɾ i ɭ m u n d͡ʑ a̠
당질	t a̠ ŋ d͡ʑ i ɭ
캐나다기러기	kʰ e̞ n a̠ d a̠ ɡ i ɾ ʌ̹ ɡ i
보스니아	p o̞ sʰ ɯ n i a̠
이트륨	i tʰ ɯ ɾ j u m
왼쪽	w e̞ː n t͡ɕ͈ o̞ k̚
매콤하다	m e̞ kʰ o̞ m ɦ a̠ d a̠
사하라	sʰ a̠ ɦ a̠ ɾ a̠
북한	p u kʰ a̠ n
부신	p uː ɕʰ i n
식생활	ɕʰ i k s͈ e̞ ŋ β w a̠ ɭ
실린더	ɕʰ i ɭ ʎ i n d ʌ̹
명예	m j ʌ̹ ŋ j e̞
콤마	kʰ o̞ m m a̠
적히다	t͡ɕ ʌ̹ k ç i d a̠
개구쟁이	k e̞ ɡ u d͡ʑ e̞ ŋ i
있어	i s͈ ʌ̹
품다	pʰ uː m t͈ a̠
앞두다	a̠ p̚ t͈ u d a̠
비용	p iː j o ŋ
교거	k j o ɡ ʌ̹
따개비	t͈ a̠ ɡ e̞ b i
봉건	p o̞ ŋ ɡ ʌ̹ n
소개	sʰ o̞ ɡ e̞
자기	t͡ɕ a̠ ɡ i
들이다	t ɯ ɾ i d a̠
벌이다	p ɘː ɾ i d a̠
확신	ɸ w a̠ k ɕ͈ i n
얼다	ɘː ɭ d a̠
추진	t͡ɕʰ u d͡ʑ i n
순두부	sʰ u n d u b u
포물선	pʰ o̞ː m u ɭ s͈ ʌ̹ n
공짜	k o̞ ŋ t͡ɕ͈ a̠
주교관	t͡ɕ u ɡ j o ɡ w a̠ n
걸작	k ʌ̹ ɭ t͡ɕ͈ a̠ k̚
시멘트	ɕʰ i m e̞ n tʰ ɯ
만지다	m a̠ n d͡ʑ i d a̠
테오도시우스	tʰ e̞ o̞ d o̞ ɕʰ i u sʰ ɯ
만날	m a̠ː n n a̠ ɭ
목련	m o̞ ŋ ɲ j ʌ̹ n
프로모션	pʰ ɯ ɾ o̞ m o̞ ɕʰ j ʌ̹ n
개발자	k e̞ b a̠ ɭ d͡ʑ a̠
우울	u u ɭ
가로	k a̠ ɾ o̞
인삼	i n sʰ a̠ m
에너지	e̞ n ʌ̹ d͡ʑ i
알데하이드	a̠ ɭ d e̞ ɦ a̠ i d ɯ
십오	ɕʰ i b o̞
모욕하다	m o̞ː j o kʰ a̠ d a̠
고라니	k o̞ ɾ a̠ n i
소나무	sʰ o̞ n a̠ m u
상당	sʰ a̠ ŋ d a̠ ŋ
절강	t͡ɕ ʌ̹ ɭ ɡ a̠ ŋ
분노	p uː n n o̞
부피	p u pʰ i
빗기다	p i t̚ k͈ i d a̠
통가	tʰ o̞ ŋ ɡ a̠
부리	p u ɾ i
소포	sʰ o̞ː pʰ o̞
별표	p j ɘː ɭ pʰ j o
포도탄	pʰ o̞ d o̞ tʰ a̠ n
까자흐스딴	k͈ a̠ d͡ʑ a̠ ɣ ɯ sʰ ɯ t͈ a̠ n
계약하다	k j e̞ː j a̠ kʰ a̠ d a̠
돋보기	t o̞ t̚ p͈ o̞ ɡ i
불가결	p u ɭ ɡ a̠ ɡ j ʌ̹ ɭ
도화뱅어	t o̞ β w a̠ b e̞ ŋ ʌ̹
노인의학	n o̞ː i n ɰ i ɦ a̠ k̚
지켜보다	t͡ɕ i k ç j ʌ̹ b o̞ d a̠
바둑	p a̠ d u k̚
의분	ɰ iː b u n
촉수	t͡ɕʰ o̞ k s͈ u
자원	t͡ɕ a̠ w ʌ̹ n
유학	j u ɦ a̠ k̚
우세	u sʰ e̞
부서지다	p u sʰ ʌ̹ d͡ʑ i d a̠
안마당	a̠ n m a̠ d a̠ ŋ
면서	m j ʌ̹ n sʰ ʌ̹
들르다	t ɯ ɭ ɭ ɯ d a̠
핵폭탄	h e̞ k̚ pʰ o̞ k̚ tʰ a̠ n
중심	t͡ɕ u ŋ ɕʰ i m
초유	t͡ɕʰ o̞ j u
무태장어	m u tʰ e̞ d͡ʑ a̠ ŋ ʌ̹
열병	j ʌ̹ ɭ b j ʌ̹ ŋ
아스마라	a̠ sʰ ɯ m a̠ ɾ a̠
구린내	k u ɾ i n n e̞
모레	m o̞ː ɾ e̞
열하나	j ʌ̹ ɾ ɦ a̠ n a̠
사슴	sʰ a̠ sʰ ɯ m
헝가리	h ʌ̹ ŋ ɡ a̠ ɾ i
수많다	sʰ uː m a̠ n tʰ a̠
세월부대인	sʰ e̞ w ʌ̹ ɭ b u d e̞ i n
에미리트	e̞ m i ɾ i tʰ ɯ
배수관	p e̞ sʰ u ɡ w a̠ n
이해하다	iː ɦ e̞ ɦ a̠ d a̠
불상사	p u ɭ s͈ a̠ ŋ sʰ a̠
흑색종	x ɯ k s͈ e̞ k̚ t͡ɕ͈ o̞ ŋ
불타	p u ɭ tʰ a̠
자선	t͡ɕ a̠ sʰ ʌ̹ n
더럽다	t ɘː ɾ ʌ̹ p̚ t͈ a̠
음욕	ɯ m j o k̚
판자	pʰ a̠ n d͡ʑ a̠
아뢰다	a̠ ɾ w e̞ d a̠
흰뺨검둥오리	ç i n p͈ j a̠ m ɡ ʌ̹ m d u ŋ o̞ ɾ i
헬스클럽	h e̞ ɭ sʰ ɯ k x ɯ ɭ ɭ ʌ̹ p̚
실력	ɕʰ i ɭ ʎ j ʌ̹ k̚
찢어지다	t͡ɕ͈ i d͡ʑ ʌ̹ d͡ʑ i d a̠
아실기	a̠ ɕʰ i ɭ ɡ i
배우	p e̞ u
아이고	a̠ i ɡ o̞
사생자	sʰ a̠ sʰ e̞ ŋ d͡ʑ a̠
소나기	sʰ o̞ n a̠ ɡ i
표현	pʰ j o ʝ j ʌ̹ n
꼬리지느러미	k͈ o̞ ɾ i d͡ʑ i n ɯ ɾ ʌ̹ m i
팝콘	pʰ a̠ p̚ kʰ o̞ n
어란	ʌ̹ ɾ a̠ n
환자	ɸ w a̠ː n d͡ʑ a̠
광석	k w a̠ː ŋ sʰ ʌ̹ k̚
포털	pʰ o̞ tʰ ʌ̹ ɭ
분필	p u n pʰ i ɭ
부풀다	p u pʰ u ɭ d a̠
시험	ɕʰ i ɦ ʌ̹ m
뜸하다	t͈ ɯ m ɦ a̠ d a̠
샛별	sʰ e̞ t̚ p͈ j ʌ̹ ɭ
전어	t͡ɕ ɘː n ʌ̹
카이사르	kʰ a̠ i sʰ a̠ ɾ ɯ
의미	ɰ iː m i
두루미	t u ɾ u m i
쁠류스	p͈ ɯ ɭ ʎ j u sʰ ɯ
노어	n o̞ ʌ̹
참마자	t͡ɕʰ a̠ m m a̠ d͡ʑ a̠
교수	k j oː sʰ u
네이멍구	n e̞ i m ʌ̹ ŋ ɡ u
큰바다사자	k x ɯ n b a̠ d a̠ sʰ a̠ d͡ʑ a̠
노잼	n o̞ d͡ʑ e̞ m
가감	k a̠ ɡ a̠ m
대주교	t e̞ː d͡ʑ u ɡ j o
비행선	p i ɦ e̞ ŋ sʰ ʌ̹ n
무슨	m u sʰ ɯ n
덧붙이다	t ʌ̹ t̚ p͈ u t͡ɕʰ i d a̠
디스프로슘	t i sʰ ɯ pʰ ɯ ɾ o̞ ɕʰ j u m
파다	pʰ a̠ d a̠
자두	t͡ɕ a̠ d u
수학	sʰ u ɦ a̠ k̚
지의류	t͡ɕ i ɰ i ɾ j u
심리학	ɕʰ i m n i ɦ a̠ k̚
면하다	m j ɘː n ɦ a̠ d a̠
순무	sʰ u n m u
실태	ɕʰ i ɭ tʰ e̞
메기	m e̞ː ɡ i
가리개	k a̠ ɾ i ɡ e̞
결석	k j ʌ̹ ɭ s͈ ʌ̹ k̚
보따리	p o̞ t͈ a̠ ɾ i
포로	pʰ o̞ː ɾ o̞
검토	k ɘː m tʰ o̞
신칸센	ɕʰ i n kʰ a̠ n sʰ e̞ n
단순하다	t a̠ n sʰ u n ɦ a̠ d a̠
상호	sʰ a̠ ŋ β o̞
시제	ɕʰ i d͡ʑ e̞
슈크림	ɕʰ j u k x ɯ ɾ i m
알데히드	a̠ ɭ d e̞ ʝ i d ɯ
옆얼굴	j ʌ̹ b ʌ̹ ɭ ɡ u ɭ
석탄	sʰ ʌ̹ k̚ tʰ a̠ n
유로비트	j u ɾ o̞ b i tʰ ɯ
자만	t͡ɕ a̠ m a̠ n
뚱뚱하다	t͈ u ŋ t͈ u ŋ ɦ a̠ d a̠
트림하다	tʰ ɯː ɾ i m ɦ a̠ d a̠
야만인	j a̠ː m a̠ n i n
가면극	k a̠ː m j ʌ̹ n ɡ ɯ k̚
사무실	sʰ a̠ː m u ɕʰ i ɭ
아이폰	a̠ i pʰ o̞ n
민국	m i n ɡ u k̚
채우다	t͡ɕʰ e̞ u d a̠
돕다	t o̞ː p̚ t͈ a̠
알맞다	a̠ ɭ m a̠ t̚ t͈ a̠
갑각	k a̠ p̚ k͈ a̠ k̚
안심해	a̠ n ɕʰ i m ɦ e̞
범부	p ɘː m b u
거품	k ʌ̹ pʰ u m
열다섯	j ʌ̹ ɭ t͈ a̠ sʰ ʌ̹ t̚
정권	t͡ɕ ʌ̹ ŋ k͈ w ʌ̹ n
승진	sʰ ɯ ŋ d͡ʑ i n
미처	m i t͡ɕʰ ʌ̹
앙골라	a̠ ŋ ɡ o̞ ɭ ɭ a̠
뉴질랜드	ɲ j u d͡ʑ i ɭ ɭ e̞ n d ɯ
라볶이	ɾ a̠ b o̞ k͈ i
실업가	ɕʰ i ɾ ʌ̹ p̚ k͈ a̠
실업	ɕʰ i ɾ ʌ̹ p̚
따다	t͈ a̠ d a̠
소주	s͈ o̞ d͡ʑ u
공중전화	k o̞ ŋ d͡ʑ u ŋ d͡ʑ ʌ̹ n β w a̠
작품	t͡ɕ a̠ k̚ pʰ u m
대륙	t e̞ː ɾ j u k̚
쟁이	t͡ɕ e̞ ŋ i
예순	j e̞ sʰ u n
기생물	k i sʰ e̞ ŋ m u ɭ
툰드라	tʰ u n d ɯ ɾ a̠
늦추다	n ɯ t̚ t͡ɕʰ u d a̠
광음사전	k w a̠ ŋ ɯ m sʰ a̠ d͡ʑ ʌ̹ n
공중	k o̞ ŋ d͡ʑ u ŋ
두우쟁이	t u u d͡ʑ e̞ ŋ i
간체	k a̠ n t͡ɕʰ e̞
매달	m e̞ː d a̠ ɭ
노랑	n o̞ ɾ a̠ ŋ
거시기	k ʌ̹ ɕʰ i ɡ i
어감	ɘː ɡ a̠ m
키읔	k ç i ɯ k̚
취하다	t͡ɕʰ ɥ iː ɦ a̠ d a̠
저녁	t͡ɕ ʌ̹ ɲ j ʌ̹ k̚
홍어회	ɸʷ o̞ ŋ ʌ̹ β w e̞
거북이	k ʌ̹ b u ɡ i
물어떼다	m u ɾ ʌ̹ t͈ e̞ d a̠
득녀	t ɯ ŋ ɲ j ʌ̹
꿇다	k͈ u ɭ tʰ a̠
울산	u ɭ s͈ a̠ n
철새	t͡ɕʰ ʌ̹ ɭ s͈ e̞
생선	sʰ e̞ ŋ sʰ ʌ̹ n
우루과이	u ɾ u ɡ w a̠ i
등줄숭어	t ɯ ŋ t͡ɕ͈ u ɭ sʰ u ŋ ʌ̹
제조업	t͡ɕ e̞ː d͡ʑ o̞ ʌ̹ p̚
포플러	pʰ o̞ pʰ ɯ ɭ ɭ ʌ̹
최종	t͡ɕʰ w e̞ː d͡ʑ o̞ ŋ
학급	h a̠ k̚ k͈ ɯ p̚
프로트악티늄	pʰ ɯ ɾ o̞ tʰ ɯ a̠ k̚ tʰ i ɲ j u m
온도	o̞ n d o̞
그레이프프루트	k͈ ɯ ɾ e̞ i pʰ ɯ pʰ ɯ ɾ u tʰ ɯ
말기	m a̠ ɭ ɡ i
알고리즘	a̠ ɭ ɡ o̞ ɾ i d͡ʑ ɯ m
찾아가다	t͡ɕʰ a̠ d͡ʑ a̠ ɡ a̠ d a̠
마음쓰다	m a̠ ɯ m s͈ ɯ d a̠
반복	p a̠ː n b o̞ k̚
구더기	k u d ʌ̹ ɡ i
네로	n e̞ ɾ o̞
파이	pʰ a̠ i
프로그람	pʰ ɯ ɾ o̞ ɡ ɯ ɾ a̠ m
웃다	uː t̚ t͈ a̠
안내서	a̠ː n n e̞ sʰ ʌ̹
노사	n o̞ː sʰ a̠
쌍곡선	s͈ a̠ ŋ ɡ o̞ k s͈ ʌ̹ n
거치적거리다	k ʌ̹ t͡ɕʰ i d͡ʑ ʌ̹ k̚ k͈ ʌ̹ ɾ i d a̠
구리다	k u ɾ i d a̠
널빤지	n ɘː ɭ p͈ a̠ n d͡ʑ i
하물	h a̠ m u ɭ
성전환	sʰ ɘː ŋ d͡ʑ ʌ̹ n β w a̠ n
가수	k a̠ sʰ u
발명	p a̠ ɭ m j ʌ̹ ŋ
대륙종개	t e̞ː ɾ j u k̚ t͡ɕ͈ o̞ ŋ ɡ e̞
중화대북	t͡ɕ u ŋ β w a̠ d e̞ b u k̚
계곡산개구리	k j e̞ ɡ o̞ k s͈ a̠ n ɡ e̞ ɡ u ɾ i
나사돌리개	n a̠ sʰ a̠ d o̞ ɭ ʎ i ɡ e̞
약자	j a̠ k̚ t͡ɕ͈ a̠
방점	p a̠ ŋ t͡ɕ͈ ʌ̹ m
놓이다	n o̞ i d a̠
지진	t͡ɕ i d͡ʑ i n
데이트	t e̞ i tʰ ɯ
폴더	pʰ o̞ ɭ d ʌ̹
구강	k u ɡ a̠ ŋ
생산력	sʰ e̞ ŋ sʰ a̠ ɭ ʎ j ʌ̹ k̚
뽀르뚜갈	p͈ o̞ ɾ ɯ t͈ u ɡ a̠ ɭ
찬사	t͡ɕʰ a̠ː n sʰ a̠
부리다	p u ɾ i d a̠
나방	n a̠ b a̠ ŋ
코알라	kʰ o̞ a̠ ɭ ɭ a̠
옥석	o̞ k s͈ ʌ̹ k̚
바램	p a̠ ɾ e̞ m
왕자	w a̠ː ŋ d͡ʑ a̠
닭발	t a̠ k̚ p͈ a̠ ɭ
재두루미	t͡ɕ e̞ d u ɾ u m i
더브늄	t ʌ̹ b ɯ ɲ j u m
자명금	t͡ɕ a̠ m j ʌ̹ ŋ ɡ ɯ m
고독하다	k o̞ d o̞ kʰ a̠ d a̠
홍합	ɸʷ o̞ ŋ ɦ a̠ p̚
비겁	p iː ɡ ʌ̹ p̚
불만	p u ɭ m a̠ n
이런	i ɾ ʌ̹ n
이디시어	i d i ɕʰ i ʌ̹
금강모치	k ɯ m ɡ a̠ ŋ m o̞ t͡ɕʰ i
미소짓다	m i sʰ o̞ d͡ʑ i t̚ t͈ a̠
사면	sʰ a̠ m j ʌ̹ n
근본	k ɯ n b o̞ n
조립하다	t͡ɕ o̞ ɾ i pʰ a̠ d a̠
치닫다	t͡ɕʰ i d a̠ t̚ t͈ a̠
목적	m o̞ k̚ t͡ɕ͈ ʌ̹ k̚
축사	t͡ɕʰ u k s͈ a̠
엄청나다	ʌ̹ m t͡ɕʰ ʌ̹ ŋ n a̠ d a̠
사이폰	s͈ a̠ i pʰ o̞ n
지도	t͡ɕ i d o̞
카바레	kʰ a̠ b a̠ ɾ e̞
다그치다	t a̠ ɡ ɯ t͡ɕʰ i d a̠
덴마크	t e̞ n m a̠ k x ɯ
배기관	p e̞ ɡ i ɡ w a̠ n
관습	k w a̠ n sʰ ɯ p̚
샤쯔	ɕʰ j a̠ t͡ɕ͈ ɯ
잡수시다	t͡ɕ a̠ p s͈ u ɕʰ i d a̠
몬스터	m o̞ n sʰ ɯ tʰ ʌ̹
명명법	m j ɘː ŋ m j ʌ̹ ŋ b ʌ̹ p̚
리원	ɾ i w ʌ̹ n
상품	sʰ a̠ ŋ pʰ u m
폭풍	pʰ o̞ k̚ pʰ u ŋ
한탄하다	h a̠ː n tʰ a̠ n ɦ a̠ d a̠
쇠오리	sʰ w e̞ o̞ ɾ i
역대급	j ʌ̹ k̚ t͈ e̞ ɡ ɯ p̚
거룩하다	k ɘː ɾ u kʰ a̠ d a̠
쇼핑	ɕ͈ j o pʰ i ŋ
찌개	t͡ɕ͈ i ɡ e̞
메소드	m e̞ sʰ o̞ d ɯ
페럿	pʰ e̞ ɾ ʌ̹ t̚
섬서	sʰ ʌ̹ m sʰ ʌ̹
기업가	k i ʌ̹ p̚ k͈ a̠
확대되다	ɸ w a̠ k̚ t͈ e̞ d w e̞ d a̠
대장	t e̞ː d͡ʑ a̠ ŋ
명칭	m j ʌ̹ ŋ t͡ɕʰ i ŋ
후난	ɸʷ u n a̠ n
더빙	t ʌ̹ b i ŋ
개국	k e̞ ɡ u k̚
이리듐	i ɾ i d j u m
늘어서다	n ɯ ɾ ʌ̹ sʰ ʌ̹ d a̠
작곡자	t͡ɕ a̠ k̚ k͈ o̞ k̚ t͡ɕ͈ a̠
바냐	p a̠ ɲ j a̠
기합	k i ɦ a̠ p̚
유의어	j uː ɰ i ʌ̹
남아프리카	n a̠ m a̠ pʰ ɯ ɾ i kʰ a̠
준말	t͡ɕ uː n m a̠ ɭ
스웨덴어	sʰ ɯ w e̞ d e̞ n ʌ̹
할렐루야	h a̠ ɭ ɭ e̞ ɭ ɭ u j a̠
어깨뼈	ʌ̹ k͈ e̞ p͈ j ʌ̹
주점	t͡ɕ u d͡ʑ ʌ̹ m
삼키다	sʰ a̠ m k ç i d a̠
강추	k a̠ ŋ t͡ɕʰ u
고민	k o̞ m i n
아제티딘	a̠ d͡ʑ e̞ tʰ i d i n
궁중	k u ŋ d͡ʑ u ŋ
종이	t͡ɕ o̞ ŋ i
발인	p a̠ ɾ i n
똑같이	t͈ o̞ k̚ k͈ a̠ t͡ɕʰ i
까맣다	k͈ a̠ː m a̠ tʰ a̠
대검집	t e̞ː ɡ ʌ̹ m d͡ʑ i p̚
최대한	t͡ɕʰ w e̞ː d e̞ ɦ a̠ n
자물쇠	t͡ɕ a̠ m u ɭ s͈ w e̞
인정하다	i n d͡ʑ ʌ̹ ŋ ɦ a̠ d a̠
거세	k ʌ̹ sʰ e̞
개척	k e̞ t͡ɕʰ ʌ̹ k̚
로므니아	ɾ o̞ m ɯ n i a̠
서벌	sʰ ʌ̹ b ʌ̹ ɭ
아무리	a̠ː m u ɾ i
버지니아	p ʌ̹ d͡ʑ i n i a̠
문절망둑	m u n d͡ʑ ʌ̹ ɭ m a̠ ŋ d u k̚
외우다	w e̞ u d a̠
깨어나다	k͈ e̞ ʌ̹ n a̠ d a̠
주식	t͡ɕ u ɕʰ i k̚
만하다	m a̠ n ɦ a̠ d a̠
사상	sʰ a̠ː sʰ a̠ ŋ
미분	m i b u n
각주구검	k a̠ k̚ t͡ɕ͈ u ɡ u ɡ ʌ̹ m
붉은왜가리	p u ɭ ɡ ɯ n w e̞ ɡ a̠ ɾ i
설치	sʰ ʌ̹ ɭ t͡ɕʰ i
포트루이스	pʰ o̞ tʰ ɯ ɾ u i sʰ ɯ
김일성화	k i m i ɭ sʰ ʌ̹ ŋ β w a̠
수박	sʰ uː b a̠ k̚
연결	j ʌ̹ n ɡ j ʌ̹ ɭ
신호	ɕʰ iː n β o̞
양쪽	j a̠ː ŋ t͡ɕ͈ o̞ k̚
인도네시아어	i n d o̞ n e̞ ɕʰ i a̠ ʌ̹
행복하다	h e̞ː ŋ b o̞ kʰ a̠ d a̠
짓궂다	t͡ɕ iː t̚ k͈ u t̚ t͈ a̠
고춧가루	k o̞ t͡ɕʰ u t̚ k͈ a̠ ɾ u
습기	sʰ ɯ p̚ k͈ i
결점	k j ʌ̹ ɭ t͡ɕ͈ ʌ̹ m
탐정	tʰ a̠ m d͡ʑ ʌ̹ ŋ
무선전화	m u sʰ ʌ̹ n d͡ʑ ʌ̹ n β w a̠
내일	n e̞ i ɭ
설교	sʰ ʌ̹ ɭ ɡ j o
매매	m e̞ m e̞
북방애기박쥐	p u k̚ p͈ a̠ ŋ e̞ ɡ i b a̠ k̚ t͡ɕ͈ ɥ i
카페	k͈ a̠ pʰ e̞
단지	t a̠ n d͡ʑ i
나타나다	n a̠ tʰ a̠ n a̠ d a̠
멜론	m e̞ ɭ ɭ o̞ n
방금	p a̠ ŋ ɡ ɯ m
점잖다	t͡ɕ ɘː m d͡ʑ a̠ n tʰ a̠
나오다	n a̠ o̞ d a̠
이단	iː d a̠ n
리옹	ɾ i o̞ ŋ
원폭	w ʌ̹ n pʰ o̞ k̚
모르폴린	m o̞ ɾ ɯ pʰ o̞ ɭ ʎ i n
별별	p j ʌ̹ ɭ b j ʌ̹ ɭ
감각적	k a̠ m ɡ a̠ k̚ t͡ɕ͈ ʌ̹ k̚
이성	i sʰ ʌ̹ ŋ
분류학	p u ɭ ʎ j u ɦ a̠ k̚
문둥이박쥐	m u n d u ŋ i b a̠ k̚ t͡ɕ͈ ɥ i
임신부	iː m ɕʰ i n b u
여러분	j ʌ̹ ɾ ʌ̹ b u n
쇠황조롱이	sʰ w e̞ β w a̠ ŋ d͡ʑ o̞ ɾ o̞ ŋ i
양봉가	j a̠ː ŋ b o̞ ŋ ɡ a̠
옥상	o̞ k s͈ a̠ ŋ
럭비	ɾ ʌ̹ k̚ p͈ i
요구하다	j o ɡ u ɦ a̠ d a̠
매끄럽다	m e̞ k͈ ɯ ɾ ʌ̹ p̚ t͈ a̠
초대	t͡ɕʰ o̞ d e̞
십자선	ɕʰ i p̚ t͡ɕ͈ a̠ sʰ ʌ̹ n
정찰병	t͡ɕ ʌ̹ ŋ t͡ɕʰ a̠ ɭ b j ʌ̹ ŋ
홍어	ɸʷ o̞ ŋ ʌ̹
민물검정망둑	m i n m u ɭ ɡ ʌ̹ m d͡ʑ ʌ̹ ŋ m a̠ ŋ d u k̚
섬짱깨	sʰ ɘː m t͡ɕ͈ a̠ ŋ k͈ e̞
겹다	k j ɘː p̚ t͈ a̠
같이하다	k a̠ t͡ɕʰ i ɦ a̠ d a̠
연맹	j ʌ̹ n m e̞ ŋ
가시어머니	k a̠ ɕʰ i ʌ̹ m ʌ̹ n i
외치다	w e̞ t͡ɕʰ i d a̠
프리지어	pʰ ɯ ɾ i d͡ʑ i ʌ̹
문장	m u n d͡ʑ a̠ ŋ
아침놀	a̠ t͡ɕʰ i m n o̞ ɭ
목면	m o̞ ŋ m j ʌ̹ n
세입자	sʰ e̞ː i p̚ t͡ɕ͈ a̠
치어리딩	t͡ɕʰ i ʌ̹ ɾ i d i ŋ
포르피린	pʰ o̞ ɾ ɯ pʰ i ɾ i n
둥간어	t u ŋ ɡ a̠ n ʌ̹
양성애자	j a̠ː ŋ sʰ ʌ̹ ŋ e̞ d͡ʑ a̠
사마륨	sʰ a̠ m a̠ ɾ j u m
꼭두각시	k͈ o̞ k̚ t͈ u ɡ a̠ k ɕ͈ i
불사조	p u ɭ s͈ a̠ d͡ʑ o̞
편찮다	pʰ j ʌ̹ n t͡ɕʰ a̠ n tʰ a̠
보륨	p o̞ ɾ j u m
개벽	k e̞ b j ʌ̹ k̚
고루	k o̞ ɾ u
꽂다	k͈ o̞ t̚ t͈ a̠
창조	t͡ɕʰ a̠ ŋ d͡ʑ o̞
예의	j e̞ ɰ i
퍼센트	pʰ ʌ̹ sʰ e̞ n tʰ ɯ
약점	j a̠ k̚ t͡ɕ͈ ʌ̹ m
천하	t͡ɕʰ ʌ̹ n ɦ a̠
장난감	t͡ɕ a̠ ŋ n a̠ n k͈ a̠ m
내몽고	n e̞ m o̞ ŋ ɡ o̞
물시계	m u ɭ ɕ͈ i ɡ j e̞
주차	t͡ɕ uː t͡ɕʰ a̠
몫몫이	m o̞ ŋ m o̞ k ɕ͈ i
평판	pʰ j ɘː ŋ pʰ a̠ n
수바	sʰ u b a̠
주장	t͡ɕ u d͡ʑ a̠ ŋ
분리	p u ɭ ʎ i
매화	m e̞ β w a̠
참으로	t͡ɕʰ a̠ m ɯ ɾ o̞
일어나다	i ɾ ʌ̹ n a̠ d a̠
종이접기	t͡ɕ o̞ ŋ i d͡ʑ ʌ̹ p̚ k͈ i
손상하다	sʰ o̞ː n sʰ a̠ ŋ ɦ a̠ d a̠
헝가리어	h ʌ̹ ŋ ɡ a̠ ɾ i ʌ̹
겸손하다	k j ʌ̹ m sʰ o̞ n ɦ a̠ d a̠
써레	s͈ ʌ̹ ɾ e̞
황새	ɸ w a̠ː ŋ sʰ e̞
담기다	t a̠ m ɡ i d a̠
달무리	t a̠ ɭ m u ɾ i
성장하다	sʰ ʌ̹ ŋ d͡ʑ a̠ ŋ ɦ a̠ d a̠
도마뱀	t o̞ m a̠ b e̞ m
선인장	sʰ ʌ̹ n i n d͡ʑ a̠ ŋ
지나	t͡ɕ i n a̠
지름길	t͡ɕ i ɾ ɯ m ɡ i ɭ
지난	t͡ɕ i n a̠ n
저분	t͡ɕ ʌ̹ b u n
보내다	p o̞ n e̞ d a̠
차장	t͡ɕʰ a̠ d͡ʑ a̠ ŋ
항생물질	h a̠ː ŋ sʰ e̞ ŋ m u ɭ t͡ɕ͈ i ɭ
앞뒤	a̠ p̚ t͈ ɥ i
루안다	ɾ u a̠ n d a̠
정수리	t͡ɕ ɘː ŋ sʰ u ɾ i
인대	i n d e̞
유전자	j u d͡ʑ ʌ̹ n d͡ʑ a̠
좋다	t͡ɕ o̞ː tʰ a̠
여기	j ʌ̹ ɡ i
초기	t͡ɕʰ o̞ ɡ i
두통	t u tʰ o̞ ŋ
저자	t͡ɕ ʌ̹ d͡ʑ a̠
빨찌산	p͈ a̠ ɭ t͡ɕ͈ i sʰ a̠ n
이거	i ɡ ʌ̹
의미하다	ɰ iː m i ɦ a̠ d a̠
맞부딪치다	m a̠ t̚ p͈ u d i t̚ t͡ɕʰ i d a̠
반물질	p a̠ː n m u ɭ t͡ɕ͈ i ɭ
효소학	ç j o sʰ o̞ ɦ a̠ k̚
파슬리	pʰ a̠ sʰ ɯ ɭ ʎ i
대만	t e̞ m a̠ n
혈액학	ç j ɘː ɾ e̞ kʰ a̠ k̚
실례	ɕʰ i ɭ ʎ j e̞
발사	p a̠ ɭ s͈ a̠
난로	n a̠ː ɭ ɭ o̞
돈가스	t o̞ n ɡ a̠ sʰ ɯ
지저귀다	t͡ɕ i d͡ʑ ʌ̹ ɡ ɥ i d a̠
생머리	sʰ e̞ ŋ m ʌ̹ ɾ i
태극기	tʰ e̞ ɡ ɯ k̚ k͈ i
격납고	k j ʌ̹ ŋ n a̠ p̚ k͈ o̞
갖가지	k a̠ t̚ k͈ a̠ d͡ʑ i
역원	j ʌ̹ ɡ w ʌ̹ n
통합	tʰ o̞ː ŋ ɦ a̠ p̚
골반	k o̞ ɭ b a̠ n
척추	t͡ɕʰ ʌ̹ k̚ t͡ɕʰ u
소비에트	sʰ o̞ b i e̞ tʰ ɯ
외손녀	w e̞ː sʰ o̞ n ɲ j ʌ̹
덩치	t ʌ̹ ŋ t͡ɕʰ i
모듈	m o̞ d j u ɭ
오월	o̞ː w ʌ̹ ɭ
플립플롭	pʰ ɯ ɭ ʎ i p̚ pʰ ɯ ɭ ɭ o̞ p̚
구하다	k u ɦ a̠ d a̠
아브라함	a̠ b ɯ ɾ a̠ ɦ a̠ m
제자	t͡ɕ e̞ː d͡ʑ a̠
제작	t͡ɕ e̞ː d͡ʑ a̠ k̚
백미러	p͈ e̞ ŋ m i ɾ ʌ̹
각막	k a̠ ŋ m a̠ k̚
꼬치	k͈ o̞ t͡ɕʰ i
차분법	t͡ɕʰ a̠ b u n b ʌ̹ p̚
출장	t͡ɕʰ u ɭ t͡ɕ͈ a̠ ŋ
관상동맥질환	k w a̠ n sʰ a̠ ŋ d o̞ ŋ m e̞ k̚ t͡ɕ͈ i ɾ β w a̠ n
안녕하다	a̠ n ɲ j ʌ̹ ŋ ɦ a̠ d a̠
관박쥐	k w a̠ n b a̠ k̚ t͡ɕ͈ ɥ i
안전하다	a̠ n d͡ʑ ʌ̹ n ɦ a̠ d a̠
폐하	pʰ j e̞ ɦ a̠
인형극	i n ʝ j ʌ̹ ŋ ɡ ɯ k̚
도저히	t o̞ː d͡ʑ ʌ̹ ʝ i
간질	k a̠ː n d͡ʑ i ɭ
참석하다	t͡ɕʰ a̠ m sʰ ʌ̹ kʰ a̠ d a̠
스톡홀름	sʰ ɯ tʰ o̞ kʰ o̞ ɭ ɭ ɯ m
남녀	n a̠ m ɲ j ʌ̹
관계없이	k w a̠ n ɡ j e̞ ʌ̹ p ɕ͈ i
주목하다	t͡ɕ u m o̞ kʰ a̠ d a̠
체스꼬슬로벤스꼬	t͡ɕʰ e̞ sʰ ɯ k͈ o̞ sʰ ɯ ɭ ɭ o̞ b e̞ n sʰ ɯ k͈ o̞
꼬마향고래	k͈ o̞ m a̠ ʝ j a̠ ŋ ɡ o̞ ɾ e̞
가마치	k a̠ m a̠ t͡ɕʰ i
햄버거	h e̞ m b ʌ̹ ɡ ʌ̹
옮아가다	o̞ ɭ m a̠ ɡ a̠ d a̠
탄화수소	tʰ a̠ː n β w a̠ sʰ u sʰ o̞
가을	k a̠ ɯ ɭ
가시다	k a̠ ɕʰ i d a̠
데바나가리	t e̞ b a̠ n a̠ ɡ a̠ ɾ i
아이슬란드어	a̠ i sʰ ɯ ɭ ɭ a̠ n d ɯ ʌ̹
공화국	k o̞ː ŋ β w a̠ ɡ u k̚
테이블	tʰ e̞ i b ɯ ɭ
병기창	p j ʌ̹ ŋ ɡ i t͡ɕʰ a̠ ŋ
나일틸라피아	n a̠ i ɭ tʰ i ɭ ɭ a̠ pʰ i a̠
나치즘	n a̠ t͡ɕʰ i d͡ʑ ɯ m
포옹하다	pʰ o̞ː o̞ ŋ ɦ a̠ d a̠
비유	p i j u
순간	sʰ u n ɡ a̠ n
동무	t o̞ ŋ m u
고객	k o̞ ɡ e̞ k̚
아드님	a̠ d ɯ n i m
노동조합	n o̞ d o̞ ŋ d͡ʑ o̞ ɦ a̠ p̚
교체	k j o t͡ɕʰ e̞
그룹	k ɯ ɾ u p̚
근지럽다	k ɯ n d͡ʑ i ɾ ʌ̹ p̚ t͈ a̠
질리다	t͡ɕ i ɭ ʎ i d a̠
진공청소기	t͡ɕ i n ɡ o̞ ŋ t͡ɕʰ ʌ̹ ŋ sʰ o̞ ɡ i
차드	t͡ɕʰ a̠ d ɯ
경찰서	k j ɘː ŋ t͡ɕʰ a̠ ɭ s͈ ʌ̹
만유인력	m a̠ː ɲ j u i ɭ ʎ j ʌ̹ k̚
주스	t͡ɕ u sʰ ɯ
벌다	p ɘː ɭ d a̠
부럽다	p u ɾ ʌ̹ p̚ t͈ a̠
케이크	kʰ e̞ i k x ɯ
쓰레받기	s͈ ɯ ɾ e̞ b a̠ t̚ k͈ i
탁구	tʰ a̠ k̚ k͈ u
물소	m u ɭ s͈ o̞
약력	j a̠ ŋ ɲ j ʌ̹ k̚
날갯죽지	n a̠ ɭ ɡ e̞ t̚ t͡ɕ͈ u k̚ t͡ɕ͈ i
유리잔	j u ɾ i d͡ʑ a̠ n
정부	t͡ɕ ʌ̹ ŋ b u
분명히	p u n m j ʌ̹ ŋ ʝ i
이따가	i t͈ a̠ ɡ a̠
게사니	k e̞ sʰ a̠ n i
순교자	sʰ u n ɡ j o d͡ʑ a̠
병아	p j ɘː ŋ a̠
품사	pʰ uː m sʰ a̠
보상	p o̞ː sʰ a̠ ŋ
굴다	k u ɭ d a̠
용이하다	j o ŋ i ɦ a̠ d a̠
왕조	w a̠ ŋ d͡ʑ o̞
아무	a̠ː m u
새집	sʰ e̞ d͡ʑ i p̚
주사기	t͡ɕ uː sʰ a̠ ɡ i
각하	k a̠ kʰ a̠
속속들이	sʰ o̞ k s͈ o̞ k̚ t͈ ɯ ɾ i
무스카트	m u sʰ ɯ kʰ a̠ tʰ ɯ
인삼차	i n sʰ a̠ m t͡ɕʰ a̠
악몽	a̠ ŋ m o̞ ŋ
중매인	t͡ɕ u ŋ m e̞ i n
사정	sʰ a̠ː d͡ʑ ʌ̹ ŋ
바래다	p a̠ ɾ e̞ d a̠
조미료	t͡ɕ o̞ m i ɾ j o
반복하다	p a̠ n b o̞ kʰ a̠ d a̠
치안	t͡ɕʰ i a̠ n
남월	n a̠ m w ʌ̹ ɭ
서리	sʰ ʌ̹ ɾ i
수말	sʰ u m a̠ ɭ
마다가스카르	m a̠ d a̠ ɡ a̠ sʰ ɯ kʰ a̠ ɾ ɯ
탈륨	tʰ a̠ ɭ ʎ j u m
교의	k j oː ɰ i
재떨이	t͡ɕ e̞ t͈ ʌ̹ ɾ i
해도	h e̞ː d o̞
가격	k a̠ ɡ j ʌ̹ k̚
뿔논병아리	p͈ u ɭ ɭ o̞ n b j ʌ̹ ŋ a̠ ɾ i
화장	ɸ w a̠ d͡ʑ a̠ ŋ
마태오	m a̠ tʰ e̞ o̞
자극	t͡ɕ a̠ː ɡ ɯ k̚
놓다	n o̞ tʰ a̠
까먹다	k͈ a̠ m ʌ̹ k̚ t͈ a̠
제의	t͡ɕ e̞ ɰ i
약사	j a̠ k s͈ a̠
천갈궁	t͡ɕʰ ʌ̹ n ɡ a̠ ɭ ɡ u ŋ
범주	p ɘː m d͡ʑ u
거기	k ʌ̹ ɡ i
이딸리아	i t͈ a̠ ɭ ʎ i a̠
트리폴리	tʰ ɯ ɾ i pʰ o̞ ɭ ʎ i
위치	ɥ i t͡ɕʰ i
엽궐련	j ʌ̹ p̚ k͈ w ʌ̹ ɭ ʎ j ʌ̹ n
휴식하다	ç j u ɕʰ i kʰ a̠ d a̠
궁수	k u ŋ sʰ u
조세	t͡ɕ o̞ sʰ e̞
비단길	p iː d a̠ n k͈ i ɭ
운전	u n d͡ʑ ʌ̹ n
질병	t͡ɕ i ɭ b j ʌ̹ ŋ
신경	ɕʰ i n ɡ j ʌ̹ ŋ
해태	h e̞ tʰ e̞
부족하다	p u d͡ʑ o̞ kʰ a̠ d a̠
찔리다	t͡ɕ͈ i ɭ ʎ i d a̠
죽부인	t͡ɕ u k̚ p͈ u i n
청량음료	t͡ɕʰ ʌ̹ ŋ ɲ j a̠ ŋ ɯ m ɲ j o
누구	n u ɡ u
울란바토르	u ɭ ɭ a̠ n b a̠ tʰ o̞ ɾ ɯ
피리미딘	pʰ i ɾ i m i d i n
맛없다	m a̠ d ʌ̹ p̚ t͈ a̠
주석	t͡ɕ u sʰ ʌ̹ k̚
파인더	pʰ a̠ i n d ʌ̹
걱정되다	k ʌ̹ k̚ t͡ɕ͈ ʌ̹ ŋ d w e̞ d a̠
벌기다	p ʌ̹ ɭ ɡ i d a̠
여제	j ʌ̹ d͡ʑ e̞
피라진	pʰ i ɾ a̠ d͡ʑ i n
아씨	a̠ː ɕ͈ i
색깔	sʰ e̞ k̚ k͈ a̠ ɭ
고이다	k o̞ i d a̠
여전하다	j ʌ̹ d͡ʑ ʌ̹ n ɦ a̠ d a̠
수풀	sʰ u pʰ u ɭ
북서	p u k s͈ ʌ̹
탱크	tʰ e̞ ŋ k x ɯ
전구	t͡ɕ ɘː n ɡ u
짜다	t͡ɕ͈ a̠ d a̠
바삭바삭하다	p a̠ sʰ a̠ k̚ p͈ a̠ sʰ a̠ kʰ a̠ d a̠
독특하다	t o̞ k̚ tʰ ɯ kʰ a̠ d a̠
더러워지다	t ɘː ɾ ʌ̹ w ʌ̹ d͡ʑ i d a̠
명명하다	m j ɘː ŋ m j ʌ̹ ŋ ɦ a̠ d a̠
존재하다	t͡ɕ o̞ n d͡ʑ e̞ ɦ a̠ d a̠
어색하다	ɘː sʰ e̞ kʰ a̠ d a̠
강철	k a̠ ŋ t͡ɕʰ ʌ̹ ɭ
유지	j u d͡ʑ i
고수	k o̞ sʰ u
저고리	t͡ɕ ʌ̹ ɡ o̞ ɾ i
고백하다	k o̞ b e̞ kʰ a̠ d a̠
주둥치	t͡ɕ u d u ŋ t͡ɕʰ i
친근하다	t͡ɕʰ i n ɡ ɯ n ɦ a̠ d a̠
사뿐사뿐	sʰ a̠ p͈ u n sʰ a̠ p͈ u n
속견	sʰ o̞ k̚ k͈ j ʌ̹ n
운반	u n b a̠ n
선상	sʰ ʌ̹ n sʰ a̠ ŋ
베냉	p e̞ n e̞ ŋ
수다	sʰ uː d a̠
초보자	t͡ɕʰ o̞ b o̞ d͡ʑ a̠
루페	ɾ u pʰ e̞
출생하다	t͡ɕʰ u ɭ s͈ e̞ ŋ ɦ a̠ d a̠
통역자	tʰ o̞ ŋ j ʌ̹ k̚ t͡ɕ͈ a̠
논리	n o̞ ɭ ʎ i
캐넌	kʰ e̞ n ʌ̹ n
교사	k j oː sʰ a̠
이익	iː i k̚
혹은	ɸʷ o̞ ɡ ɯ n
남학생	n a̠ m ɦ a̠ k s͈ e̞ ŋ
안타깝다	a̠ n tʰ a̠ k͈ a̠ p̚ t͈ a̠
놀라움	n o̞ː ɭ ɭ a̠ u m
군주제	k u n d͡ʑ u d͡ʑ e̞
미싸일	m i s͈ a̠ i ɭ
밀라노	m i ɭ ɭ a̠ n o̞
촌락	t͡ɕʰ o̞ː ɭ ɭ a̠ k̚
해넘이	h e̞ n ʌ̹ m i
부딪다	p u d i t̚ t͈ a̠
강도다리	k a̠ ŋ d o̞ d a̠ ɾ i
구전	k u d͡ʑ ʌ̹ n
신다	ɕʰ iː n t͈ a̠
양성애	j a̠ː ŋ sʰ ʌ̹ ŋ e̞
공세	k o̞ː ŋ sʰ e̞
수영장	sʰ u j ʌ̹ ŋ d͡ʑ a̠ ŋ
그리하여	k ɯ ɾ i ɦ a̠ j ʌ̹
순위	sʰ uː n ɥ i
뜬소문	t͈ ɯ n sʰ o̞ m u n
가르다	k a̠ ɾ ɯ d a̠
정확히	t͡ɕ ɘː ŋ β w a̠ k ç i
솔개	sʰ o̞ ɭ ɡ e̞
생리학	sʰ e̞ ŋ n i ɦ a̠ k̚
남자아이	n a̠ m d͡ʑ a̠ a̠ i
차이나타운	t͡ɕʰ a̠ i n a̠ tʰ a̠ u n
마련하다	m a̠ ɾ j ʌ̹ n ɦ a̠ d a̠
검독수리	k ʌ̹ m d o̞ k s͈ u ɾ i
가곡	k a̠ ɡ o̞ k̚
킬로미터	k ç i ɭ ɭ o̞ m i tʰ ʌ̹
멜키체덱	m e̞ ɭ k ç i t͡ɕʰ e̞ d e̞ k̚
신념	ɕʰ iː n ɲ j ʌ̹ m
구축함	k u t͡ɕʰ u kʰ a̠ m
폴란드	pʰ o̞ ɭ ɭ a̠ n d ɯ
내부	n e̞ː b u
돼지꿈	t w e̞ː d͡ʑ i k͈ u m
성부	sʰ ɘː ŋ b u
해쓱하다	h e̞ s͈ ɯ kʰ a̠ d a̠
낯설다	n a̠ t̚ s͈ ʌ̹ ɭ d a̠
십일	ɕʰ i b i ɭ
얽매이다	ʌ̹ ŋ m e̞ i d a̠
모자라다	m o̞ː d͡ʑ a̠ ɾ a̠ d a̠
석방	sʰ ʌ̹ k̚ p͈ a̠ ŋ
진출	t͡ɕ iː n t͡ɕʰ u ɭ
구역	k u j ʌ̹ k̚
학용품	h a̠ ɡ j o ŋ pʰ u m
히프	ç i pʰ ɯ
고생	k o̞ sʰ e̞ ŋ
혼돈	ɸʷ o̞ n d o̞ n
으로	ɯ ɾ o̞
산불	sʰ a̠ n b u ɭ
공동체	k o̞ː ŋ d o̞ ŋ t͡ɕʰ e̞
관용구	k w a̠ ɲ j o ŋ ɡ u
야망	j a̠ː m a̠ ŋ
요약하다	j o j a̠ kʰ a̠ d a̠
불바다	p u ɭ b a̠ d a̠
시다	ɕʰ i d a̠
구치소	k u t͡ɕʰ i sʰ o̞
붙여넣기	p u tʰ j ʌ̹ n ʌ̹ k ç i
수시로	sʰ u ɕʰ i ɾ o̞
계산서	k j e̞ː sʰ a̠ n sʰ ʌ̹
이마	i m a̠
보고하다	p o̞ː ɡ o̞ ɦ a̠ d a̠
잡채	t͡ɕ a̠ p̚ t͡ɕʰ e̞
아티스트	a̠ tʰ i sʰ ɯ tʰ ɯ
아스타틴	a̠ sʰ ɯ tʰ a̠ tʰ i n
소믈리에	sʰ o̞ m ɯ ɭ ʎ i e̞
레위기	ɾ e̞ ɥ i ɡ i
작은관코박쥐	t͡ɕ a̠ ɡ ɯ n ɡ w a̠ n kʰ o̞ b a̠ k̚ t͡ɕ͈ ɥ i
부제	p uː d͡ʑ e̞
뢴트게늄	ɾ w e̞ n tʰ ɯ ɡ e̞ ɲ j u m
다녀오다	t a̠ ɲ j ʌ̹ o̞ d a̠
관광	k w a̠ n ɡ w a̠ ŋ
문학	m u n ɦ a̠ k̚
저지하다	t͡ɕ ʌ̹ d͡ʑ i ɦ a̠ d a̠
자막	t͡ɕ a̠ m a̠ k̚
돌연	t o̞ ɾ j ʌ̹ n
평일	pʰ j ʌ̹ ŋ i ɭ
한담하다	h a̠ n d a̠ m ɦ a̠ d a̠
말리	m a̠ ɭ ʎ i
구성하다	k u sʰ ʌ̹ ŋ ɦ a̠ d a̠
홍당무	ɸʷ o̞ ŋ d a̠ ŋ m u
펴다	pʰ j ʌ̹ d a̠
대다수	t e̞ː d a̠ sʰ u
일자	i ɭ t͡ɕ͈ a̠
따름	t͈ a̠ ɾ ɯ m
미지수	m iː d͡ʑ i sʰ u
적도	t͡ɕ ʌ̹ k̚ t͈ o̞
전지	t͡ɕ ɘː n d͡ʑ i
그늘	k ɯ n ɯ ɭ
긴급	k i n ɡ ɯ p̚
극작가	k ɯ k̚ t͡ɕ͈ a̠ k̚ k͈ a̠
내다보다	n e̞ d a̠ b o̞ d a̠
곤색	k o̞ n sʰ e̞ k̚
떡납줄갱이	t͈ ʌ̹ ŋ n a̠ p̚ t͡ɕ͈ u ɭ ɡ e̞ ŋ i
대여섯	t e̞ː j ʌ̹ sʰ ʌ̹ t̚
외삼촌	w e̞ː sʰ a̠ m t͡ɕʰ o̞ n
부루퉁이	p u ɾ u tʰ u ŋ i
경성	k j ʌ̹ ŋ sʰ ʌ̹ ŋ
이케바나	i kʰ e̞ b a̠ n a̠
얕다	j a̠ t̚ t͈ a̠
꺼지다	k͈ ʌ̹ d͡ʑ i d a̠
냉이	n e̞ ŋ i
캐릭터	kʰ e̞ ɾ i k̚ tʰ ʌ̹
쇠기러기	sʰ w e̞ ɡ i ɾ ʌ̹ ɡ i
연구원생	j ʌ̹ n ɡ u w ʌ̹ n sʰ e̞ ŋ
좀비	t͡ɕ o̞ m b i
회의하다	ɸ w e̞ ɰ i ɦ a̠ d a̠
사태	sʰ a̠ tʰ e̞
더불어	t ʌ̹ b u ɾ ʌ̹
ㅇㅇ	i ɯ ŋ i ɯ ŋ
처럼	t͡ɕʰ ʌ̹ ɾ ʌ̹ m
호놀룰루	ɸʷ o̞ n o̞ ɭ ɭ u ɭ ɭ u
녀석	ɲ j ʌ̹ sʰ ʌ̹ k̚
부동산	p u d o̞ ŋ sʰ a̠ n
변수	p j ɘː n sʰ u
스톤헨지	sʰ ɯ tʰ o̞ n ɦ e̞ n d͡ʑ i
료리	ɾ j o ɾ i
삼바	sʰ a̠ m b a̠
비극	p iː ɡ ɯ k̚
우웩	u w e̞ k̚
노면전차	n o̞ m j ʌ̹ n d͡ʑ ʌ̹ n t͡ɕʰ a̠
아지	a̠ d͡ʑ i
콜라보레이션	kʰ o̞ ɭ ɭ a̠ b o̞ ɾ e̞ i ɕʰ j ʌ̹ n
노처녀	n o̞ː t͡ɕʰ ʌ̹ ɲ j ʌ̹
많아지다	m a̠ː n a̠ d͡ʑ i d a̠
철갑상어	t͡ɕʰ ʌ̹ ɭ ɡ a̠ p s͈ a̠ ŋ ʌ̹
흘러가다	x ɯ ɭ ɭ ʌ̹ ɡ a̠ d a̠
일각수	i ɭ ɡ a̠ k s͈ u
짭새	t͡ɕ͈ a̠ p s͈ e̞
부처님	p u t͡ɕʰ ʌ̹ n i m
입맞춤	i m m a̠ t̚ t͡ɕʰ u m
레이저	ɾ e̞ i d͡ʑ ʌ̹
멧밭쥐	m e̞ t̚ p͈ a̠ t̚ t͡ɕ͈ ɥ i
칠성말배꼽	t͡ɕʰ i ɭ s͈ ʌ̹ ŋ m a̠ ɭ b e̞ k͈ o̞ p̚
수라	sʰ u ɾ a̠
일없다	iː ɾ ʌ̹ p̚ t͈ a̠
유능하다	j u n ɯ ŋ ɦ a̠ d a̠
납치	n a̠ p̚ t͡ɕʰ i
광원	k w a̠ ŋ w ʌ̹ n
지질학	t͡ɕ i d͡ʑ i ɾ ɦ a̠ k̚
미루다	m i ɾ u d a̠
부쿠레슈티	p u kʰ u ɾ e̞ ɕʰ j u tʰ i
피폭자	pʰ i pʰ o̞ k̚ t͡ɕ͈ a̠
걸다	k ɘː ɭ d a̠
실체	ɕʰ i ɭ t͡ɕʰ e̞
캡스턴	kʰ e̞ p s͈ ɯ tʰ ʌ̹ n
사장	sʰ a̠ d͡ʑ a̠ ŋ
이전	iː d͡ʑ ʌ̹ n
십각형	ɕʰ i p̚ k͈ a̠ k ç j ʌ̹ ŋ
위생	ɥ i sʰ e̞ ŋ
휘파람	h ɥ i pʰ a̠ ɾ a̠ m
온종일	o̞ː n d͡ʑ o̞ ŋ i ɭ
용상어	j o ŋ sʰ a̠ ŋ ʌ̹
호프	ɸʷ o̞ pʰ ɯ
발톱	p a̠ ɭ tʰ o̞ p̚
말고기	m a̠ ɭ ɡ o̞ ɡ i
천식	t͡ɕʰ ɘː n ɕʰ i k̚
아픔	a̠ pʰ ɯ m
미스터	m i sʰ ɯ tʰ ʌ̹
분사	p u n sʰ a̠
추출	t͡ɕʰ u t͡ɕʰ u ɭ
자장노래	t͡ɕ a̠ d͡ʑ a̠ ŋ n o̞ ɾ e̞
줄다	t͡ɕ uː ɭ d a̠
리스본	ɾ i sʰ ɯ b o̞ n
낮다	n a̠ t̚ t͈ a̠
많이	m a̠ː n i
복도	p o̞ k̚ t͈ o̞
구상	k u sʰ a̠ ŋ
설립하다	sʰ ʌ̹ ɭ ʎ i pʰ a̠ d a̠
소유	sʰ o̞ː j u
적절하다	t͡ɕ ʌ̹ k̚ t͡ɕ͈ ʌ̹ ɾ ɦ a̠ d a̠
빛내다	p i n n e̞ d a̠
화이팅	ɸ w a̠ i tʰ i ŋ
베이징	p e̞ i d͡ʑ i ŋ
칠월	t͡ɕʰ i ɾ w ʌ̹ ɭ
흥분하다	x ɯ ŋ b u n ɦ a̠ d a̠
완곡어법	w a̠ː n ɡ o̞ ɡ ʌ̹ b ʌ̹ p̚
날고기	n a̠ ɭ ɡ o̞ ɡ i
동시	t o̞ː ŋ ɕʰ i
군데	k u n d e̞
배달	p e̞ː d a̠ ɭ
어쩌다	ʌ̹ t͡ɕ͈ ʌ̹ d a̠
타이완	tʰ a̠ i w a̠ n
중앙	t͡ɕ u ŋ a̠ ŋ
내전	n e̞ d͡ʑ ʌ̹ n
사양하다	sʰ a̠ j a̠ ŋ ɦ a̠ d a̠
베릴륨	p e̞ ɾ i ɭ ʎ j u m
가로막	k a̠ ɾ o̞ m a̠ k̚
블라우스	p ɯ ɭ ɭ a̠ u sʰ ɯ
몬순	m o̞ n sʰ u n
셀카	sʰ e̞ ɭ kʰ a̠
치맥	t͡ɕʰ i m e̞ k̚
가능하다	k a̠ː n ɯ ŋ ɦ a̠ d a̠
친할아버지	t͡ɕʰ i n ɦ a̠ ɾ a̠ b ʌ̹ d͡ʑ i
유엔	j u e̞ n
산시	sʰ a̠ n ɕʰ i
줄곧	t͡ɕ u ɭ ɡ o̞ t̚
호숫가	ɸʷ o̞ sʰ u t̚ k͈ a̠
하다	h a̠ d a̠
흰발망둑	ç i n b a̠ ɭ m a̠ ŋ d u k̚
들어오다	t ɯ ɾ ʌ̹ o̞ d a̠
콜호스	kʰ o̞ ɾ β o̞ sʰ ɯ
전통	t͡ɕ ʌ̹ n tʰ o̞ ŋ
뵙다	p w e̞ p̚ t͈ a̠
출신	t͡ɕʰ u ɭ ɕ͈ i n
확실하다	ɸ w a̠ k ɕ͈ i ɾ ɦ a̠ d a̠
소령	sʰ o̞ː ɾ j ʌ̹ ŋ
왜년	w e̞ ɲ j ʌ̹ n
운수	u n sʰ u
치리	t͡ɕʰ i ɾ i
줄기	t͡ɕ u ɭ ɡ i
은퇴하다	ɯ n tʰ w e̞ ɦ a̠ d a̠
칫솔	t͡ɕʰ i t̚ s͈ o̞ ɭ
국면	k u ŋ m j ʌ̹ n
몽구스	m o̞ ŋ ɡ u sʰ ɯ
남용	n a̠ː m j o ŋ
중력	t͡ɕ u ŋ ɲ j ʌ̹ k̚
굴착기	k u ɭ t͡ɕʰ a̠ k̚ k͈ i
뇌관	n w e̞ ɡ w a̠ n
없애다	ʌ̹ p s͈ e̞ d a̠
모듬	m o̞ d ɯ m
사랑해	sʰ a̠ ɾ a̠ ŋ ɦ e̞
과팅	k w a̠ tʰ i ŋ
음핵	ɯ m ɦ e̞ k̚
벽력	p j ʌ̹ ŋ ɲ j ʌ̹ k̚
인칭	i n t͡ɕʰ i ŋ
세로	sʰ e̞ː ɾ o̞
정규	t͡ɕ ʌ̹ ŋ ɡ j u
노동자	n o̞ d o̞ ŋ d͡ʑ a̠
건너다	k ɘː n n ʌ̹ d a̠
충고하다	t͡ɕʰ u ŋ ɡ o̞ ɦ a̠ d a̠
탈출	tʰ a̠ ɭ t͡ɕʰ u ɭ
일생	i ɭ s͈ e̞ ŋ
폐렴	pʰ j e̞ː ɾ j ʌ̹ m
조깅	t͡ɕ o̞ ɡ i ŋ
시숙	ɕʰ i sʰ u k̚
동일하다	t o̞ ŋ i ɾ ɦ a̠ d a̠
팥소	pʰ a̠ t̚ s͈ o̞
아피아	a̠ pʰ i a̠
손톱깎이	sʰ o̞ n tʰ o̞ p̚ k͈ a̠ k͈ i
미치광이	m i t͡ɕʰ i ɡ w a̠ ŋ i
감싸다	k a̠ː m s͈ a̠ d a̠
이성애자	i sʰ ʌ̹ ŋ e̞ d͡ʑ a̠
여배우	j ʌ̹ b e̞ u
운동장	uː n d o̞ ŋ d͡ʑ a̠ ŋ
이슬람국가	i sʰ ɯ ɭ ɭ a̠ m ɡ u k̚ k͈ a̠
도토리	t o̞ tʰ o̞ ɾ i
성운	sʰ ʌ̹ ŋ u n
제출하다	t͡ɕ e̞ t͡ɕʰ u ɾ ɦ a̠ d a̠
친일파	t͡ɕʰ i n i ɭ pʰ a̠
수의사	sʰ u ɰ i sʰ a̠
퀴나졸린	kʰ ɥ i n a̠ d͡ʑ o̞ ɭ ʎ i n
돌이키다	t o̞ ɾ i k ç i d a̠
쏠다	s͈ o̞ː ɭ d a̠
넘다	n ɘː m t͈ a̠
커튼	kʰ ʌ̹ tʰ ɯ n
노여움	n o̞ː j ʌ̹ u m
밍크	m i ŋ k x ɯ
꺽정이	k͈ ʌ̹ k̚ t͡ɕ͈ ʌ̹ ŋ i
련맹	ɾ j ʌ̹ n m e̞ ŋ
튀기다	tʰ ɥ i ɡ i d a̠
들치기	t ɯ ɭ t͡ɕʰ i ɡ i
두께	t u k͈ e̞
기울이다	k i u ɾ i d a̠
지다	t͡ɕ i d a̠
홀리다	ɸʷ o̞ ɭ ʎ i d a̠
건배	k ʌ̹ n b e̞
위원장	ɥ i w ʌ̹ n d͡ʑ a̠ ŋ
니트릴	n i tʰ ɯ ɾ i ɭ
바알	p a̠ a̠ ɭ
엉망진창	ʌ̹ ŋ m a̠ ŋ d͡ʑ i n t͡ɕʰ a̠ ŋ
커리	kʰ ʌ̹ ɾ i
눈뜨다	n u n t͈ ɯ d a̠
판지	pʰ a̠ n d͡ʑ i
바르샤바	p a̠ ɾ ɯ ɕʰ j a̠ b a̠
멀쩡	m ʌ̹ ɭ t͡ɕ͈ ʌ̹ ŋ
애환	e̞ β w a̠ n
비밀스럽다	p iː m i ɭ sʰ ɯ ɾ ʌ̹ p̚ t͈ a̠
요망	j o m a̠ ŋ
찾다	t͡ɕʰ a̠ t̚ t͈ a̠
국적	k u k̚ t͡ɕ͈ ʌ̹ k̚
일찍	i ɭ t͡ɕ͈ i k̚
비단	p i d a̠ n
계열	k j e̞ j ʌ̹ ɭ
감방	k a̠ m b a̠ ŋ
갈보	k a̠ ɭ b o̞
항암제	h a̠ː ŋ a̠ m d͡ʑ e̞
헐렁하다	h ʌ̹ ɭ ɭ ʌ̹ ŋ ɦ a̠ d a̠
경기도	k j ʌ̹ ŋ ɡ i d o̞
쿨쿨	kʰ u ɭ kʰ u ɭ
옮아오다	o̞ ɭ m a̠ o̞ d a̠
다치다	t a̠ t͡ɕʰ i d a̠
회색기러기	ɸ w e̞ sʰ e̞ k̚ k͈ i ɾ ʌ̹ ɡ i
형법	ç j ʌ̹ ŋ b ʌ̹ p̚
횡단보도	ɸ w e̞ ŋ d a̠ n b o̞ d o̞
이제	i d͡ʑ e̞
혜성	ç j e̞ː sʰ ʌ̹ ŋ
실제로	ɕʰ i ɭ t͡ɕ͈ e̞ ɾ o̞
벅차다	p ʌ̹ k̚ t͡ɕʰ a̠ d a̠
부닥치다	p u d a̠ k̚ t͡ɕʰ i d a̠
마르다	m a̠ ɾ ɯ d a̠
과로사	k w a̠ ɾ o̞ sʰ a̠
퀴륨	kʰ ɥ i ɾ j u m
사양	sʰ a̠ j a̠ ŋ
교체하다	k j o t͡ɕʰ e̞ ɦ a̠ d a̠
불알	p u ɾ a̠ ɭ
기와	k i w a̠
캄팔라	kʰ a̠ m pʰ a̠ ɭ ɭ a̠
시옷	ɕʰ i o̞ t̚
급하다	k ɯ pʰ a̠ d a̠
쪼개다	t͡ɕ͈ o̞ ɡ e̞ d a̠
전철	t͡ɕ ɘː n t͡ɕʰ ʌ̹ ɭ
정변	t͡ɕ ʌ̹ ŋ b j ʌ̹ n
크세논	k x ɯ sʰ e̞ n o̞ n
경주	k j ɘː ŋ d͡ʑ u
후기	ɸʷ uː ɡ i
다락방	t a̠ ɾ a̠ k̚ p͈ a̠ ŋ
신경학	ɕʰ i n ɡ j ʌ̹ ŋ ɦ a̠ k̚
사다리	sʰ a̠ d a̠ ɾ i
구름	k u ɾ ɯ m
지사	t͡ɕ i sʰ a̠
행복	h e̞ː ŋ b o̞ k̚
성질	sʰ ɘː ŋ d͡ʑ i ɭ
북두칠성	p u k̚ t͈ u t͡ɕʰ i ɭ sʰ ʌ̹ ŋ
결혼식	k j ʌ̹ ɾ β o̞ n ɕʰ i k̚
논하다	n o̞ n ɦ a̠ d a̠
원하다	w ɘː n ɦ a̠ d a̠
귓결	k ɥ i t̚ k͈ j ʌ̹ ɭ
러더포듐	ɾ ʌ̹ d ʌ̹ pʰ o̞ d j u m
완벽하다	w a̠ n b j ʌ̹ kʰ a̠ d a̠
결정수	k j ʌ̹ ɭ t͡ɕ͈ ʌ̹ ŋ sʰ u
서로	sʰ ʌ̹ ɾ o̞
풀밭	pʰ u ɭ b a̠ t̚
다르다	t a̠ ɾ ɯ d a̠
설농탕	sʰ ʌ̹ ɭ ɭ o̞ ŋ tʰ a̠ ŋ
감자튀김	k a̠ m d͡ʑ a̠ tʰ ɥ i ɡ i m
받다	p a̠ t̚ t͈ a̠
피자	pʰ i d͡ʑ a̠
계시판	k j e̞ː ɕʰ i pʰ a̠ n
활자	ɸ w a̠ ɭ t͡ɕ͈ a̠
야금야금	j a̠ ɡ ɯ m j a̠ ɡ ɯ m
석유	sʰ ʌ̹ ɡ j u
사리원	sʰ a̠ ɾ i w ʌ̹ n
참수리	t͡ɕʰ a̠ m sʰ u ɾ i
출생일	t͡ɕʰ u ɭ s͈ e̞ ŋ i ɭ
사흘	sʰ a̠ ɣ ɯ ɭ
가난	k a̠ n a̠ n
괄약근	k w a̠ ɾ j a̠ k̚ k͈ ɯ n
중대	t͡ɕ u ŋ d e̞
진균	t͡ɕ i n ɡ j u n
현금	ç j ɘː n ɡ ɯ m
연방	j ʌ̹ n b a̠ ŋ
오후	o̞ː β u
고래	k o̞ ɾ e̞
거스러미	k ʌ̹ sʰ ɯ ɾ ʌ̹ m i
현재	ç j ɘː n d͡ʑ e̞
조반	t͡ɕ o̞ː b a̠ n
맑다	m a̠ k̚ t͈ a̠
어렵사리	ʌ̹ ɾ j ʌ̹ p s͈ a̠ ɾ i
기선	k i sʰ ʌ̹ n
학위	h a̠ ɡ ɥ i
득점	t ɯ k̚ t͡ɕ͈ ʌ̹ m
배추	p e̞ː t͡ɕʰ u
가치	k a̠ t͡ɕʰ i
이기주의	iː ɡ i d͡ʑ u ɰ i
생태계	sʰ e̞ ŋ tʰ e̞ ɡ j e̞
북경	p u k̚ k͈ j ʌ̹ ŋ
서류철	sʰ ʌ̹ ɾ j u t͡ɕʰ ʌ̹ ɭ
늦다	n ɯ t̚ t͈ a̠
액적	e̞ k̚ t͡ɕ͈ ʌ̹ k̚
보수	p o̞ː sʰ u
발자국	p a̠ ɭ t͡ɕ͈ a̠ ɡ u k̚
음식값	ɯː m ɕʰ i k̚ k͈ a̠ p̚
천안문	t͡ɕʰ ʌ̹ n a̠ n m u n
과즙	k w a̠ː d͡ʑ ɯ p̚
약하다	j a̠ kʰ a̠ d a̠
풍기다	pʰ u ŋ ɡ i d a̠
구분자	k uː b u n d͡ʑ a̠
탈린	tʰ a̠ ɭ ʎ i n
응결	ɯ ŋ ɡ j ʌ̹ ɭ
트랙터	tʰ ɯ ɾ e̞ k̚ tʰ ʌ̹
흰날개해오라기	ç i n n a̠ ɭ ɡ e̞ ɦ e̞ o̞ ɾ a̠ ɡ i
카메라	kʰ a̠ m e̞ ɾ a̠
단백	t a̠ː n b e̞ k̚
지도자	t͡ɕ i d o̞ d͡ʑ a̠
이테르븀	i tʰ e̞ ɾ ɯ b j u m
반구	p a̠ː n ɡ u
요새	j o sʰ e̞
우선	u sʰ ʌ̹ n
흰이마기러기	ç i n n i m a̠ ɡ i ɾ ʌ̹ ɡ i
책하다	t͡ɕʰ e̞ kʰ a̠ d a̠
협박하다	ç j ʌ̹ p̚ p͈ a̠ kʰ a̠ d a̠
트다	tʰ ɯ d a̠
객공잡이	k e̞ k̚ k͈ o̞ ŋ d͡ʑ a̠ b i
메다	m e̞ː d a̠
보람	p o̞ ɾ a̠ m
위병	ɥ i b j ʌ̹ ŋ
구체적	k u t͡ɕʰ e̞ d͡ʑ ʌ̹ k̚
세관	sʰ e̞ː ɡ w a̠ n
협상	ç j ʌ̹ p s͈ a̠ ŋ
뺏다	p͈ e̞ː t̚ t͈ a̠
티아졸	tʰ i a̠ d͡ʑ o̞ ɭ
움직임	u m d͡ʑ i ɡ i m
문지기	m u n d͡ʑ i ɡ i
훔치다	ɸʷ u m t͡ɕʰ i d a̠
별실	p j ʌ̹ ɭ ɕ͈ i ɭ
두서넛	t u sʰ ʌ̹ n ʌ̹ t̚
펄서	pʰ ʌ̹ ɭ sʰ ʌ̹
활동하다	ɸ w a̠ ɭ t͈ o̞ ŋ ɦ a̠ d a̠
가마우지	k a̠ m a̠ u d͡ʑ i
벨벳	p e̞ ɭ b e̞ t̚
예수	j e̞ sʰ u
뽑히다	p͈ o̞ pʰ i d a̠
아르메니아	a̠ ɾ ɯ m e̞ n i a̠
독음	t o̞ ɡ ɯ m
대박	t e̞ː b a̠ k̚
뒷모습	t ɥ iː n m o̞ sʰ ɯ p̚
마치	m a̠ t͡ɕʰ i
청머리오리	t͡ɕʰ ʌ̹ ŋ m ʌ̹ ɾ i o̞ ɾ i
관수리	k w a̠ n sʰ u ɾ i
골목	k o̞ː ɭ m o̞ k̚
시짱	ɕʰ i t͡ɕ͈ a̠ ŋ
눋다	n uː t̚ t͈ a̠
표현하다	pʰ j o ʝ j ʌ̹ n ɦ a̠ d a̠
오물	o̞ː m u ɭ
황로	ɸ w a̠ ŋ n o̞
식품보존료	ɕʰ i k̚ pʰ u m b o̞ d͡ʑ o̞ ɭ ʎ j o
똥차	t͈ o̞ ŋ t͡ɕʰ a̠
올림말	o̞ ɭ ʎ i m m a̠ ɭ
횡파	ɸ w e̞ ŋ pʰ a̠
미치다	m i t͡ɕʰ i d a̠
구름다리	k u ɾ ɯ m d a̠ ɾ i
난백	n a̠ː n b e̞ k̚
식초	ɕʰ i k̚ t͡ɕʰ o̞
타갈로그어	tʰ a̠ ɡ a̠ ɭ ɭ o̞ ɡ ɯ ʌ̹
예약	j e̞ː j a̠ k̚
음소문자	ɯ m sʰ o̞ m u n d͡ʑ a̠
해마	h e̞ m a̠
협회	ç j ʌ̹ pʰ w e̞
대수학	t e̞ sʰ u ɦ a̠ k̚
벌꿀	p ɘː ɭ k͈ u ɭ
심리	ɕʰ i m n i
이과	iː k͈ w a̠
솔로몬	sʰ o̞ ɭ ɭ o̞ m o̞ n
검은해오라기	k ʌ̹ m ɯ n ɦ e̞ o̞ ɾ a̠ ɡ i
다림질	t a̠ ɾ i m d͡ʑ i ɭ
치료	t͡ɕʰ i ɾ j o
뭄바이	m u m b a̠ i
모란봉	m o̞ ɾ a̠ n b o̞ ŋ
음반	ɯ m b a̠ n
굳이	k u d͡ʑ i
심근경색	ɕʰ i m ɡ ɯ n ɡ j ʌ̹ ŋ sʰ e̞ k̚
보이프렌드	p o̞ i pʰ ɯ ɾ e̞ n d ɯ
애국심	e̞ː ɡ u k ɕ͈ i m
동물학	t o̞ ŋ m u ɾ ɦ a̠ k̚
행동하다	h e̞ ŋ d o̞ ŋ ɦ a̠ d a̠
마술사	m a̠ sʰ u ɭ s͈ a̠
원조	w ɘː n d͡ʑ o̞
보디빌딩	p o̞ d i b i ɭ d i ŋ
접수하다	t͡ɕ ʌ̹ p s͈ u ɦ a̠ d a̠
무관심하다	m u ɡ w a̠ n ɕʰ i m ɦ a̠ d a̠
태황태후	tʰ e̞ β w a̠ ŋ tʰ e̞ β u
목피	m o̞ k̚ pʰ i
발음	p a̠ ɾ ɯ m
조약돌	t͡ɕ o̞ j a̠ k̚ t͈ o̞ ɭ
볼셰비키	p o̞ ɭ ɕʰ j e̞ b i k ç i
젖먹이	t͡ɕ ʌ̹ n m ʌ̹ ɡ i
프랑	pʰ ɯ ɾ a̠ ŋ
열없다	j ɘː ɾ ʌ̹ p̚ t͈ a̠
피리	pʰ i ɾ i
가득히	k a̠ d ɯ k ç i
헬리콥터	h e̞ ɭ ʎ i kʰ o̞ p̚ tʰ ʌ̹
나귀	n a̠ ɡ ɥ i
취나물	t͡ɕʰ ɥ i n a̠ m u ɭ
올리다	o̞ ɭ ʎ i d a̠
민들레	m i n d ɯ ɭ ɭ e̞
제국주의	t͡ɕ e̞ː ɡ u k̚ t͡ɕ͈ u ɰ i
낮잠	n a̠ t̚ t͡ɕ͈ a̠ m
뽐내다	p͈ o̞ m n e̞ d a̠
흥미	x ɯː ŋ m i
힘들다	ç i m d ɯ ɭ d a̠
망치	m a̠ ŋ t͡ɕʰ i
짙푸르다	t͡ɕ i t̚ pʰ u ɾ ɯ d a̠
의심쩍다	ɰ i ɕʰ i m t͡ɕ͈ ʌ̹ k̚ t͈ a̠
홍보	ɸʷ o̞ ŋ b o̞
파리	pʰ a̠ ɾ i
대음순	t e̞ː ɯ m sʰ u n
구아바	k u a̠ b a̠
근로	k ɯː ɭ ɭ o̞
통신	tʰ o̞ ŋ ɕʰ i n
스타킹	sʰ ɯ tʰ a̠ k ç i ŋ
띠무늬물범	t͈ i m u n i m u ɭ b ʌ̹ m
응모자	ɯː ŋ m o̞ d͡ʑ a̠
해당	h e̞ d a̠ ŋ
싼룬처	s͈ a̠ ɭ ɭ u n t͡ɕʰ ʌ̹
교육하다	k j oː j u kʰ a̠ d a̠
그림자	k ɯː ɾ i m d͡ʑ a̠
가득	k a̠ d ɯ k̚
애교쟁이	e̞ ɡ j o d͡ʑ e̞ ŋ i
연어	j ʌ̹ n ʌ̹
회교도	ɸ w e̞ ɡ j o d o̞
심지	ɕʰ i m d͡ʑ i
사회적	sʰ a̠ β w e̞ d͡ʑ ʌ̹ k̚
가는돌고기	k a̠ n ɯ n d o̞ ɭ ɡ o̞ ɡ i
데뷔	t e̞ b ɥ i
복사	p o̞ː k s͈ a̠
새벽	sʰ e̞ b j ʌ̹ k̚
달구지	t a̠ ɭ ɡ u d͡ʑ i
만주어	m a̠ n d͡ʑ u ʌ̹
바깥어른	p a̠ k͈ a̠ d ʌ̹ ɾ ɯ n
카라카스	kʰ a̠ ɾ a̠ kʰ a̠ sʰ ɯ
공갈하다	k o̞ː ŋ ɡ a̠ ɾ ɦ a̠ d a̠
바쿠	p a̠ kʰ u
태양계	tʰ e̞ j a̠ ŋ ɡ j e̞
아프로디테	a̠ pʰ ɯ ɾ o̞ d i tʰ e̞
가이드	k a̠ i d ɯ
혼례식	ɸʷ o̞ ɭ ʎ j e̞ ɕʰ i k̚
사향쥐	sʰ a̠ ʝ j a̠ ŋ d͡ʑ ɥ i
뜻밖에	t͈ ɯ t̚ p͈ a̠ k͈ e̞
발랄라이카	p a̠ ɭ ɭ a̠ ɭ ɭ a̠ i kʰ a̠
새끼손가락	sʰ e̞ k͈ i sʰ o̞ n ɡ a̠ ɾ a̠ k̚
저승	t͡ɕ ʌ̹ sʰ ɯ ŋ
자의	t͡ɕ a̠ ɰ i
그리스도	k ɯ ɾ i sʰ ɯ d o̞
엘리트	e̞ ɭ ʎ i tʰ ɯ
닿다	t a̠ː tʰ a̠
볶다	p o̞ k̚ t͈ a̠
시월	ɕʰ i w ʌ̹ ɭ
부뚜막	p u t͈ u m a̠ k̚
집어넣다	t͡ɕ i b ʌ̹ n ʌ̹ tʰ a̠
엔진	e̞ n d͡ʑ i n
속속	sʰ o̞ k s͈ o̞ k̚
알아보다	a̠ ɾ a̠ b o̞ d a̠
궐련	k w ʌ̹ ɭ ʎ j ʌ̹ n
때문	t͈ e̞ m u n
큰귀박쥐	k x ɯ n ɡ ɥ i b a̠ k̚ t͡ɕ͈ ɥ i
프런트	pʰ ɯ ɾ ʌ̹ n tʰ ɯ
바지	p a̠ d͡ʑ i
스포일러	s͈ ɯ pʰ o̞ i ɭ ɭ ʌ̹
일으키다	i ɾ ɯ k ç i d a̠
광호흡	k w a̠ ŋ β o̞ ɣ ɯ p̚
멤버	m e̞ m b ʌ̹
여닫다	j ɘː d a̠ t̚ t͈ a̠
인종차별	i n d͡ʑ o̞ ŋ t͡ɕʰ a̠ b j ʌ̹ ɭ
웃프다	u t̚ pʰ ɯ d a̠
오랑우탄	o̞ ɾ a̠ ŋ u tʰ a̠ n
정면	t͡ɕ ɘː ŋ m j ʌ̹ n
한두	h a̠ n d u
묵묵히	m u ŋ m u k ç i
삼촌	sʰ a̠ m t͡ɕʰ o̞ n
골프	k͈ o̞ ɭ pʰ ɯ
펜션	pʰ e̞ n ɕʰ j ʌ̹ n
정거장	t͡ɕ ʌ̹ ŋ ɡ ʌ̹ d͡ʑ a̠ ŋ
대중	t e̞ː d͡ʑ u ŋ
물론	m u ɭ ɭ o̞ n
영리하다	j ɘː ŋ n i ɦ a̠ d a̠
외동딸	w e̞ d o̞ ŋ t͈ a̠ ɭ
노랑부리백로	n o̞ ɾ a̠ ŋ b u ɾ i b e̞ ŋ n o̞
발정	p a̠ ɭ t͡ɕ͈ ʌ̹ ŋ
해적	h e̞ d͡ʑ ʌ̹ k̚
차츰	t͡ɕʰ a̠ t͡ɕʰ ɯ m
떡볶이	t͈ ʌ̹ k̚ p͈ o̞ k͈ i
풋사랑	pʰ u t̚ s͈ a̠ ɾ a̠ ŋ
육각형	j u k̚ k͈ a̠ k ç j ʌ̹ ŋ
오타쿠	o̞ tʰ a̠ kʰ u
햄스터	h e̞ m sʰ ɯ tʰ ʌ̹
아메리카	a̠ m e̞ ɾ i kʰ a̠
이며	i m j ʌ̹
라디오	ɾ a̠ d i o̞
석랍	sʰ ʌ̹ ŋ n a̠ p̚
응용	ɯː ŋ j o ŋ
마작	m a̠ː d͡ʑ a̠ k̚
공수도	k o̞ ŋ sʰ u d o̞
오옴	o̞ o̞ m
유혹	j u β o̞ k̚
묻히다	m u tʰ i d a̠
소비자	sʰ o̞ b i d͡ʑ a̠
무산쇠족제비	m uː sʰ a̠ n sʰ w e̞ d͡ʑ o̞ k̚ t͡ɕ͈ e̞ b i
밟다	p a̠ː p̚ t͈ a̠
누렁이	n u ɾ ʌ̹ ŋ i
불포화	p u ɭ pʰ o̞ β w a̠
봄날	p o̞ m n a̠ ɭ
콜카타	kʰ o̞ ɭ kʰ a̠ tʰ a̠
이스탄불	i sʰ ɯ tʰ a̠ n b u ɭ
정일봉	t͡ɕ ʌ̹ ŋ i ɭ b o̞ ŋ
컴퓨터	kʰ ʌ̹ m pʰ j u tʰ ʌ̹
카트	kʰ a̠ tʰ ɯ
투표자	tʰ u pʰ j o d͡ʑ a̠
담다	t a̠ː m t͈ a̠
날씨	n a̠ ɭ ɕ͈ i
월식	w ʌ̹ ɭ ɕ͈ i k̚
뒤쫓다	t ɥ iː t͡ɕ͈ o̞ t̚ t͈ a̠
카세트	kʰ a̠ sʰ e̞ tʰ ɯ
토양	tʰ o̞ j a̠ ŋ
게우다	k e̞ u d a̠
중성	t͡ɕ u ŋ sʰ ʌ̹ ŋ
심연	ɕʰ iː m j ʌ̹ n
갈보집	k a̠ ɭ b o̞ d͡ʑ i p̚
팔레스타인	pʰ a̠ ɭ ɭ e̞ sʰ ɯ tʰ a̠ i n
차림표	t͡ɕʰ a̠ ɾ i m pʰ j o
정치학	t͡ɕ ʌ̹ ŋ t͡ɕʰ i ɦ a̠ k̚
원산	w ʌ̹ n sʰ a̠ n
갈아타다	k a̠ ɾ a̠ tʰ a̠ d a̠
성군	sʰ ʌ̹ ŋ ɡ u n
얇다	j a̠ː ɭ t͈ a̠
포도당	pʰ o̞ d o̞ d a̠ ŋ
가시집	k a̠ ɕʰ i d͡ʑ i p̚
카라치	kʰ a̠ ɾ a̠ t͡ɕʰ i
어이	ʌ̹ i
의존증	ɰ i d͡ʑ o̞ n d͡ʑ ɯ ŋ
바이올린	p a̠ i o̞ ɭ ʎ i n
회합	ɸ w e̞ː ɦ a̠ p̚
이야기	i j a̠ ɡ i
막힘없다	m a̠ k ç i m ʌ̹ p̚ t͈ a̠
황어	ɸ w a̠ ŋ ʌ̹
성공	sʰ ʌ̹ ŋ ɡ o̞ ŋ
걸음마	k ʌ̹ ɾ ɯ m m a̠
소프트볼	sʰ o̞ pʰ ɯ tʰ ɯ b o̞ ɭ
인식표	i n ɕʰ i k̚ pʰ j o
일문	i ɭ m u n
년도	ɲ j ʌ̹ n d o̞
맘속	m a̠ː m s͈ o̞ k̚
흐려지다	x ɯ ɾ j ʌ̹ d͡ʑ i d a̠
끓다	k͈ ɯ ɭ tʰ a̠
주님	t͡ɕ u n i m
후예	ɸʷ uː j e̞
퇴직금	tʰ w e̞ː d͡ʑ i k̚ k͈ ɯ m
그분	k ɯ b u n
화단	ɸ w a̠ d a̠ n
두드리다	t u d ɯ ɾ i d a̠
답정너	t a̠ p̚ t͡ɕ͈ ʌ̹ ŋ n ʌ̹
수준	sʰ u d͡ʑ u n
물뿌리개	m u ɭ p͈ u ɾ i ɡ e̞
로동	ɾ o̞ d o̞ ŋ
화면	ɸ w a̠ː m j ʌ̹ n
홀아비	ɸʷ o̞ ɾ a̠ b i
류형	ɾ j uː ʝ j ʌ̹ ŋ
나사	n a̠ sʰ a̠
명일	m j ʌ̹ ŋ i ɭ
노크노크	n o̞ k x ɯ n o̞ k x ɯ
태평양	tʰ e̞ pʰ j ʌ̹ ŋ ɲ j a̠ ŋ
성교	sʰ ɘː ŋ ɡ j o
호치민	ɸʷ o̞ t͡ɕʰ i m i n
오리	o̞ː ɾ i
진출하다	t͡ɕ iː n t͡ɕʰ u ɾ ɦ a̠ d a̠
도쿄	t o̞ k ç j o
대화	t e̞ː β w a̠
성립	sʰ ʌ̹ ŋ n i p̚
굶주리다	k uː m d͡ʑ u ɾ i d a̠
남부	n a̠ m b u
싸고돌다	s͈ a̠ ɡ o̞ d o̞ ɭ d a̠
인하다	i n ɦ a̠ d a̠
옥시토신	o̞ k ɕ͈ i tʰ o̞ ɕʰ i n
어느	ʌ̹ n ɯ
심다	ɕʰ iː m t͈ a̠
스펙트럼	sʰ ɯ pʰ e̞ k̚ tʰ ɯ ɾ ʌ̹ m
상표	sʰ a̠ ŋ pʰ j o
곡물	k o̞ ŋ m u ɭ
무치다	m u t͡ɕʰ i d a̠
플랫폼	pʰ ɯ ɭ ɭ e̞ t̚ pʰ o̞ m
시금치	ɕʰ i ɡ ɯ m t͡ɕʰ i
건축물	k ɘː n t͡ɕʰ u ŋ m u ɭ
화려하다	ɸ w a̠ ɾ j ʌ̹ ɦ a̠ d a̠
먹이다	m ʌ̹ ɡ i d a̠
가짜	k a̠ː t͡ɕ͈ a̠
변하다	p j ɘː n ɦ a̠ d a̠
산서	sʰ a̠ n sʰ ʌ̹
올리고	o̞ ɭ ʎ i ɡ o̞
검다	k ɘː m d a̠
아인슈타이늄	a̠ i n ɕʰ j u tʰ a̠ i ɲ j u m
뒤따르다	t ɥ iː t͈ a̠ ɾ ɯ d a̠
와인	w a̠ i n
걸어가다	k ʌ̹ ɾ ʌ̹ ɡ a̠ d a̠
학교	h a̠ k̚ k͈ j o
트로필륨	tʰ ɯ ɾ o̞ pʰ i ɭ ʎ j u m
적당하다	t͡ɕ ʌ̹ k̚ t͈ a̠ ŋ ɦ a̠ d a̠
티읕	tʰ i ɯ t̚
툴륨	tʰ u ɭ ʎ j u m
말다툼	m a̠ː ɭ d a̠ tʰ u m
공언	k o̞ ŋ ʌ̹ n
간물	k a̠ n m u ɭ
일심단결	i ɭ ɕ͈ i m d a̠ n ɡ j ʌ̹ ɭ
반응	p a̠ː n ɯ ŋ
조카딸	t͡ɕ o̞ kʰ a̠ t͈ a̠ ɭ
옷감	o̞ t̚ k͈ a̠ m
뒷마당	t ɥ iː n m a̠ d a̠ ŋ
돌다	t o̞ː ɭ d a̠
전환하다	t͡ɕ ɘː n β w a̠ n ɦ a̠ d a̠
회관	ɸ w e̞ː ɡ w a̠ n
묽다	m u k̚ t͈ a̠
한류	h a̠ ɭ ʎ j u
동이	t o̞ ŋ i
임신하다	iː m ɕʰ i n ɦ a̠ d a̠
하이드라존	h a̠ i d ɯ ɾ a̠ d͡ʑ o̞ n
해협	h e̞ː ʝ j ʌ̹ p̚
체커	t͡ɕʰ e̞ kʰ ʌ̹
슬슬	sʰ ɯ ɭ sʰ ɯ ɭ
기근	k i ɡ ɯ n
비롯되다	p i ɾ o̞ t̚ t͈ w e̞ d a̠
아파르트헤이트	a̠ pʰ a̠ ɾ ɯ tʰ ɯ ɦ e̞ i tʰ ɯ
풍선	pʰ u ŋ sʰ ʌ̹ n
어학	ɘː ɦ a̠ k̚
슈트케이스	ɕʰ j u tʰ ɯ kʰ e̞ i sʰ ɯ
방문하다	p a̠ː ŋ m u n ɦ a̠ d a̠
풍금	pʰ u ŋ ɡ ɯ m
거절하다	k ɘː d͡ʑ ʌ̹ ɾ ɦ a̠ d a̠
진주층	t͡ɕ i n d͡ʑ u t͡ɕʰ ɯ ŋ
노환	n o̞ː β w a̠ n
집토끼	t͡ɕ i p̚ tʰ o̞ k͈ i
읽다	i k̚ t͈ a̠
드라이브	t ɯ ɾ a̠ i b ɯ
노른자	n o̞ ɾ ɯ n d͡ʑ a̠
제출	t͡ɕ e̞ t͡ɕʰ u ɭ
낙하하다	n a̠ kʰ a̠ ɦ a̠ d a̠
으쌰	ɯ ɕ͈ j a̠
소속	sʰ o̞ː sʰ o̞ k̚
김정일화	k i m d͡ʑ ʌ̹ ŋ i ɾ β w a̠
소고기	sʰ o̞ ɡ o̞ ɡ i
몰리브데넘	m o̞ ɭ ʎ i b ɯ d e̞ n ʌ̹ m
만류	m a̠ ɭ ʎ j u
판결	pʰ a̠ n ɡ j ʌ̹ ɭ
피스타치오	pʰ i sʰ ɯ tʰ a̠ t͡ɕʰ i o̞
맑스주의	m a̠ k s͈ ɯ d͡ʑ u ɰ i
큰납지리	k x ɯ n n a̠ p̚ t͡ɕ͈ i ɾ i
파충류	pʰ a̠ t͡ɕʰ u ŋ ɲ j u
열반	j ʌ̹ ɭ b a̠ n
타이르다	tʰ a̠ i ɾ ɯ d a̠
다시	t a̠ ɕʰ i
장애	t͡ɕ a̠ ŋ e̞
매달리다	m e̞ː d a̠ ɭ ʎ i d a̠
스도쿠	sʰ ɯ d o̞ kʰ u
청하다	t͡ɕʰ ʌ̹ ŋ ɦ a̠ d a̠
우리나라	u ɾ i n a̠ ɾ a̠
국어	k u ɡ ʌ̹
쇠퇴하다	sʰ w e̞ tʰ w e̞ ɦ a̠ d a̠
꼬리치레도롱뇽	k͈ o̞ ɾ i t͡ɕʰ i ɾ e̞ d o̞ ɾ o̞ ŋ ɲ j o ŋ
고방오리	k o̞ b a̠ ŋ o̞ ɾ i
백해	p e̞ kʰ e̞
삐뚤다	p͈ i t͈ u ɭ d a̠
쿨라크	kʰ u ɭ ɭ a̠ k x ɯ
해설하다	h e̞ sʰ ʌ̹ ɾ ɦ a̠ d a̠
운영하다	uː ɲ j ʌ̹ ŋ ɦ a̠ d a̠
불까다	p u ɭ k͈ a̠ d a̠
길잡이	k i ɭ d͡ʑ a̠ b i
요청하다	j o t͡ɕʰ ʌ̹ ŋ ɦ a̠ d a̠
필드하키	pʰ i ɭ d ɯ ɦ a̠ k ç i
인도네시아	i n d o̞ n e̞ ɕʰ i a̠
오른손잡이	o̞ ɾ ɯ n sʰ o̞ n d͡ʑ a̠ b i
수학여행	sʰ u ɦ a̠ ŋ ɲ j ʌ̹ ɦ e̞ ŋ
상괭이	sʰ a̠ ŋ ɡ w e̞ ŋ i
제대	t͡ɕ e̞ d e̞
대기하다	t e̞ː ɡ i ɦ a̠ d a̠
파나마	pʰ a̠ n a̠ m a̠
양봉	j a̠ː ŋ b o̞ ŋ
프랑슘	pʰ ɯ ɾ a̠ ŋ ɕʰ j u m
행정학	h e̞ ŋ d͡ʑ ʌ̹ ŋ ɦ a̠ k̚
붙들다	p u t̚ t͈ ɯ ɭ d a̠
운전자	uː n d͡ʑ ʌ̹ n d͡ʑ a̠
산호	sʰ a̠ n β o̞
문방	m u n b a̠ ŋ
테니스장	tʰ e̞ n i sʰ ɯ d͡ʑ a̠ ŋ
약혼자	j a̠ kʰ o̞ n d͡ʑ a̠
료금	ɾ j oː ɡ ɯ m
울타리	u ɭ tʰ a̠ ɾ i
아르바이트	a̠ ɾ ɯ b a̠ i tʰ ɯ
체르노빌	t͡ɕʰ e̞ ɾ ɯ n o̞ b i ɭ
졸리다	t͡ɕ o̞ ɭ ʎ i d a̠
남기다	n a̠ m ɡ i d a̠
목록	m o̞ ŋ n o̞ k̚
백질	p e̞ k̚ t͡ɕ͈ i ɭ
영원히	j ɘː ŋ w ʌ̹ n ʝ i
콜론	kʰ o̞ ɭ ɭ o̞ n
동의하다	t o̞ ŋ ɰ i ɦ a̠ d a̠
더블린	t ʌ̹ b ɯ ɭ ʎ i n
정구	t͡ɕ ʌ̹ ŋ ɡ u
대역폭	t e̞ j ʌ̹ k̚ pʰ o̞ k̚
고구려	k o̞ ɡ u ɾ j ʌ̹
턱수염	tʰ ʌ̹ k s͈ u j ʌ̹ m
파장	pʰ a̠ d͡ʑ a̠ ŋ
익살스럽다	i k s͈ a̠ ɭ sʰ ɯ ɾ ʌ̹ p̚ t͈ a̠
자판	t͡ɕ a̠ pʰ a̠ n
그믐날	k ɯ m ɯ m n a̠ ɭ
오블라스티	o̞ b ɯ ɭ ɭ a̠ sʰ ɯ tʰ i
괴한	k w e̞ː ɦ a̠ n
폭력	pʰ o̞ ŋ ɲ j ʌ̹ k̚
상담	sʰ a̠ ŋ d a̠ m
갈륨	k a̠ ɭ ʎ j u m
어요	ʌ̹ j o
요술	j o sʰ u ɭ
암스테르담	a̠ m sʰ ɯ tʰ e̞ ɾ ɯ d a̠ m
나름	n a̠ ɾ ɯ m
하나님	h a̠ n a̠ n i m
갑충	k a̠ p̚ t͡ɕʰ u ŋ
옥탑	o̞ k̚ tʰ a̠ p̚
관세	k w a̠ n sʰ e̞
형성	ç j ʌ̹ ŋ sʰ ʌ̹ ŋ
칼라	kʰ a̠ ɭ ɭ a̠
망고	m a̠ ŋ ɡ o̞
서투르다	sʰ ɘː tʰ u ɾ ɯ d a̠
궁둥이	k u ŋ d u ŋ i
젓뱅어	t͡ɕ ʌ̹ t̚ p͈ e̞ ŋ ʌ̹
꿋꿋하다	k͈ u t̚ k͈ u tʰ a̠ d a̠
버버리	p ʌ̹ b ʌ̹ ɾ i
침실	t͡ɕʰ iː m ɕʰ i ɭ
수렴	sʰ u ɾ j ʌ̹ m
위하다	ɥ i ɦ a̠ d a̠
카복실산	kʰ a̠ b o̞ k ɕ͈ i ɭ sʰ a̠ n
자전거	t͡ɕ a̠ d͡ʑ ʌ̹ n ɡ ʌ̹
중순	t͡ɕ u ŋ sʰ u n
온몸	o̞ː n m o̞ m
양피지	j a̠ ŋ pʰ i d͡ʑ i
개살구	k e̞ sʰ a̠ ɭ ɡ u
자벌레	t͡ɕ a̠ b ʌ̹ ɭ ɭ e̞
항공모함	h a̠ ŋ ɡ o̞ ŋ m o̞ ɦ a̠ m
삼신각	sʰ a̠ m ɕʰ i n ɡ a̠ k̚
부르키나파소	p u ɾ ɯ k ç i n a̠ pʰ a̠ sʰ o̞
오래전	o̞ ɾ e̞ d͡ʑ ʌ̹ n
다과	t a̠ ɡ w a̠
혼백	ɸʷ o̞ n b e̞ k̚
문진	m u n d͡ʑ i n
철물점	t͡ɕʰ ʌ̹ ɭ m u ɭ d͡ʑ ʌ̹ m
하여튼	h a̠ j ʌ̹ tʰ ɯ n
싫어하다	ɕʰ i ɾ ʌ̹ ɦ a̠ d a̠
만엽집	m a̠ ɲ j ʌ̹ p̚ t͡ɕ͈ i p̚
흡충	x ɯ p̚ t͡ɕʰ u ŋ
어지럽다	ʌ̹ d͡ʑ i ɾ ʌ̹ p̚ t͈ a̠
종족	t͡ɕ o̞ ŋ d͡ʑ o̞ k̚
세상에	sʰ e̞ː sʰ a̠ ŋ e̞
쿠냥	kʰ u ɲ j a̠ ŋ
유태인	j u tʰ e̞ i n
방위각	p a̠ ŋ ɥ i ɡ a̠ k̚
비자	p i d͡ʑ a̠
등등	t ɯː ŋ d ɯ ŋ
마나과	m a̠ n a̠ ɡ w a̠
갈고리	k a̠ ɭ ɡ o̞ ɾ i
슬기	sʰ ɯ ɭ ɡ i
뮈슬리	m ɥ i sʰ ɯ ɭ ʎ i
애니메이션	e̞ n i m e̞ i ɕʰ j ʌ̹ n
다행	t a̠ ɦ e̞ ŋ
비난하다	p iː n a̠ n ɦ a̠ d a̠
향기	ç j a̠ ŋ ɡ i
흘러내리다	x ɯ ɭ ɭ ʌ̹ n e̞ ɾ i d a̠
쪼다	t͡ɕ͈ o̞ d a̠
붉다	p u k̚ t͈ a̠
과들루프	k w a̠ d ɯ ɭ ɭ u pʰ ɯ
환승	ɸ w a̠ː n sʰ ɯ ŋ
패킷	pʰ e̞ k ç i t̚
자격지심	t͡ɕ a̠ ɡ j ʌ̹ k̚ t͡ɕ͈ i ɕʰ i m
변화	p j ɘː n β w a̠
태국	tʰ e̞ ɡ u k̚
기원전	k i w ʌ̹ n d͡ʑ ʌ̹ n
핍박	pʰ i p̚ p͈ a̠ k̚
땋다	t͈ a̠ː tʰ a̠
불면증	p u ɭ m j ʌ̹ n t͡ɕ͈ ɯ ŋ
아무래도	a̠ː m u ɾ e̞ d o̞
나무라다	n a̠ m u ɾ a̠ d a̠
크립톤	k x ɯ ɾ i p̚ tʰ o̞ n
초등학교	t͡ɕʰ o̞ d ɯ ŋ ɦ a̠ k̚ k͈ j o
스터킹	sʰ ɯ tʰ ʌ̹ k ç i ŋ
축척	t͡ɕʰ u k̚ t͡ɕʰ ʌ̹ k̚
남비	n a̠ m b i
애칭	e̞ː t͡ɕʰ i ŋ
대기실	t e̞ː ɡ i ɕʰ i ɭ
노트	n o̞ tʰ ɯ
제명	t͡ɕ e̞ m j ʌ̹ ŋ
스테아린	sʰ ɯ tʰ e̞ a̠ ɾ i n
지르다	t͡ɕ i ɾ ɯ d a̠
기억력	k i ʌ̹ ŋ ɲ j ʌ̹ k̚
마르멜로	m a̠ ɾ ɯ m e̞ ɭ ɭ o̞
썸팅	s͈ ʌ̹ m tʰ i ŋ
모세관	m o̞ sʰ e̞ ɡ w a̠ n
인원	i n w ʌ̹ n
보호	p o̞ː β o̞
간질거리다	k a̠ n d͡ʑ i ɭ ɡ ʌ̹ ɾ i d a̠
파란색	pʰ a̠ ɾ a̠ n sʰ e̞ k̚
고조	k o̞ d͡ʑ o̞
던데	t ʌ̹ n d e̞
수도	sʰ u d o̞
엘니뇨	e̞ ɭ ʎ i ɲ j o
폴란드인	pʰ o̞ ɭ ɭ a̠ n d ɯ i n
사절	sʰ a̠ː d͡ʑ ʌ̹ ɭ
다수	t a̠ sʰ u
행주	h e̞ ŋ d͡ʑ u
시리즈	ɕʰ i ɾ i d͡ʑ ɯ
박대	p a̠ k̚ t͈ e̞
원피스	w ʌ̹ n pʰ i sʰ ɯ
이야	i j a̠
회사	ɸ w e̞ː sʰ a̠
카멜레온	kʰ a̠ m e̞ ɭ ɭ e̞ o̞ n
어근	ɘː ɡ ɯ n
나아지다	n a̠ a̠ d͡ʑ i d a̠
중화인민공화국	t͡ɕ uː ŋ β w a̠ i n m i n ɡ o̞ ŋ β w a̠ ɡ u k̚
송어	sʰ o̞ ŋ ʌ̹
도도마	t o̞ d o̞ m a̠
용병	j o ŋ b j ʌ̹ ŋ
벌레	p ʌ̹ ɭ ɭ e̞
눈꺼풀	n u n k͈ ʌ̹ pʰ u ɭ
병신	p j ʌ̹ ŋ ɕʰ i n
말레이시아	m a̠ ɭ ɭ e̞ i ɕʰ i a̠
쌍안경	s͈ a̠ ŋ a̠ n ɡ j ʌ̹ ŋ
당장	t a̠ ŋ d͡ʑ a̠ ŋ
투어	tʰ u ʌ̹
루바슈카	ɾ u b a̠ ɕʰ j u kʰ a̠
싣다	ɕʰ i t̚ t͈ a̠
파이팅	pʰ a̠ i tʰ i ŋ
흔들리다	x ɯ n d ɯ ɭ ʎ i d a̠
건조하다	k ʌ̹ n d͡ʑ o̞ ɦ a̠ d a̠
진단	t͡ɕ iː n d a̠ n
스칸듐	sʰ ɯ kʰ a̠ n d j u m
인색하다	i n sʰ e̞ kʰ a̠ d a̠
눈썹	n u n s͈ ʌ̹ p̚
손수건	sʰ o̞ n s͈ u ɡ ʌ̹ n
천국	t͡ɕʰ ʌ̹ n ɡ u k̚
팔목	pʰ a̠ ɭ m o̞ k̚
근면	k ɯː n m j ʌ̹ n
항구	h a̠ː ŋ ɡ u
귀신	k ɥ iː ɕʰ i n
기윽	k i ɯ k̚
있으시다	i s͈ ɯ ɕʰ i d a̠
애너그램	e̞ n ʌ̹ ɡ ɯ ɾ e̞ m
필리핀	pʰ i ɭ ʎ i pʰ i n
락타	ɾ a̠ k̚ tʰ a̠
소반	sʰ o̞ b a̠ n
지칭하다	t͡ɕ i t͡ɕʰ i ŋ ɦ a̠ d a̠
프로메튬	pʰ ɯ ɾ o̞ m e̞ tʰ j u m
개별자	k e̞ː b j ʌ̹ ɭ t͡ɕ͈ a̠
설레다	sʰ ʌ̹ ɭ ɭ e̞ d a̠
바닥	p a̠ d a̠ k̚
녕하	ɲ j ʌ̹ ŋ ɦ a̠
남방	n a̠ m b a̠ ŋ
일본어	i ɭ b o̞ n ʌ̹
프로세스	pʰ ɯ ɾ o̞ sʰ e̞ sʰ ɯ
귀싸대기	k ɥ i s͈ a̠ d e̞ ɡ i
클랜	k x ɯ ɭ ɭ e̞ n
사기꾼	sʰ a̠ ɡ i k͈ u n
성년	sʰ ʌ̹ ŋ ɲ j ʌ̹ n
락사	ɾ a̠ k s͈ a̠
네거리	n e̞ː ɡ ʌ̹ ɾ i
자네	t͡ɕ a̠ n e̞
마무르다	m a̠ m u ɾ ɯ d a̠
득도하다	t ɯ k̚ t͈ o̞ ɦ a̠ d a̠
애비	e̞ b i
통근	tʰ o̞ ŋ ɡ ɯ n
모과	m o̞ː ɡ w a̠
온실	o̞ n ɕʰ i ɭ
쌀쌀히	s͈ a̠ ɭ s͈ a̠ ɾ ʝ i
성경	sʰ ɘː ŋ ɡ j ʌ̹ ŋ
국제화	k u k̚ t͡ɕ͈ e̞ β w a̠
포르투갈어	pʰ o̞ ɾ ɯ tʰ u ɡ a̠ ɾ ʌ̹
초어	t͡ɕʰ o̞ ʌ̹
두더지	t u d ʌ̹ d͡ʑ i
느낌	n ɯ k͈ i m
물들이다	m u ɭ d ɯ ɾ i d a̠
낱낱이	n a̠ː n n a̠ t͡ɕʰ i
혈암	ç j ʌ̹ ɾ a̠ m
문제점	m u n d͡ʑ e̞ d͡ʑ ʌ̹ m
까막눈	k͈ a̠ m a̠ ŋ n u n
노병	n o̞ː b j ʌ̹ ŋ
전개하다	t͡ɕ ɘː n ɡ e̞ ɦ a̠ d a̠
그릇	k ɯ ɾ ɯ t̚
박스	p a̠ k s͈ ɯ
입향순속	i pʰ j a̠ ŋ sʰ u n sʰ o̞ k̚
복음서	p o̞ ɡ ɯ m sʰ ʌ̹
스페인	sʰ ɯ pʰ e̞ i n
시선	ɕʰ iː sʰ ʌ̹ n
향고래	ç j a̠ ŋ ɡ o̞ ɾ e̞
사우나	sʰ a̠ u n a̠
겁나다	k ʌ̹ m n a̠ d a̠
수송	sʰ u sʰ o̞ ŋ
교양	k j o j a̠ ŋ
동사리	t o̞ ŋ sʰ a̠ ɾ i
매다	m e̞ː d a̠
강소	k a̠ ŋ sʰ o̞
불닭	p u ɭ d a̠ k̚
발라드	p a̠ ɭ ɭ a̠ d ɯ
가령	k a̠ː ɾ j ʌ̹ ŋ
초특급	t͡ɕʰ o̞ tʰ ɯ k̚ k͈ ɯ p̚
거세다	k ʌ̹ sʰ e̞ d a̠
호정	ɸʷ o̞ d͡ʑ ʌ̹ ŋ
술고래	sʰ u ɭ ɡ o̞ ɾ e̞
복수하다	p o̞ k s͈ u ɦ a̠ d a̠
킬롬미터	k ç i ɭ ɭ o̞ m m i tʰ ʌ̹
순흥	sʰ u n ɣ ɯ ŋ
긴꼬리꼬마쥐	k i n k͈ o̞ ɾ i k͈ o̞ m a̠ d͡ʑ ɥ i
꽃병	k͈ o̞ t̚ p͈ j ʌ̹ ŋ
끊임없다	k͈ ɯ n i m ʌ̹ p̚ t͈ a̠
비파	p i pʰ a̠
라임	ɾ a̠ i m
이쁘다	i p͈ ɯ d a̠
벤젠	p e̞ n d͡ʑ e̞ n
나프타	n a̠ pʰ ɯ tʰ a̠
매장	m e̞ː d͡ʑ a̠ ŋ
꺾다	k͈ ʌ̹ k̚ t͈ a̠
달구다	t a̠ ɭ ɡ u d a̠
됨됨	t w e̞ m d w e̞ m
붙잡히다	p u t̚ t͡ɕ͈ a̠ pʰ i d a̠
알제	a̠ ɭ d͡ʑ e̞
보충하다	p o̞ː t͡ɕʰ u ŋ ɦ a̠ d a̠
회담	ɸ w e̞ː d a̠ m
환도	ɸ w a̠ n d o̞
열목어	j ʌ̹ ɭ m o̞ ɡ ʌ̹
가게	k a̠ː ɡ e̞
관절염	k w a̠ n d͡ʑ ʌ̹ ɾ j ʌ̹ m
공사	k o̞ ŋ sʰ a̠
갈라지다	k a̠ ɭ ɭ a̠ d͡ʑ i d a̠
물음표	m u ɾ ɯ m pʰ j o
손가락	sʰ o̞ n k͈ a̠ ɾ a̠ k̚
가두리	k a̠ː d u ɾ i
광검	k w a̠ ŋ ɡ ʌ̹ m
구결	k uː ɡ j ʌ̹ ɭ
완전	w a̠ n d͡ʑ ʌ̹ n
감각	k a̠ː m ɡ a̠ k̚
유대인	j u d e̞ i n
암유	a̠ː m j u
흉상	ç j u ŋ sʰ a̠ ŋ
재판소	t͡ɕ e̞ pʰ a̠ n sʰ o̞
고국	k o̞ː ɡ u k̚
세기	sʰ e̞ː ɡ i
공동	k o̞ː ŋ d o̞ ŋ
열심히	j ʌ̹ ɭ ɕ͈ i m ʝ i
ᆯ지	ɭ t͡ɕ͈ i
혜산	ç j e̞ː sʰ a̠ n
저곳	t͡ɕ ʌ̹ ɡ o̞ t̚
천사	t͡ɕʰ ʌ̹ n sʰ a̠
박사	p a̠ k s͈ a̠
갈겨니	k a̠ ɭ ɡ j ʌ̹ n i
보고서	p o̞ː ɡ o̞ sʰ ʌ̹
리큐어	ɾ i k ç j u ʌ̹
누난	n u n a̠ n
글피	k ɯ ɭ pʰ i
구입	k u i p̚
당연히	t a̠ ŋ j ʌ̹ n ʝ i
거치다	k ʌ̹ t͡ɕʰ i d a̠
펠리컨	pʰ e̞ ɭ ʎ i kʰ ʌ̹ n
수소탄	sʰ u sʰ o̞ tʰ a̠ n
자행거	t͡ɕ a̠ ɦ e̞ ŋ ɡ ʌ̹
태권도	tʰ e̞ k͈ w ʌ̹ n d o̞
외계어	w e̞ː ɡ j e̞ ʌ̹
정류장	t͡ɕ ʌ̹ ŋ ɲ j u d͡ʑ a̠ ŋ
아니다	a̠ n i d a̠
류월	ɾ j u w ʌ̹ ɭ
서술하다	sʰ ɘː sʰ u ɾ ɦ a̠ d a̠
하수도	h a̠ː sʰ u d o̞
평민	pʰ j ʌ̹ ŋ m i n
전하다	t͡ɕ ʌ̹ n ɦ a̠ d a̠
제거	t͡ɕ e̞ ɡ ʌ̹
바쁘다	p a̠ p͈ ɯ d a̠
펄럭펄럭	pʰ ʌ̹ ɭ ɭ ʌ̹ k̚ pʰ ʌ̹ ɭ ɭ ʌ̹ k̚
코요테	kʰ o̞ j o tʰ e̞
유행	j u ɦ e̞ ŋ
나폴리	n a̠ pʰ o̞ ɭ ʎ i
다리	t a̠ ɾ i
피에로	pʰ i e̞ ɾ o̞
는다	n ɯ n d a̠
국뽕	k u k̚ p͈ o̞ ŋ
추구하다	t͡ɕʰ u ɡ u ɦ a̠ d a̠
녹이다	n o̞ ɡ i d a̠
빙하	p i ŋ ɦ a̠
금세	k ɯ m sʰ e̞
개고기	k e̞ː ɡ o̞ ɡ i
세탁하다	sʰ e̞ː tʰ a̠ kʰ a̠ d a̠
익룡	i ŋ ɲ j o ŋ
마라톤	m a̠ ɾ a̠ tʰ o̞ n
인절미	i n d͡ʑ ʌ̹ ɭ m i
전체적	t͡ɕ ʌ̹ n t͡ɕʰ e̞ d͡ʑ ʌ̹ k̚
공산주의자	k o̞ː ŋ sʰ a̠ n d͡ʑ u ɰ i d͡ʑ a̠
기대되다	k i d e̞ d w e̞ d a̠
바퀴벌레	p a̠ kʰ ɥ i b ʌ̹ ɭ ɭ e̞
음훈	ɯ m β u n
삐침별	p͈ i t͡ɕʰ i m b j ʌ̹ ɭ
루카	ɾ u kʰ a̠
일정	i ɭ t͡ɕ͈ ʌ̹ ŋ
세차	sʰ e̞ː t͡ɕʰ a̠
모어	m o̞ː ʌ̹
반년	p a̠ː n ɲ j ʌ̹ n
첫소리	t͡ɕʰ ʌ̹ t̚ s͈ o̞ ɾ i
뗀노	t͈ e̞ n n o̞
확률	ɸ w a̠ ŋ ɲ j u ɭ
특별히	tʰ ɯ k̚ p͈ j ʌ̹ ɾ ʝ i
마비	m a̠ː b i
외모	w e̞ m o̞
친밀	t͡ɕʰ i n m i ɭ
이게	i ɡ e̞
공항	k o̞ ŋ ɦ a̠ ŋ
감염	k a̠ː m j ʌ̹ m
유명	j uː m j ʌ̹ ŋ
이기다	i ɡ i d a̠
교향곡	k j o ʝ j a̠ ŋ ɡ o̞ k̚
탑승권	tʰ a̠ p s͈ ɯ ŋ k͈ w ʌ̹ n
이끌다	i k͈ ɯ ɭ d a̠
코멘트	kʰ o̞ m e̞ n tʰ ɯ
제논	t͡ɕ e̞ n o̞ n
배다	p e̞ː d a̠
앉은자리	a̠ n d͡ʑ ɯ n d͡ʑ a̠ ɾ i
빈민	p i n m i n
묘사하다	m j oː sʰ a̠ ɦ a̠ d a̠
타이포그래피	tʰ a̠ i pʰ o̞ ɡ ɯ ɾ e̞ pʰ i
단고기	t a̠ n ɡ o̞ ɡ i
양초	j a̠ ŋ t͡ɕʰ o̞
인사하다	i n sʰ a̠ ɦ a̠ d a̠
샐러리	sʰ e̞ ɭ ɭ ʌ̹ ɾ i
공갈치다	k o̞ː ŋ ɡ a̠ ɭ t͡ɕʰ i d a̠
변호사	p j ɘː n β o̞ sʰ a̠
밀다	m i ɭ d a̠
장점	t͡ɕ a̠ ŋ t͡ɕ͈ ʌ̹ m
미장원	m iː d͡ʑ a̠ ŋ w ʌ̹ n
꽃집	k͈ o̞ t̚ t͡ɕ͈ i p̚
방어	p a̠ ŋ ʌ̹
김밥	k iː m p͈ a̠ p̚
로메	ɾ o̞ m e̞
등산하다	t ɯ ŋ sʰ a̠ n ɦ a̠ d a̠
죄송하다	t͡ɕ w e̞ː sʰ o̞ ŋ ɦ a̠ d a̠
접하다	t͡ɕ ʌ̹ pʰ a̠ d a̠
시디	ɕʰ i d i
복권	p o̞ k̚ k͈ w ʌ̹ n
조국	t͡ɕ o̞ ɡ u k̚
텐구	tʰ e̞ n ɡ u
병리학	p j ɘː ŋ n i ɦ a̠ k̚
시합	ɕʰ i ɦ a̠ p̚
교과서	k j oː k͈ w a̠ sʰ ʌ̹
우연히	u j ʌ̹ n ʝ i
수서	sʰ u sʰ ʌ̹
사직	sʰ a̠ d͡ʑ i k̚
생겨나다	sʰ e̞ ŋ ɡ j ʌ̹ n a̠ d a̠
인치	i n t͡ɕʰ i
형부	ç j ʌ̹ ŋ b u
대나무	t e̞ n a̠ m u
번데기	p ʌ̹ n d e̞ ɡ i
도리	t o̞ ɾ i
검은머리흰죽지	k ʌ̹ m ɯ n m ʌ̹ ɾ i ʝ i n d͡ʑ u k̚ t͡ɕ͈ i
불상	p uː ɭ sʰ a̠ ŋ
독립성	t o̞ ŋ n i p s͈ ʌ̹ ŋ
천왕성	t͡ɕʰ ʌ̹ n w a̠ ŋ sʰ ʌ̹ ŋ
아티초크	a̠ tʰ i t͡ɕʰ o̞ k x ɯ
잠언	t͡ɕ a̠ m ʌ̹ n
이외	iː w e̞
몬트리올	m o̞ n tʰ ɯ ɾ i o̞ ɭ
청소기	t͡ɕʰ ʌ̹ ŋ sʰ o̞ ɡ i
연습	j ɘː n sʰ ɯ p̚
제주도롱뇽	t͡ɕ e̞ː d͡ʑ u d o̞ ɾ o̞ ŋ ɲ j o ŋ
친구	t͡ɕʰ i n ɡ u
파시즘	pʰ a̠ ɕʰ i d͡ʑ ɯ m
다마네기	t a̠ m a̠ n e̞ ɡ i
빵집	p͈ a̠ ŋ t͡ɕ͈ i p̚
능동태	n ɯ ŋ d o̞ ŋ tʰ e̞
왼손잡이	w e̞ː n sʰ o̞ n d͡ʑ a̠ b i
악력	a̠ ŋ ɲ j ʌ̹ k̚
서툴다	sʰ ɘː tʰ u ɭ d a̠
기린영양	k i ɾ i ɲ j ʌ̹ ŋ j a̠ ŋ
만년필	m a̠ː n ɲ j ʌ̹ n pʰ i ɭ
관련하다	k w a̠ ɭ ʎ j ʌ̹ n ɦ a̠ d a̠
즐기다	t͡ɕ ɯ ɭ ɡ i d a̠
황제	ɸ w a̠ ŋ d͡ʑ e̞
통치하다	tʰ o̞ː ŋ t͡ɕʰ i ɦ a̠ d a̠
뒹굴다	t ɥ i ŋ ɡ u ɭ d a̠
백러시아	p e̞ ŋ n ʌ̹ ɕʰ i a̠
국왕	k u ɡ w a̠ ŋ
적당히	t͡ɕ ʌ̹ k̚ t͈ a̠ ŋ ʝ i
헤파이스토스	h e̞ pʰ a̠ i sʰ ɯ tʰ o̞ sʰ ɯ
핸드볼	h e̞ n d ɯ b o̞ ɭ
집중	t͡ɕ i p̚ t͡ɕ͈ u ŋ
호르몬	ɸʷ o̞ ɾ ɯ m o̞ n
전관예우	t͡ɕ ʌ̹ n ɡ w a̠ n ɲ j e̞ u
국물	k u ŋ m u ɭ
옳다	o̞ ɭ tʰ a̠
조각	t͡ɕ o̞ ɡ a̠ k̚
입빠이	i p̚ p͈ a̠ i
깨끗하다	k͈ e̞ k͈ ɯ tʰ a̠ d a̠
켈빈	kʰ e̞ ɭ b i n
제한하다	t͡ɕ e̞ː ɦ a̠ n ɦ a̠ d a̠
크레용	k x ɯ ɾ e̞ j o ŋ
생신	sʰ e̞ ŋ ɕʰ i n
말씀	m a̠ː ɭ s͈ ɯ m
일기	i ɭ ɡ i
협박	ç j ʌ̹ p̚ p͈ a̠ k̚
명함	m j ʌ̹ ŋ ɦ a̠ m
리야드	ɾ i j a̠ d ɯ
독소	t o̞ k s͈ o̞
작은	t͡ɕ a̠ ɡ ɯ n
화석	ɸ w a̠ː sʰ ʌ̹ k̚
계산기	k j e̞ː sʰ a̠ n ɡ i
부터	p u tʰ ʌ̹
협잡질	ç j ʌ̹ p̚ t͡ɕ͈ a̠ p̚ t͡ɕ͈ i ɭ
정서	t͡ɕ ʌ̹ ŋ sʰ ʌ̹
포르토노보	pʰ o̞ ɾ ɯ tʰ o̞ n o̞ b o̞
무슬림	m u sʰ ɯ ɭ ʎ i m
확립	ɸ w a̠ ŋ n i p̚
정역학	t͡ɕ ʌ̹ ŋ ɲ j ʌ̹ kʰ a̠ k̚
콘택트	kʰ o̞ n tʰ e̞ k̚ tʰ ɯ
검댕	k ʌ̹ m t͈ e̞ ŋ
상환되다	sʰ a̠ ŋ β w a̠ n d w e̞ d a̠
경비원	k j ɘː ŋ b i w ʌ̹ n
넓적부리	n ʌ̹ p̚ t͡ɕ͈ ʌ̹ k̚ p͈ u ɾ i
아무르강	a̠ m u ɾ ɯ ɡ a̠ ŋ
복건	p o̞ k̚ k͈ ʌ̹ n
오페라	o̞ pʰ e̞ ɾ a̠
수족관	sʰ u d͡ʑ o̞ k̚ k͈ w a̠ n
택시	tʰ e̞ k ɕ͈ i
가소제	k a̠ː sʰ o̞ d͡ʑ e̞
그런데	k ɯ ɾ ʌ̹ n d e̞
유륜	j u ɾ j u n
러시아말	ɾ ʌ̹ ɕʰ i a̠ m a̠ ɭ
송장	sʰ o̞ː ŋ d͡ʑ a̠ ŋ
타지크어	tʰ a̠ d͡ʑ i k x ɯ ʌ̹
피롤	pʰ i ɾ o̞ ɭ
사무소	sʰ a̠ː m u sʰ o̞
교황	k j oː β w a̠ ŋ
마천루	m a̠ t͡ɕʰ ʌ̹ ɭ ɭ u
세수	sʰ e̞ː sʰ u
들다	t ɯ ɭ d a̠
소쩍새	sʰ o̞ t͡ɕ͈ ʌ̹ k s͈ e̞
레바논	ɾ e̞ b a̠ n o̞ n
저항기	t͡ɕ ʌ̹ ɦ a̠ ŋ ɡ i
토끼박쥐	tʰ o̞ k͈ i b a̠ k̚ t͡ɕ͈ ɥ i
아빠트	a̠ p͈ a̠ tʰ ɯ
도시	t o̞ ɕʰ i
인천	i n t͡ɕʰ ʌ̹ n
절망	t͡ɕ ʌ̹ ɭ m a̠ ŋ
곽밥	k w a̠ k̚ p͈ a̠ p̚
머릿속	m ʌ̹ ɾ i t̚ s͈ o̞ k̚
진지하다	t͡ɕ i n d͡ʑ i ɦ a̠ d a̠
꺾어지다	k͈ ʌ̹ k͈ ʌ̹ d͡ʑ i d a̠
소음	sʰ o̞ ɯ m
보관	p o̞ː ɡ w a̠ n
맞이	m a̠ d͡ʑ i
애정	e̞ː d͡ʑ ʌ̹ ŋ
오전	o̞ː d͡ʑ ʌ̹ n
한양	h a̠ː ɲ j a̠ ŋ
파리채	pʰ a̠ː ɾ i t͡ɕʰ e̞
한둘	h a̠ n d u ɭ
남조선	n a̠ m d͡ʑ o̞ sʰ ʌ̹ n
털발말똥가리	tʰ ʌ̹ ɭ b a̠ ɭ m a̠ ɭ t͈ o̞ ŋ ɡ a̠ ɾ i
타월	tʰ a̠ w ʌ̹ ɭ
권위	k w ʌ̹ n ɥ i
얼핏	ʌ̹ ɭ pʰ i t̚
실고기	ɕʰ iː ɭ ɡ o̞ ɡ i
프로필렌	pʰ ɯ ɾ o̞ pʰ i ɭ ɭ e̞ n
그루지야	k ɯ ɾ u d͡ʑ i j a̠
온갖	o̞ n ɡ a̠ t̚
체험	t͡ɕʰ e̞ ɦ ʌ̹ m
말솜씨	m a̠ː ɭ s͈ o̞ m ɕ͈ i
라지오	ɾ a̠ d͡ʑ i o̞
당근	t a̠ ŋ ɡ ɯ n
루시퍼	ɾ u ɕʰ i pʰ ʌ̹
통발	tʰ o̞ ŋ b a̠ ɭ
치킨	t͡ɕʰ i k ç i n
점원	t͡ɕ ɘː m w ʌ̹ n
연회	j ɘː n β w e̞
균형	k j u n ʝ j ʌ̹ ŋ
굉장히	k w e̞ ŋ d͡ʑ a̠ ŋ ʝ i
성망	sʰ ɘː ŋ m a̠ ŋ
목소리	m o̞ k s͈ o̞ ɾ i
필터	pʰ i ɭ tʰ ʌ̹
서남	sʰ ʌ̹ n a̠ m
프놈펜	pʰ ɯ n o̞ m pʰ e̞ n
백일몽	p e̞ ɡ i ɭ m o̞ ŋ
정사각형	t͡ɕ ɘː ŋ sʰ a̠ ɡ a̠ k ç j ʌ̹ ŋ
가능	k a̠ː n ɯ ŋ
미국인	m i ɡ u ɡ i n
한반도	h a̠ n b a̠ n d o̞
여행사	j ʌ̹ ɦ e̞ ŋ sʰ a̠
바로잡다	p a̠ ɾ o̞ d͡ʑ a̠ p̚ t͈ a̠
일본인	i ɭ b o̞ n i n
수호	sʰ u β o̞
열넷	j ʌ̹ ɭ ɭ e̞ t̚
탈취제	tʰ a̠ ɭ t͡ɕʰ ɥ i d͡ʑ e̞
카르복실기	kʰ a̠ ɾ ɯ b o̞ k ɕ͈ i ɭ ɡ i
집다	t͡ɕ i p̚ t͈ a̠
단수	t a̠ n sʰ u
통풍	tʰ o̞ː ŋ pʰ u ŋ
지라	t͡ɕ i ɾ a̠
오르내리다	o̞ ɾ ɯ n e̞ ɾ i d a̠
광동어	k w a̠ ŋ d o̞ ŋ ʌ̹
색인	sʰ e̞ ɡ i n
해오라기	h e̞ o̞ ɾ a̠ ɡ i
홍채	ɸʷ o̞ ŋ t͡ɕʰ e̞
점액	t͡ɕ ʌ̹ m e̞ k̚
체코	t͡ɕʰ e̞ kʰ o̞
강물	k a̠ ŋ m u ɭ
토바고	tʰ o̞ b a̠ ɡ o̞
부잣집	p uː d͡ʑ a̠ t̚ t͡ɕ͈ i p̚
한성	h a̠ː n sʰ ʌ̹ ŋ
파도	pʰ a̠ d o̞
편집자	pʰ j ʌ̹ n d͡ʑ i p̚ t͡ɕ͈ a̠
공무원	k o̞ ŋ m u w ʌ̹ n
터치패드	tʰ ʌ̹ t͡ɕʰ i pʰ e̞ d ɯ
카게베	kʰ a̠ ɡ e̞ b e̞
탈주자	tʰ a̠ ɭ t͡ɕ͈ u d͡ʑ a̠
풍뎅이	pʰ u ŋ d e̞ ŋ i
너머	n ʌ̹ m ʌ̹
하락하다	h a̠ː ɾ a̠ kʰ a̠ d a̠
익살	i k s͈ a̠ ɭ
츄잉껌	t͡ɕʰ j u i ŋ k͈ ʌ̹ m
격언	k j ʌ̹ ɡ ʌ̹ n
체포	t͡ɕʰ e̞ pʰ o̞
떡국	t͈ ʌ̹ k̚ k͈ u k̚
예레반	j e̞ ɾ e̞ b a̠ n
스케줄	sʰ ɯ kʰ e̞ d͡ʑ u ɭ
아라비아인	a̠ ɾ a̠ b i a̠ i n
아니	a̠ n i
부티크	p u tʰ i k x ɯ
교환	k j o β w a̠ n
가차	k a̠ t͡ɕʰ a̠
바지락	p a̠ d͡ʑ i ɾ a̠ k̚
아메리카홍머리오리	a̠ m e̞ ɾ i kʰ a̠ β o̞ ŋ m ʌ̹ ɾ i o̞ ɾ i
개학	k e̞ ɦ a̠ k̚
후견인	ɸʷ u ɡ j ʌ̹ n i n
땅크	t͈ a̠ ŋ k x ɯ
시도	ɕʰ iː d o̞
짐승	t͡ɕ i m sʰ ɯ ŋ
해바라기	h e̞ b a̠ ɾ a̠ ɡ i
헬조선	h e̞ ɭ d͡ʑ o̞ sʰ ʌ̹ n
병원	p j ɘː ŋ w ʌ̹ n
분홍색	p uː n β o̞ ŋ sʰ e̞ k̚
연락하다	j ʌ̹ ɭ ɭ a̠ kʰ a̠ d a̠
삼엽기	sʰ a̠ m j ʌ̹ p̚ k͈ i
리본	ɾ i b o̞ n
조선말	t͡ɕ o̞ sʰ ʌ̹ n m a̠ ɭ
똥싸다	t͈ o̞ ŋ s͈ a̠ d a̠
존중	t͡ɕ o̞ n d͡ʑ u ŋ
어름치	ʌ̹ ɾ ɯ m t͡ɕʰ i
스치다	sʰ ɯ t͡ɕʰ i d a̠
영혼	j ʌ̹ ŋ β o̞ n
이론	iː ɾ o̞ n
아이	a̠ i
칠판	t͡ɕʰ i ɭ pʰ a̠ n
노리개	n o̞ ɾ i ɡ e̞
미국흰죽지	m i ɡ u k ç i n d͡ʑ u k̚ t͡ɕ͈ i
각기	k a̠ k̚ k͈ i
신분증	ɕʰ i n b u n t͡ɕ͈ ɯ ŋ
단풍	t a̠ n pʰ u ŋ
시애틀	ɕʰ i e̞ tʰ ɯ ɭ
장과	t͡ɕ a̠ ŋ ɡ w a̠
중화민국	t͡ɕ u ŋ β w a̠ m i n ɡ u k̚
귀책사유	k ɥ iː t͡ɕʰ e̞ k s͈ a̠ j u
목마	m o̞ ŋ m a̠
여성스럽다	j ʌ̹ sʰ ʌ̹ ŋ sʰ ɯ ɾ ʌ̹ p̚ t͈ a̠
드러나다	t ɯ ɾ ʌ̹ n a̠ d a̠
부끄러워하다	p u k͈ ɯ ɾ ʌ̹ w ʌ̹ ɦ a̠ d a̠
용서하다	j o ŋ sʰ ʌ̹ ɦ a̠ d a̠
과식	k w a̠ː ɕʰ i k̚
장례	t͡ɕ a̠ː ŋ ɲ j e̞
교회	k j oː β w e̞
이어지다	i ʌ̹ d͡ʑ i d a̠
레인지	ɾ e̞ i n d͡ʑ i
준비하다	t͡ɕ uː n b i ɦ a̠ d a̠
실망시키다	ɕʰ i ɭ m a̠ ŋ ɕʰ i k ç i d a̠
가창	k a̠ t͡ɕʰ a̠ ŋ
초원	t͡ɕʰ o̞ w ʌ̹ n
시가	ɕʰ i ɡ a̠
소품	sʰ o̞ː pʰ u m
고갱이	k o̞ ɡ e̞ ŋ i
방아쇠	p a̠ ŋ a̠ sʰ w e̞
삥궐	p͈ i ŋ ɡ w ʌ̹ ɭ
무화과	m u β w a̠ ɡ w a̠
일흔	i ɾ ɣ ɯ n
소행성	sʰ o̞ː ɦ e̞ ŋ sʰ ʌ̹ ŋ
가라오케	k a̠ ɾ a̠ o̞ kʰ e̞
쇼룸	ɕʰ j o ɾ u m
그쪽	k ɯ t͡ɕ͈ o̞ k̚
이듬해	i d ɯ m ɦ e̞
방공	p a̠ ŋ ɡ o̞ ŋ
씹거웃	ɕ͈ i p̚ k͈ ʌ̹ u t̚
인듐	i n d j u m
환영하다	ɸ w a̠ ɲ j ʌ̹ ŋ ɦ a̠ d a̠
허구	h ʌ̹ ɡ u
빙빙	p i ŋ b i ŋ
반말	p a̠ n m a̠ ɭ
제쳐놓다	t͡ɕ e̞ t͡ɕʰ j ʌ̹ n o̞ tʰ a̠
접수처	t͡ɕ ʌ̹ p s͈ u t͡ɕʰ ʌ̹
각국	k a̠ k̚ k͈ u k̚
깍두기	k͈ a̠ k̚ t͈ u ɡ i
혁명	ç j ʌ̹ ŋ m j ʌ̹ ŋ
로그	ɾ o̞ ɡ ɯ
세계어	sʰ e̞ː ɡ j e̞ ʌ̹
두근거리다	t u ɡ ɯ n ɡ ʌ̹ ɾ i d a̠
제주어	t͡ɕ e̞ː d͡ʑ u ʌ̹
줄종개	t͡ɕ u ɭ d͡ʑ o̞ ŋ ɡ e̞
라고	ɾ a̠ ɡ o̞
양다리	j a̠ ŋ d a̠ ɾ i
공격전	k o̞ː ŋ ɡ j ʌ̹ k̚ t͡ɕ͈ ʌ̹ n
홍학	ɸʷ o̞ ŋ ɦ a̠ k̚
펩타이드	pʰ e̞ p̚ tʰ a̠ i d ɯ
쥐며느리	t͡ɕ ɥ i m j ʌ̹ n ɯ ɾ i
피우다	pʰ i u d a̠
개집	k e̞ː d͡ʑ i p̚
멍하다	m ɘː ŋ ɦ a̠ d a̠
양배추	j a̠ ŋ b e̞ t͡ɕʰ u
불편하다	p u ɭ pʰ j ʌ̹ n ɦ a̠ d a̠
마주치다	m a̠ d͡ʑ u t͡ɕʰ i d a̠
꾸준히	k͈ u d͡ʑ u n ʝ i
정주	t͡ɕ ɘː ŋ d͡ʑ u
남극해	n a̠ m ɡ ɯ kʰ e̞
정강이	t͡ɕ ʌ̹ ŋ ɡ a̠ ŋ i
플라스틱	pʰ ɯ ɭ ɭ a̠ sʰ ɯ tʰ i k̚
인용	i ɲ j o ŋ
항상	h a̠ ŋ sʰ a̠ ŋ
드라이기	t ɯ ɾ a̠ i ɡ i
오해	o̞ː ɦ e̞
체언	t͡ɕʰ e̞ː ʌ̹ n
행수	h e̞ ŋ sʰ u
브로콜리	p ɯ ɾ o̞ kʰ o̞ ɭ ʎ i
제비	t͡ɕ e̞ b i
쎈터	s͈ e̞ n tʰ ʌ̹
상의하다	sʰ a̠ ŋ ɰ i ɦ a̠ d a̠
편의	pʰ j ʌ̹ n ɰ i
죄송	t͡ɕ w e̞ː sʰ o̞ ŋ
발효	p a̠ ɾ ʝ j o
얼버무리다	ʌ̹ ɭ b ʌ̹ m u ɾ i d a̠
샴푸	ɕʰ j a̠ m pʰ u
붕어	p uː ŋ ʌ̹
시치미	ɕʰ i t͡ɕʰ i m i
데이트하다	t e̞ i tʰ ɯ ɦ a̠ d a̠
우체부	uː t͡ɕʰ e̞ b u
친하다	t͡ɕʰ i n ɦ a̠ d a̠
사이트	sʰ a̠ i tʰ ɯ
케피르	kʰ e̞ pʰ i ɾ ɯ
좋아지다	t͡ɕ o̞ː a̠ d͡ʑ i d a̠
서사하라	sʰ ʌ̹ sʰ a̠ ɦ a̠ ɾ a̠
부엉이	p u ʌ̹ ŋ i
합격	h a̠ p̚ k͈ j ʌ̹ k̚
붕대	p u ŋ d e̞
서까래	sʰ ʌ̹ k͈ a̠ ɾ e̞
다운로드	t a̠ u n n o̞ d ɯ
내년	n e̞ ɲ j ʌ̹ n
자세하다	t͡ɕ a̠ sʰ e̞ ɦ a̠ d a̠
판도	pʰ a̠ n d o̞
쇠갈밭쥐	sʰ w e̞ ɡ a̠ ɭ b a̠ t̚ t͡ɕ͈ ɥ i
자유적	t͡ɕ a̠ j u d͡ʑ ʌ̹ k̚
옥고	o̞ k̚ k͈ o̞
식다	ɕʰ i k̚ t͈ a̠
민요	m i ɲ j o
영원	j ɘː ŋ w ʌ̹ n
건답	k ʌ̹ n d a̠ p̚
모로니	m o̞ ɾ o̞ n i
신형	ɕʰ iː n ʝ j ʌ̹ ŋ
횡령	ɸ w e̞ ŋ ɲ j ʌ̹ ŋ
키위	k ç i ɥ i
무덤	m u d ʌ̹ m
의생	ɰ i sʰ e̞ ŋ
낙태	n a̠ k̚ tʰ e̞
베개	p e̞ ɡ e̞
스파게티	sʰ ɯ pʰ a̠ ɡ e̞ tʰ i
낙천주의	n a̠ k̚ t͡ɕʰ ʌ̹ n d͡ʑ u ɰ i
뒤늦다	t ɥ iː n ɯ t̚ t͈ a̠
레이스	ɾ e̞ i sʰ ɯ
늙다리	n ɯ k̚ t͈ a̠ ɾ i
커지다	kʰ ʌ̹ d͡ʑ i d a̠
정액	t͡ɕ ʌ̹ ŋ e̞ k̚
쌍둥이	s͈ a̠ ŋ d u ŋ i
벨리즈	p e̞ ɭ ʎ i d͡ʑ ɯ
수프	sʰ u pʰ ɯ
밉다	m iː p̚ t͈ a̠
유형	j uː ʝ j ʌ̹ ŋ
어루다	ʌ̹ ɾ u d a̠
끊임없이	k͈ ɯ n i m ʌ̹ p ɕ͈ i
퀴논	kʰ ɥ i n o̞ n
배경	p e̞ː ɡ j ʌ̹ ŋ
힌두교	ç i n d u ɡ j o
잊히다	i t͡ɕʰ i d a̠
머슴	m ʌ̹ sʰ ɯ m
후계자	ɸʷ u ɡ j e̞ d͡ʑ a̠
콘센트	kʰ o̞ n sʰ e̞ n tʰ ɯ
산사태	sʰ a̠ n sʰ a̠ tʰ e̞
파라마리보	pʰ a̠ ɾ a̠ m a̠ ɾ i b o̞
여건	j ɘː ɡ ʌ̹ n
자동	t͡ɕ a̠ d o̞ ŋ
고유명사	k o̞ j u m j ʌ̹ ŋ sʰ a̠
시한폭탄	ɕʰ i ɦ a̠ n pʰ o̞ k̚ tʰ a̠ n
형식	ç j ʌ̹ ŋ ɕʰ i k̚
제재	t͡ɕ e̞ː d͡ʑ e̞
샐러드	sʰ e̞ ɭ ɭ ʌ̹ d ɯ
크레인	k x ɯ ɾ e̞ i n
블루길	p ɯ ɭ ɭ u ɡ i ɭ
관계	k w a̠ n ɡ j e̞
간섭	k a̠ n sʰ ʌ̹ p̚
그래픽	k ɯ ɾ e̞ pʰ i k̚
화약	ɸ w a̠ː j a̠ k̚
저수지	t͡ɕ ɘː sʰ u d͡ʑ i
사르르	sʰ a̠ ɾ ɯ ɾ ɯ
북돋우다	p u k̚ t͈ o̞ d u d a̠
구마	k u m a̠
곤돌라	k o̞ n d o̞ ɭ ɭ a̠
십대	ɕʰ i p̚ t͈ e̞
몸빛깔	m o̞ m p͈ i t̚ k͈ a̠ ɭ
혼혈	ɸʷ o̞ː n ʝ j ʌ̹ ɭ
깨끗이	k͈ e̞ k͈ ɯ ɕʰ i
풀어지다	pʰ u ɾ ʌ̹ d͡ʑ i d a̠
생산하다	sʰ e̞ ŋ sʰ a̠ n ɦ a̠ d a̠
레소토	ɾ e̞ sʰ o̞ tʰ o̞
시달리다	ɕʰ i d a̠ ɭ ʎ i d a̠
광학	k w a̠ ŋ ɦ a̠ k̚
지린	t͡ɕ i ɾ i n
비판하다	p iː pʰ a̠ n ɦ a̠ d a̠
연뿌리	j ʌ̹ n p͈ u ɾ i
미사일	m i sʰ a̠ i ɭ
악어	a̠ ɡ ʌ̹
연주	j ɘː n d͡ʑ u
시보귬	ɕʰ i b o̞ ɡ j u m
촛불	t͡ɕʰ o̞ t̚ p͈ u ɭ
가름	k a̠ ɾ ɯ m
방송	p a̠ː ŋ sʰ o̞ ŋ
편집	pʰ j ʌ̹ n d͡ʑ i p̚
풍경	pʰ u ŋ ɡ j ʌ̹ ŋ
사이렌	s͈ a̠ i ɾ e̞ n
돌려주다	t o̞ ɭ ʎ j ʌ̹ d͡ʑ u d a̠
편자	pʰ j ʌ̹ n d͡ʑ a̠
씁쓸하다	s͈ ɯ p s͈ ɯ ɾ ɦ a̠ d a̠
도착하다	t o̞ː t͡ɕʰ a̠ kʰ a̠ d a̠
버팔로	p ʌ̹ pʰ a̠ ɭ ɭ o̞
남사친	n a̠ m sʰ a̠ t͡ɕʰ i n
그렇지	k ɯ ɾ ʌ̹ t͡ɕʰ i
머리하다	m ʌ̹ ɾ i ɦ a̠ d a̠
광둥	k w a̠ ŋ d u ŋ
초호	t͡ɕʰ o̞ β o̞
부처	p u t͡ɕʰ ʌ̹
소용돌이	sʰ o̞ j o ŋ d o̞ ɾ i
멍텅구리	m ʌ̹ ŋ tʰ ʌ̹ ŋ ɡ u ɾ i
엄니	ɘː m n i
밥벌이	p a̠ p̚ p͈ ʌ̹ ɾ i
로토	ɾ o̞ tʰ o̞
직물	t͡ɕ i ŋ m u ɭ
작은윗수염박쥐	t͡ɕ a̠ ɡ ɯ n ɥ i t̚ s͈ u j ʌ̹ m b a̠ k̚ t͡ɕ͈ ɥ i
신입생	ɕʰ i n i p s͈ e̞ ŋ
주인공	t͡ɕ u i n ɡ o̞ ŋ
임하다	i m ɦ a̠ d a̠
일상	i ɭ sʰ a̠ ŋ
공공	k o̞ ŋ ɡ o̞ ŋ
전략	t͡ɕ ɘː ɭ ʎ j a̠ k̚
감초	k a̠ m t͡ɕʰ o̞
분광	p u n ɡ w a̠ ŋ
정치	t͡ɕ ʌ̹ ŋ t͡ɕʰ i
냉장고	n e̞ː ŋ d͡ʑ a̠ ŋ ɡ o̞
숙련자	sʰ u ŋ ɲ j ʌ̹ n d͡ʑ a̠
반립자	p a̠ ɭ ʎ i p̚ t͡ɕ͈ a̠
내지	n e̞ː d͡ʑ i
구쟁이	k u d͡ʑ e̞ ŋ i
이대로	i d e̞ ɾ o̞
타이베이	tʰ a̠ i b e̞ i
관복	k w a̠ n b o̞ k̚
우주비행사	uː d͡ʑ u b i ɦ e̞ ŋ sʰ a̠
소라	sʰ o̞ ɾ a̠
자체	t͡ɕ a̠ t͡ɕʰ e̞
페레스트로이카	pʰ e̞ ɾ e̞ sʰ ɯ tʰ ɯ ɾ o̞ i kʰ a̠
누군가	n u ɡ u n ɡ a̠
자외선	t͡ɕ a̠ː w e̞ sʰ ʌ̹ n
손질하다	sʰ o̞ n d͡ʑ i ɾ ɦ a̠ d a̠
지읒	t͡ɕ i ɯ t̚
해양	h e̞ː j a̠ ŋ
조피볼락	t͡ɕ o̞ pʰ i b o̞ ɭ ɭ a̠ k̚
은어	ɯ n ʌ̹
배양액	p e̞ː j a̠ ŋ e̞ k̚
유원지	j u w ʌ̹ n d͡ʑ i
배변하다	p e̞ b j ʌ̹ n ɦ a̠ d a̠
센티미터	s͈ e̞ n tʰ i m i tʰ ʌ̹
산개구리	sʰ a̠ n ɡ e̞ ɡ u ɾ i
왁자그르르	w a̠ k̚ t͡ɕ͈ a̠ ɡ ɯ ɾ ɯ ɾ ɯ
본능	p o̞ n n ɯ ŋ
절대적	t͡ɕ ʌ̹ ɭ t͈ e̞ d͡ʑ ʌ̹ k̚
관찰	k w a̠ n t͡ɕʰ a̠ ɭ
는지	n ɯ n d͡ʑ i
호북	ɸʷ o̞ b u k̚
계곡	k j e̞ ɡ o̞ k̚
마침	m a̠ t͡ɕʰ i m
학생회관	h a̠ k s͈ e̞ ŋ β w e̞ ɡ w a̠ n
뻔하다	p͈ ɘː n ɦ a̠ d a̠
촉지	t͡ɕʰ o̞ k̚ t͡ɕ͈ i
프리랜서	pʰ ɯ ɾ i ɾ e̞ n sʰ ʌ̹
드리다	t ɯ ɾ i d a̠
속하다	sʰ o̞ kʰ a̠ d a̠
반절	p a̠ n d͡ʑ ʌ̹ ɭ
안면승마	a̠ n m j ʌ̹ n sʰ ɯ ŋ m a̠
반대	p a̠ː n d e̞
똠얌	t͈ o̞ m j a̠ m
이르쿠츠크	i ɾ ɯ kʰ u t͡ɕʰ ɯ k x ɯ
치욕	t͡ɕʰ i j o k̚
가드	k a̠ d ɯ
사내	sʰ a̠ n e̞
라바트	ɾ a̠ b a̠ tʰ ɯ
됨됨이	t w e̞ m d w e̞ m i
만억	m a̠ː n ʌ̹ k̚
흔들다	x ɯ n d ɯ ɭ d a̠
극히	k ɯ k ç i
통나무	tʰ o̞ ŋ n a̠ m u
웁살라	u p s͈ a̠ ɭ ɭ a̠
복장	p o̞ k̚ t͡ɕ͈ a̠ ŋ
오래다	o̞ ɾ e̞ d a̠
장난	t͡ɕ a̠ ŋ n a̠ n
놀이공원	n o̞ ɾ i ɡ o̞ ŋ w ʌ̹ n
집단화	t͡ɕ i p̚ t͈ a̠ n β w a̠
매일	m e̞ː i ɭ
파랗다	pʰ a̠ː ɾ a̠ tʰ a̠
브랜드	p ɯ ɾ e̞ n d ɯ
피하다	pʰ iː ɦ a̠ d a̠
오늄	o̞ ɲ j u m
수요일	sʰ u j o i ɭ
절차	t͡ɕ ʌ̹ ɭ t͡ɕʰ a̠
통상	tʰ o̞ ŋ sʰ a̠ ŋ
스웨덴	sʰ ɯ w e̞ d e̞ n
정비	t͡ɕ ɘː ŋ b i
요가	j o ɡ a̠
생산되다	sʰ e̞ ŋ sʰ a̠ n d w e̞ d a̠
예문	j e̞ː m u n
치마	t͡ɕʰ i m a̠
히브리어	ç i b ɯ ɾ i ʌ̹
비행	p i ɦ e̞ ŋ
소비	sʰ o̞ b i
똑똑하다	t͈ o̞ k̚ t͈ o̞ kʰ a̠ d a̠
지만	t͡ɕ i m a̠ n
성행위	sʰ ɘː ŋ ɦ e̞ ŋ ɥ i
지뢰	t͡ɕ i ɾ w e̞
따오다	t͈ a̠ o̞ d a̠
끈기	k͈ ɯ n ɡ i
재킷	t͡ɕ e̞ k ç i t̚
사실	sʰ a̠ː ɕʰ i ɭ
환경	ɸ w a̠ n ɡ j ʌ̹ ŋ
발생	p a̠ ɭ s͈ e̞ ŋ
가지고	k a̠ d͡ʑ i ɡ o̞
갉다	k a̠ k̚ t͈ a̠
엉큼하다	ʌ̹ ŋ k x ɯ m ɦ a̠ d a̠
부조리	p u d͡ʑ o̞ ɾ i
오이	o̞ i
복잡	p o̞ k̚ t͡ɕ͈ a̠ p̚
도서관	t o̞ sʰ ʌ̹ ɡ w a̠ n
싱겁다	ɕʰ i ŋ ɡ ʌ̹ p̚ t͈ a̠
육자대명왕진언	j u k̚ t͡ɕ͈ a̠ d e̞ m j ʌ̹ ŋ w a̠ ŋ d͡ʑ i n ʌ̹ n
단락	t a̠ ɭ ɭ a̠ k̚
빨리	p͈ a̠ ɭ ʎ i
아쉬움	a̠ ʃʰ ɥ i u m
성씨	sʰ ɘː ŋ ɕ͈ i
수캐	sʰ u kʰ e̞
여남은	j ʌ̹ n a̠ m ɯ n
토지	tʰ o̞ d͡ʑ i
반발	p a̠ː n b a̠ ɭ
답답하다	t a̠ p̚ t͈ a̠ pʰ a̠ d a̠
천문학	t͡ɕʰ ʌ̹ n m u n ɦ a̠ k̚
생물체	sʰ e̞ ŋ m u ɭ t͡ɕʰ e̞
세금	sʰ e̞ː ɡ ɯ m
스캐너	sʰ ɯ kʰ e̞ n ʌ̹
우표	u pʰ j o
기간	k i ɡ a̠ n
되풀이하다	t w e̞ pʰ u ɾ i ɦ a̠ d a̠
세상	sʰ e̞ː sʰ a̠ ŋ
아편	a̠ pʰ j ʌ̹ n
문구점	m u n ɡ u d͡ʑ ʌ̹ m
당황하다	t a̠ ŋ β w a̠ ŋ ɦ a̠ d a̠
목숨	m o̞ k s͈ u m
개밥바라기	k e̞ b a̠ p̚ p͈ a̠ ɾ a̠ ɡ i
후식	ɸʷ uː ɕʰ i k̚
노래방	n o̞ ɾ e̞ b a̠ ŋ
치우다	t͡ɕʰ i u d a̠
고슴도치	k o̞ sʰ ɯ m d o̞ t͡ɕʰ i
혐의	ç j ʌ̹ m ɰ i
커다랗다	kʰ ɘː d a̠ ɾ a̠ tʰ a̠
뺑소니	p͈ e̞ ŋ sʰ o̞ n i
해요체	h e̞ j o t͡ɕʰ e̞
화장지	ɸ w a̠ d͡ʑ a̠ ŋ d͡ʑ i
대야	t e̞ j a̠
회화	ɸ w e̞ː β w a̠
소꿉친구	sʰ o̞ k͈ u p̚ t͡ɕʰ i n ɡ u
사용	sʰ a̠ː j o ŋ
치르다	t͡ɕʰ i ɾ ɯ d a̠
교토	k j o tʰ o̞
천리안	t͡ɕʰ ʌ̹ ɭ ʎ i a̠ n
소꿉동무	sʰ o̞ k͈ u p̚ t͈ o̞ ŋ m u
펌프	pʰ ʌ̹ m pʰ ɯ
소유자	sʰ o̞ː j u d͡ʑ a̠
지나가다	t͡ɕ i n a̠ ɡ a̠ d a̠
아카데미	a̠ kʰ a̠ d e̞ m i
모험	m o̞ː ɦ ʌ̹ m
정하다	t͡ɕ ɘː ŋ ɦ a̠ d a̠
강원도	k a̠ ŋ w ʌ̹ n d o̞
싸인펜	s͈ a̠ i n pʰ e̞ n
솔직	sʰ o̞ ɭ t͡ɕ͈ i k̚
구입하다	k u i pʰ a̠ d a̠
둔치다	t u n t͡ɕʰ i d a̠
참둑중개	t͡ɕʰ a̠ m d u k̚ t͡ɕ͈ u ŋ ɡ e̞
이슬라마바드	i sʰ ɯ ɭ ɭ a̠ m a̠ b a̠ d ɯ
교도	k j oː d o̞
어떡하다	ʌ̹ t͈ ʌ̹ kʰ a̠ d a̠
간편하다	k a̠ n pʰ j ʌ̹ n ɦ a̠ d a̠
신천옹	ɕʰ iː n t͡ɕʰ ʌ̹ n o̞ ŋ
수은	sʰ u ɯ n
공학	k o̞ ŋ ɦ a̠ k̚
편암	pʰ j ʌ̹ n a̠ m
당연하다	t a̠ ŋ j ʌ̹ n ɦ a̠ d a̠
헛코골다	h ʌ̹ t̚ kʰ o̞ ɡ o̞ ɭ d a̠
보도	p o̞ː d o̞
프라이아	pʰ ɯ ɾ a̠ i a̠
트롤리버스	tʰ ɯ ɾ o̞ ɭ ʎ i b ʌ̹ sʰ ɯ
인정	i n d͡ʑ ʌ̹ ŋ
코드	kʰ o̞ d ɯ
에미	e̞ m i
콜린	kʰ o̞ ɭ ʎ i n
잡종	t͡ɕ a̠ p̚ t͡ɕ͈ o̞ ŋ
우롱차	u ɾ o̞ ŋ t͡ɕʰ a̠
고마워	k o̞ m a̠ w ʌ̹
가끔씩	k a̠ k͈ ɯ m ɕ͈ i k̚
기회주의자	k i β w e̞ d͡ʑ u ɰ i d͡ʑ a̠
그다지	k ɯ d a̠ d͡ʑ i
흡연	x ɯ b j ʌ̹ n
참말	t͡ɕʰ a̠ m m a̠ ɭ
인어	i n ʌ̹
홀소리	ɸʷ o̞ ɭ s͈ o̞ ɾ i
화물	ɸ w a̠ː m u ɭ
원망	w ʌ̹ n m a̠ ŋ
이별	i b j ʌ̹ ɭ
말레이어	m a̠ ɭ ɭ e̞ i ʌ̹
미끄럽다	m i k͈ ɯ ɾ ʌ̹ p̚ t͈ a̠
속어	sʰ o̞ ɡ ʌ̹
대신	t e̞ː ɕʰ i n
심성	ɕʰ i m sʰ ʌ̹ ŋ
가계	k a̠ ɡ j e̞
이룩하다	i ɾ u kʰ a̠ d a̠
지적	t͡ɕ i d͡ʑ ʌ̹ k̚
점수	t͡ɕ ʌ̹ m s͈ u
황조롱이	ɸ w a̠ ŋ d͡ʑ o̞ ɾ o̞ ŋ i
장작	t͡ɕ a̠ ŋ d͡ʑ a̠ k̚
진보	t͡ɕ iː n b o̞
꼬치구이	k͈ o̞ t͡ɕʰ i ɡ u i
목란	m o̞ ŋ n a̠ n
부아	p u a̠
표지판	pʰ j o d͡ʑ i pʰ a̠ n
갈래	k a̠ ɭ ɭ e̞
위생실	ɥ i sʰ e̞ ŋ ɕʰ i ɭ
석탄산	sʰ ʌ̹ k̚ tʰ a̠ n sʰ a̠ n
이삼	iː sʰ a̠ m
도메인	t o̞ m e̞ i n
불고기	p u ɭ ɡ o̞ ɡ i
낙엽	n a̠ ɡ j ʌ̹ p̚
방편	p a̠ ŋ pʰ j ʌ̹ n
콤바인	kʰ o̞ m b a̠ i n
천장	t͡ɕʰ ʌ̹ n d͡ʑ a̠ ŋ
쌀쌀하다	s͈ a̠ ɭ s͈ a̠ ɾ ɦ a̠ d a̠
댈러스	t e̞ ɭ ɭ ʌ̹ sʰ ɯ
다행하다	t a̠ ɦ e̞ ŋ ɦ a̠ d a̠
설치류	sʰ ʌ̹ ɭ t͡ɕʰ i ɾ j u
바깥쪽	p a̠ k͈ a̠ t̚ t͡ɕ͈ o̞ k̚
서문	sʰ ɘː m u n
네트워크	n e̞ tʰ ɯ w ʌ̹ k x ɯ
공연	k o̞ ŋ j ʌ̹ n
한계	h a̠ː n ɡ j e̞
국민학교	k u ŋ m i n ɦ a̠ k̚ k͈ j o
놀아나다	n o̞ ɾ a̠ n a̠ d a̠
플라스마	pʰ ɯ ɭ ɭ a̠ sʰ ɯ m a̠
국제어	k uː k̚ t͡ɕ͈ e̞ ʌ̹
원인	w ʌ̹ n i n
대상자	t e̞ sʰ a̠ ŋ d͡ʑ a̠
목마름	m o̞ ŋ m a̠ ɾ ɯ m
빙어	p i ŋ ʌ̹
외환	w e̞ː β w a̠ n
이라크	i ɾ a̠ k x ɯ
혹성	ɸʷ o̞ k s͈ ʌ̹ ŋ
참매	t͡ɕʰ a̠ m m e̞
그녀들	k ɯ ɲ j ʌ̹ d ɯ ɭ
잔류	t͡ɕ a̠ ɭ ʎ j u
야채	j a̠ː t͡ɕʰ e̞
뮤직비디오	m j u d͡ʑ i k̚ p͈ i d i o̞
안개	a̠ n ɡ e̞
가물치	k a̠ m u ɭ t͡ɕʰ i
낮아지다	n a̠ d͡ʑ a̠ d͡ʑ i d a̠
곰국	k o̞ː m k͈ u k̚
동기	t o̞ ŋ ɡ i
분자	p u n d͡ʑ a̠
고치다	k o̞ t͡ɕʰ i d a̠
노르웨이	n o̞ ɾ ɯ w e̞ i
짓다	t͡ɕ iː t̚ t͈ a̠
혁명가	ç j ʌ̹ ŋ m j ʌ̹ ŋ ɡ a̠
늘다	n ɯ ɭ d a̠
얼른	ʌ̹ ɭ ɭ ɯ n
제복	t͡ɕ e̞ː b o̞ k̚
화창하다	ɸ w a̠ t͡ɕʰ a̠ ŋ ɦ a̠ d a̠
겨우	k j ʌ̹ u
비교하다	p iː ɡ j o ɦ a̠ d a̠
파라과이	pʰ a̠ ɾ a̠ ɡ w a̠ i
수명	sʰ u m j ʌ̹ ŋ
대시보드	t e̞ ɕʰ i b o̞ d ɯ
내밀다	n e̞ː m i ɭ d a̠
로봇	ɾ o̞ b o̞ t̚
묘사	m j oː sʰ a̠
얼짱	ʌ̹ ɭ t͡ɕ͈ a̠ ŋ
나누다	n a̠ n u d a̠
신뢰	ɕʰ iː ɭ ɭ w e̞
빈틈	p iː n tʰ ɯ m
꾸바	k͈ u b a̠
마피아	m a̠ pʰ i a̠
농사	n o̞ ŋ sʰ a̠
검사	k ɘː m sʰ a̠
빠져나오다	p͈ a̠ː d͡ʑ j ʌ̹ n a̠ o̞ d a̠
식품	ɕʰ i k̚ pʰ u m
현장	ç j ɘː n d͡ʑ a̠ ŋ
입자	i p̚ t͡ɕ͈ a̠
광물	k w a̠ː ŋ m u ɭ
훑다	ɸʷ u ɭ t͈ a̠
노워스티	n o̞ w ʌ̹ sʰ ɯ tʰ i
비빔	p i b i m
낫다	n a̠ː t̚ t͈ a̠
나프탈렌	n a̠ pʰ ɯ tʰ a̠ ɭ ɭ e̞ n
이러하다	i ɾ ʌ̹ ɦ a̠ d a̠
기독	k i d o̞ k̚
뽈스카	p͈ o̞ ɭ sʰ ɯ kʰ a̠
동전	t o̞ ŋ d͡ʑ ʌ̹ n
경찰관	k j ɘː ŋ t͡ɕʰ a̠ ɭ ɡ w a̠ n
가무이야기	k a̠ m u i j a̠ ɡ i
게시판	k e̞ː ɕʰ i pʰ a̠ n
트로트	tʰ ɯ ɾ o̞ tʰ ɯ
군사	k u n sʰ a̠
다들	t a̠ d ɯ ɭ
천산갑	t͡ɕʰ ɘː n sʰ a̠ n ɡ a̠ p̚
오존	o̞ d͡ʑ o̞ n
다리미질하다	t a̠ ɾ i m i d͡ʑ i ɾ ɦ a̠ d a̠
짱꼴라	t͡ɕ͈ a̠ ŋ k͈ o̞ ɭ ɭ a̠
페르시아	pʰ e̞ ɾ ɯ ɕʰ i a̠
눈물	n u n m u ɭ
평해	pʰ j ʌ̹ ŋ ɦ e̞
명부	m j ʌ̹ ŋ b u
우아	u a̠
다발	t a̠ b a̠ ɭ
모시다	m o̞ː ɕʰ i d a̠
새콤하다	sʰ e̞ kʰ o̞ m ɦ a̠ d a̠
본받다	p o̞ n b a̠ t̚ t͈ a̠
체온계	t͡ɕʰ e̞ o̞ n ɡ j e̞
군체	k u n t͡ɕʰ e̞
초콜릿	t͡ɕʰ o̞ kʰ o̞ ɭ ʎ i t̚
운동화	uː n d o̞ ŋ β w a̠
그레이비	k ɯ ɾ e̞ i b i
죄인	t͡ɕ w e̞ː i n
분탕질	p u n tʰ a̠ ŋ d͡ʑ i ɭ
목다리	m o̞ k̚ t͈ a̠ ɾ i
추악하다	t͡ɕʰ u a̠ kʰ a̠ d a̠
켤레	k ç j ʌ̹ ɭ ɭ e̞
포르투갈	pʰ o̞ ɾ ɯ tʰ u ɡ a̠ ɭ
프라세오디뮴	pʰ ɯ ɾ a̠ sʰ e̞ o̞ d i m j u m
유물	j u m u ɭ
도달	t o̞ː d a̠ ɭ
지진학	t͡ɕ i d͡ʑ i n ɦ a̠ k̚
알바니아	a̠ ɭ b a̠ n i a̠
조센징	t͡ɕ o̞ sʰ e̞ n d͡ʑ i ŋ
당신들	t a̠ ŋ ɕʰ i n d ɯ ɭ
벼랑	p j ʌ̹ ɾ a̠ ŋ
향유	ç j a̠ ŋ j u
팔다리	pʰ a̠ ɭ d a̠ ɾ i
그릴	k ɯ ɾ i ɭ
연체동물	j ɘː n t͡ɕʰ e̞ d o̞ ŋ m u ɭ
몰타	m o̞ ɭ tʰ a̠
왜구	w e̞ ɡ u
파동함수	pʰ a̠ d o̞ ŋ ɦ a̠ m sʰ u
데려오다	t e̞ ɾ j ʌ̹ o̞ d a̠
발꿈치	p a̠ ɭ k͈ u m t͡ɕʰ i
티켓	tʰ i kʰ e̞ t̚
연루	j ʌ̹ ɭ ɭ u
영적	j ʌ̹ ŋ t͡ɕ͈ ʌ̹ k̚
편성	pʰ j ʌ̹ n sʰ ʌ̹ ŋ
찍다	t͡ɕ͈ i k̚ t͈ a̠
동맥	t o̞ː ŋ m e̞ k̚
옥좌	o̞ k̚ t͡ɕ͈ w a̠
거인	k ɘː i n
요일	j o i ɭ
바게트	p͈ a̠ ɡ e̞ tʰ ɯ
주중	t͡ɕ u d͡ʑ u ŋ
견본	k j ɘː n b o̞ n
복지	p o̞ k̚ t͡ɕ͈ i
오바마	o̞ b a̠ m a̠
함대	h a̠ː m d e̞
부지런	p u d͡ʑ i ɾ ʌ̹ n
선반	sʰ ʌ̹ n b a̠ n
참고서	t͡ɕʰ a̠ m ɡ o̞ sʰ ʌ̹
빈대떡	p i n d e̞ t͈ ʌ̹ k̚
도적	t o̞ d͡ʑ ʌ̹ k̚
이혼하다	iː β o̞ n ɦ a̠ d a̠
역경	j ʌ̹ k̚ k͈ j ʌ̹ ŋ
증기	t͡ɕ ɯ ŋ ɡ i
튀르크	tʰ ɥ i ɾ ɯ k x ɯ
변이하다	p j ɘː n i ɦ a̠ d a̠
참기름	t͡ɕʰ a̠ m ɡ i ɾ ɯ m
도덕	t o̞ː d ʌ̹ k̚
흰수마자	ç i n sʰ u m a̠ d͡ʑ a̠
입다	i p̚ t͈ a̠
귀환	k ɥ iː β w a̠ n
하원	h a̠ː w ʌ̹ n
민부리고래	m i n b u ɾ i ɡ o̞ ɾ e̞
이상하다	iː sʰ a̠ ŋ ɦ a̠ d a̠
버무리다	p ʌ̹ m u ɾ i d a̠
끈적끈적하다	k͈ ɯ n d͡ʑ ʌ̹ k̚ k͈ ɯ n d͡ʑ ʌ̹ kʰ a̠ d a̠
개판	k e̞ː pʰ a̠ n
제한	t͡ɕ e̞ː ɦ a̠ n
까다롭다	k͈ a̠ː d a̠ ɾ o̞ p̚ t͈ a̠
주인	t͡ɕ u i n
잘다	t͡ɕ a̠ ɭ d a̠
십칠	ɕʰ i p̚ t͡ɕʰ i ɭ
잠수함	t͡ɕ a̠ m sʰ u ɦ a̠ m
복제	p o̞ k̚ t͡ɕ͈ e̞
대리인	t e̞ː ɾ i i n
토륨	tʰ o̞ ɾ j u m
발매	p a̠ ɭ m e̞
표면장력	pʰ j o m j ʌ̹ n d͡ʑ a̠ ŋ ɲ j ʌ̹ k̚
민낯	m i n n a̠ t̚
고물	k o̞ m u ɭ
회색	ɸ w e̞ sʰ e̞ k̚
바라다	p a̠ ɾ a̠ d a̠
되찾다	t w e̞ t͡ɕʰ a̠ t̚ t͈ a̠
리브르빌	ɾ i b ɯ ɾ ɯ b i ɭ
버들가지	p ʌ̹ d ɯ ɭ ɡ a̠ d͡ʑ i
남방동사리	n a̠ m b a̠ ŋ d o̞ ŋ sʰ a̠ ɾ i
멕시코	m e̞ k ɕ͈ i kʰ o̞
인체	i n t͡ɕʰ e̞
자메이카	t͡ɕ a̠ m e̞ i kʰ a̠
비골	p iː ɡ o̞ ɭ
과들루쁘	k w a̠ d ɯ ɭ ɭ u p͈ ɯ
머물다	m ʌ̹ m u ɭ d a̠
당나귀	t a̠ ŋ n a̠ ɡ ɥ i
악곡	a̠ k̚ k͈ o̞ k̚
오가다	o̞ ɡ a̠ d a̠
묵납자루	m u ŋ n a̠ p̚ t͡ɕ͈ a̠ ɾ u
찬가	t͡ɕʰ a̠ː n k͈ a̠
누악쇼트	n u a̠ k ɕ͈ j o tʰ ɯ
천황	t͡ɕʰ ʌ̹ n β w a̠ ŋ
훈장	ɸʷ u n d͡ʑ a̠ ŋ
흰고래	ç i n ɡ o̞ ɾ e̞
메뚜기	m e̞ t͈ u ɡ i
욕실	j o k ɕ͈ i ɭ
베짱이	p e̞ t͡ɕ͈ a̠ ŋ i
총알열차	t͡ɕʰ o̞ ŋ a̠ ɾ j ʌ̹ ɭ t͡ɕʰ a̠
텔레비	tʰ e̞ ɭ ɭ e̞ b i
이력서	iː ɾ j ʌ̹ k s͈ ʌ̹
펠라티오	pʰ e̞ ɭ ɭ a̠ tʰ i o̞
생태학	sʰ e̞ ŋ tʰ e̞ ɦ a̠ k̚
짱깨	t͡ɕ͈ a̠ ŋ k͈ e̞
지점	t͡ɕ i d͡ʑ ʌ̹ m
가벼워지다	k a̠ b j ʌ̹ w ʌ̹ d͡ʑ i d a̠
핵심	h e̞ k ɕ͈ i m
펼치다	pʰ j ʌ̹ ɭ t͡ɕʰ i d a̠
어리석다	ʌ̹ ɾ i sʰ ʌ̹ k̚ t͈ a̠
맡기다	m a̠ t̚ k͈ i d a̠
셀로판	sʰ e̞ ɭ ɭ o̞ pʰ a̠ n
아예	a̠ j e̞
일보	i ɭ b o̞
청국장	t͡ɕʰ ʌ̹ ŋ ɡ u k̚ t͡ɕ͈ a̠ ŋ
거주하다	k ʌ̹ d͡ʑ u ɦ a̠ d a̠
안내	a̠ː n n e̞
바마코	p a̠ m a̠ kʰ o̞
비디오테이프	p i d i o̞ tʰ e̞ i pʰ ɯ
겹치다	k j ʌ̹ p̚ t͡ɕʰ i d a̠
지방	t͡ɕ i b a̠ ŋ
여드름	j ʌ̹ d ɯ ɾ ɯ m
가구	k a̠ ɡ u
타이가	tʰ a̠ i ɡ a̠
모피	m o̞ pʰ i
가오리	k a̠ o̞ ɾ i
한강납줄개	h a̠ n ɡ a̠ ŋ n a̠ p̚ t͡ɕ͈ u ɭ ɡ e̞
향수	ç j a̠ ŋ sʰ u
교역	k j o j ʌ̹ k̚
뉘우치다	n ɥ i u t͡ɕʰ i d a̠
부안종개	p u a̠ n d͡ʑ o̞ ŋ ɡ e̞
뱀장어	p e̞ː m d͡ʑ a̠ ŋ ʌ̹
트리니다드	tʰ ɯ ɾ i n i d a̠ d ɯ
가파르다	k a̠ pʰ a̠ ɾ ɯ d a̠
보급	p o̞ː ɡ ɯ p̚
인산인해	i n sʰ a̠ n i n ɦ e̞
알아차리다	a̠ ɾ a̠ t͡ɕʰ a̠ ɾ i d a̠
알케인	a̠ ɭ kʰ e̞ i n
케이블	kʰ e̞ i b ɯ ɭ
무사도	m u sʰ a̠ d o̞
문자반	m u n t͡ɕ͈ a̠ b a̠ n
허브티	h ʌ̹ b ɯ tʰ i
테크네튬	tʰ e̞ k x ɯ n e̞ tʰ j u m
떫다	t͈ ɘː ɭ t͈ a̠
구식	k uː ɕʰ i k̚
키로와트	k ç i ɾ o̞ w a̠ tʰ ɯ
동티모르	t o̞ ŋ tʰ i m o̞ ɾ ɯ
샅샅이	sʰ a̠ t̚ s͈ a̠ t͡ɕʰ i
기만하다	k i m a̠ n ɦ a̠ d a̠
덴마크어	t e̞ n m a̠ k x ɯ ʌ̹
발견하다	p a̠ ɭ ɡ j ʌ̹ n ɦ a̠ d a̠
상관	sʰ a̠ː ŋ ɡ w a̠ n
건강	k ɘː n ɡ a̠ ŋ
대북	t e̞ b u k̚
방탄	p a̠ ŋ tʰ a̠ n
객관적	k e̞ k̚ k͈ w a̠ n d͡ʑ ʌ̹ k̚
도검	t o̞ ɡ ʌ̹ m
마음성	m a̠ ɯ m s͈ ʌ̹ ŋ
신고하다	ɕʰ i n ɡ o̞ ɦ a̠ d a̠
수법	sʰ u b ʌ̹ p̚
신나다	ɕʰ i n n a̠ d a̠
얹다	ʌ̹ n t͈ a̠
증가하다	t͡ɕ ɯ ŋ ɡ a̠ ɦ a̠ d a̠
메시아	m e̞ ɕʰ i a̠
아론	a̠ ɾ o̞ n
임신	iː m ɕʰ i n
가로채다	k a̠ ɾ o̞ t͡ɕʰ e̞ d a̠
내주	n e̞ d͡ʑ u
가발	k a̠ b a̠ ɭ
평지	pʰ j ʌ̹ ŋ d͡ʑ i
공손	k o̞ ŋ sʰ o̞ n
검열	k ɘː m ɲ j ʌ̹ ɭ
새똥	sʰ e̞ː t͈ o̞ ŋ
악습	a̠ k s͈ ɯ p̚
예배	j e̞ b e̞
박해자	p a̠ kʰ e̞ d͡ʑ a̠
법칙	p ʌ̹ p̚ t͡ɕʰ i k̚
산장	sʰ a̠ n d͡ʑ a̠ ŋ
설인	sʰ ʌ̹ ɾ i n
병들다	p j ɘː ŋ d ɯ ɭ d a̠
돌아서다	t o̞ ɾ a̠ sʰ ʌ̹ d a̠
결코	k j ʌ̹ ɭ kʰ o̞
지휘자	t͡ɕ i ɦ ɥ i d͡ʑ a̠
밝혀지다	p a̠ ɭ k ç j ʌ̹ d͡ʑ i d a̠
가극	k a̠ ɡ ɯ k̚
트럼펫	tʰ ɯ ɾ ʌ̹ m pʰ e̞ t̚
설거지	sʰ ʌ̹ ɭ ɡ ʌ̹ d͡ʑ i
대리점	t e̞ː ɾ i d͡ʑ ʌ̹ m
경험치	k j ʌ̹ ŋ ɦ ʌ̹ m t͡ɕʰ i
정신적	t͡ɕ ʌ̹ ŋ ɕʰ i n d͡ʑ ʌ̹ k̚
포획하다	pʰ o̞ː β w e̞ kʰ a̠ d a̠
방송하다	p a̠ː ŋ sʰ o̞ ŋ ɦ a̠ d a̠
쌓이다	s͈ a̠ i d a̠
술어	sʰ u ɾ ʌ̹
어간	ɘː ɡ a̠ n
바다	p a̠ d a̠
구별	k u b j ʌ̹ ɭ
시위	ɕʰ iː ɥ i
각자	k a̠ k̚ t͡ɕ͈ a̠
쿠웨이트	kʰ u w e̞ i tʰ ɯ
바베이도스	p a̠ b e̞ i d o̞ sʰ ɯ
식민지	ɕʰ i ŋ m i n d͡ʑ i
뵈다	p w e̞ː d a̠
채식주의	t͡ɕʰ e̞ː ɕʰ i k̚ t͡ɕ͈ u ɰ i
명태	m j ʌ̹ ŋ tʰ e̞
대륙밭쥐	t e̞ː ɾ j u k̚ p͈ a̠ t̚ t͡ɕ͈ ɥ i
데모	t e̞ m o̞
배구	p e̞ ɡ u
불황	p u ɾ β w a̠ ŋ
아리	a̠ ɾ i
리모넨	ɾ i m o̞ n e̞ n
세륨	sʰ e̞ ɾ j u m
소변	sʰ o̞ b j ʌ̹ n
ㅈㅅ	t͡ɕ w e̞ sʰ o̞ ŋ
킹스턴	k ç i ŋ sʰ ɯ tʰ ʌ̹ n
실리다	ɕʰ i ɭ ʎ i d a̠
중국산개구리	t͡ɕ u ŋ ɡ u k s͈ a̠ n ɡ e̞ ɡ u ɾ i
사소하다	sʰ a̠ sʰ o̞ ɦ a̠ d a̠
놀이기구	n o̞ ɾ i ɡ i ɡ u
덥다	t ɘː p̚ t͈ a̠
더구나	t ʌ̹ ɡ u n a̠
운동량	uː n d o̞ ŋ ɲ j a̠ ŋ
하도	h a̠ d o̞
청해	t͡ɕʰ ʌ̹ ŋ ɦ e̞
저지르다	t͡ɕ ʌ̹ d͡ʑ i ɾ ɯ d a̠
맞다	m a̠ t̚ t͈ a̠
지시하다	t͡ɕ i ɕʰ i ɦ a̠ d a̠
말똥구리	m a̠ ɭ t͈ o̞ ŋ ɡ u ɾ i
방과후	p a̠ ŋ ɡ w a̠ β u
난자	n a̠ː n d͡ʑ a̠
멜번	m e̞ ɭ b ʌ̹ n
반사경	p a̠ n sʰ a̠ ɡ j ʌ̹ ŋ
황천	ɸ w a̠ ŋ t͡ɕʰ ʌ̹ n
에스토니아어	e̞ sʰ ɯ tʰ o̞ n i a̠ ʌ̹
떨다	t͈ ɘː ɭ d a̠
조사하다	t͡ɕ o̞ sʰ a̠ ɦ a̠ d a̠
백치	p e̞ k̚ t͡ɕʰ i
권력	k w ɘː ɭ ʎ j ʌ̹ k̚
트로피	tʰ ɯ ɾ o̞ pʰ i
지옥철	t͡ɕ i o̞ k̚ t͡ɕʰ ʌ̹ ɭ
주판	t͡ɕ uː pʰ a̠ n
깔다	k͈ a̠ ɭ d a̠
목화	m o̞ kʰ w a̠
철밥통	t͡ɕʰ ʌ̹ ɭ b a̠ p̚ tʰ o̞ ŋ
간판	k a̠ n pʰ a̠ n
아폴론	a̠ pʰ o̞ ɭ ɭ o̞ n
활발	ɸ w a̠ ɭ b a̠ ɭ
이글이글	i ɡ ɯ ɾ i ɡ ɯ ɭ
실시	ɕʰ i ɭ ɕ͈ i
파괴	pʰ a̠ː ɡ w e̞
라파스	ɾ a̠ pʰ a̠ sʰ ɯ
지경	t͡ɕ i ɡ j ʌ̹ ŋ
이상야릇하다	iː sʰ a̠ ŋ ɲ j a̠ ɾ ɯ tʰ a̠ d a̠
조수	t͡ɕ o̞ː sʰ u
스스로	sʰ ɯ sʰ ɯ ɾ o̞
영양물	j ʌ̹ ŋ j a̠ ŋ m u ɭ
우라누스	u ɾ a̠ n u sʰ ɯ
청소	t͡ɕʰ ʌ̹ ŋ sʰ o̞
반사	p a̠ː n sʰ a̠
음식	ɯː m ɕʰ i k̚
배워주다	p e̞ w ʌ̹ d͡ʑ u d a̠
생각되다	sʰ e̞ ŋ ɡ a̠ k̚ t͈ w e̞ d a̠
경멸적	k j ʌ̹ ŋ m j ʌ̹ ɭ t͡ɕ͈ ʌ̹ k̚
여든	j ʌ̹ d ɯ n
멀찌감치	m ʌ̹ ɭ t͡ɕ͈ i ɡ a̠ m t͡ɕʰ i
억울하다	ʌ̹ ɡ u ɾ ɦ a̠ d a̠
우먼	u m ʌ̹ n
할라페뇨	h a̠ ɭ ɭ a̠ pʰ e̞ ɲ j o
레슬링	ɾ e̞ sʰ ɯ ɭ ʎ i ŋ
차이	t͡ɕʰ a̠ i
저렇다	t͡ɕ ʌ̹ ɾ ʌ̹ tʰ a̠
옷장	o̞ t̚ t͡ɕ͈ a̠ ŋ
상하이	sʰ a̠ ŋ ɦ a̠ i
오토바이	o̞ tʰ o̞ b a̠ i
내내	n e̞ː n e̞
헐다	h ɘː ɭ d a̠
과부	k w a̠ː b u
귀국	k ɥ iː ɡ u k̚
성병	sʰ ɘː ŋ p͈ j ʌ̹ ŋ
샐러리맨	s͈ e̞ ɭ ɭ ʌ̹ ɾ i m e̞ n
분수령	p u n sʰ u ɾ j ʌ̹ ŋ
앰뷸런스	e̞ m b j u ɭ ɭ ʌ̹ n sʰ ɯ
고유	k o̞ j u
외로	w e̞ ɾ o̞
간지	k a̠ n d͡ʑ i
소학교	sʰ o̞ ɦ a̠ k̚ k͈ j o
자료	t͡ɕ a̠ ɾ j o
수량	sʰ uː ɾ j a̠ ŋ
신사	ɕʰ iː n sʰ a̠
달콤하다	t a̠ ɭ kʰ o̞ m ɦ a̠ d a̠
은유	ɯ ɲ j u
비판	p iː pʰ a̠ n
이틀	i tʰ ɯ ɭ
백과전서	p e̞ k̚ k͈ w a̠ d͡ʑ ʌ̹ n sʰ ʌ̹
묵주	m u k̚ t͡ɕ͈ u
개리	k e̞ ɾ i
작동	t͡ɕ a̠ k̚ t͈ o̞ ŋ
그만두다	k ɯ m a̠ n d u d a̠
지속적	t͡ɕ i sʰ o̞ k̚ t͡ɕ͈ ʌ̹ k̚
스타벅스	sʰ ɯ tʰ a̠ b ʌ̹ k s͈ ɯ
조건	t͡ɕ o̞ k͈ ʌ̹ n
옴스크	o̞ m sʰ ɯ k x ɯ
쇼핑하다	ɕʰ j o pʰ i ŋ ɦ a̠ d a̠
황복	ɸ w a̠ ŋ b o̞ k̚
피해	pʰ iː ɦ e̞
양말	j a̠ ŋ m a̠ ɭ
스트레스	sʰ ɯ tʰ ɯ ɾ e̞ s͈ ɯ
요구되다	j o ɡ u d w e̞ d a̠
전체주의	t͡ɕ ʌ̹ n t͡ɕʰ e̞ d͡ʑ u ɰ i
청설모	t͡ɕʰ ʌ̹ ŋ sʰ ʌ̹ ɭ m o̞
마땅하다	m a̠ t͈ a̠ ŋ ɦ a̠ d a̠
인터넷	i n tʰ ʌ̹ n e̞ t̚
소화기	sʰ o̞ β w a̠ ɡ i
벗겨지다	p ʌ̹ t̚ k͈ j ʌ̹ d͡ʑ i d a̠
잊어버리다	i d͡ʑ ʌ̹ b ʌ̹ ɾ i d a̠
내몽골	n e̞ m o̞ ŋ ɡ o̞ ɭ
추석	t͡ɕʰ u sʰ ʌ̹ k̚
휴지통	ç j u d͡ʑ i tʰ o̞ ŋ
광대	k w a̠ː ŋ d e̞
헷갈리다	h e̞ t̚ k͈ a̠ ɭ ʎ i d a̠
뒷다리	t ɥ i t̚ t͈ a̠ ɾ i
강서	k a̠ ŋ sʰ ʌ̹
전등	t͡ɕ ɘː n d ɯ ŋ
모충	m o̞ t͡ɕʰ u ŋ
출석하다	t͡ɕʰ u ɭ sʰ ʌ̹ kʰ a̠ d a̠
급기야	k ɯ p̚ k͈ i j a̠
시장하다	ɕʰ i d͡ʑ a̠ ŋ ɦ a̠ d a̠
루사카	ɾ u sʰ a̠ kʰ a̠
백련어	p e̞ ŋ ɲ j ʌ̹ n ʌ̹
신발	ɕʰ i n b a̠ ɭ
볼트	p o̞ ɭ tʰ ɯ
진정하다	t͡ɕ i n d͡ʑ ʌ̹ ŋ ɦ a̠ d a̠
술래잡기	sʰ u ɭ ɭ e̞ d͡ʑ a̠ p̚ k͈ i
카불	kʰ a̠ b u ɭ
파산하다	pʰ a̠ː sʰ a̠ n ɦ a̠ d a̠
화음	ɸ w a̠ ɯ m
바로	p a̠ ɾ o̞
장군석	t͡ɕ a̠ ŋ ɡ u n sʰ ʌ̹ k̚
소농	sʰ o̞ː n o̞ ŋ
학공치	h a̠ k̚ k͈ o̞ ŋ t͡ɕʰ i
모나코	m o̞ n a̠ kʰ o̞
배아	p e̞ a̠
몹시	m o̞ː p ɕ͈ i
출산율	t͡ɕʰ u ɭ sʰ a̠ ɲ j u ɭ
알킨	a̠ ɭ k ç i n
병기고	p j ʌ̹ ŋ ɡ i ɡ o̞
지피다	t͡ɕ i pʰ i d a̠
파행	pʰ a̠ ɦ e̞ ŋ
촬영	t͡ɕʰ w a̠ ɾ j ʌ̹ ŋ
전리품	t͡ɕ ɘː ɭ ʎ i pʰ u m
문지방	m u n d͡ʑ i b a̠ ŋ
기도매듭	k i d o̞ m e̞ d ɯ p̚
무디다	m u d i d a̠
위반	ɥ i b a̠ n
인터뷰	i n tʰ ʌ̹ b j u
긴날개박쥐	k i n n a̠ ɭ ɡ e̞ b a̠ k̚ t͡ɕ͈ ɥ i
대책	t e̞ː t͡ɕʰ e̞ k̚
부스러기	p u sʰ ɯ ɾ ʌ̹ ɡ i
만큼	m a̠ n k x ɯ m
신어	ɕʰ i n ʌ̹
상관하다	sʰ a̠ ŋ ɡ w a̠ n ɦ a̠ d a̠
가렵다	k a̠ ɾ j ʌ̹ p̚ t͈ a̠
백파이프	p e̞ k̚ pʰ a̠ i pʰ ɯ
기원	k i w ʌ̹ n
평화롭다	pʰ j ʌ̹ ŋ β w a̠ ɾ o̞ p̚ t͈ a̠
차라리	t͡ɕʰ a̠ ɾ a̠ ɾ i
묘미	m j oː m i
헛간	h ʌ̹ t̚ k͈ a̠ n
가솔린	k a̠ sʰ o̞ ɭ ʎ i n
레스토랑	ɾ e̞ sʰ ɯ tʰ o̞ ɾ a̠ ŋ
려행	ɾ j ʌ̹ ɦ e̞ ŋ
까치돌고래	k͈ a̠ t͡ɕʰ i d o̞ ɭ ɡ o̞ ɾ e̞
수영	sʰ u j ʌ̹ ŋ
민병	m i n b j ʌ̹ ŋ
인형	i n ʝ j ʌ̹ ŋ
분류	p u ɭ ʎ j u
복무하다	p o̞ ŋ m u ɦ a̠ d a̠
꺽저기	k͈ ʌ̹ k̚ t͡ɕ͈ ʌ̹ ɡ i
태산	tʰ e̞ sʰ a̠ n
살살하다	sʰ a̠ː ɭ sʰ a̠ ɾ ɦ a̠ d a̠
점몰개	t͡ɕ ʌ̹ m m o̞ ɭ ɡ e̞
서반아	sʰ ʌ̹ b a̠ n a̠
만들어지다	m a̠ n d ɯ ɾ ʌ̹ d͡ʑ i d a̠
아련히	a̠ ɾ j ʌ̹ n ʝ i
동등하다	t o̞ ŋ d ɯ ŋ ɦ a̠ d a̠
백인	p e̞ ɡ i n
조용히	t͡ɕ o̞ j o ŋ ʝ i
핫스팟	h a̠ t̚ s͈ ɯ pʰ a̠ t̚
가만두다	k a̠ m a̠ n d u d a̠
절다	t͡ɕ ɘː ɭ d a̠
방해	p a̠ ŋ ɦ e̞
규정	k j u d͡ʑ ʌ̹ ŋ
굽히다	k u pʰ i d a̠
기모노	k i m o̞ n o̞
감숙	k a̠ m sʰ u k̚
금년	k ɯ m ɲ j ʌ̹ n
제물	t͡ɕ e̞ m u ɭ
고기후학	k o̞ ɡ i β u ɦ a̠ k̚
얼룩동사리	ʌ̹ ɭ ɭ u k̚ t͈ o̞ ŋ sʰ a̠ ɾ i
마장	m a̠ d͡ʑ a̠ ŋ
내려가다	n e̞ ɾ j ʌ̹ ɡ a̠ d a̠
점프	t͡ɕ ʌ̹ m pʰ ɯ
희생자	ç i sʰ e̞ ŋ d͡ʑ a̠
샹차이	ɕʰ j a̠ ŋ t͡ɕʰ a̠ i
풍령	pʰ u ŋ ɲ j ʌ̹ ŋ
일반인	i ɭ b a̠ n i n
어둠	ʌ̹ d u m
물건	m u ɭ ɡ ʌ̹ n
결석하다	k j ʌ̹ ɭ s͈ ʌ̹ kʰ a̠ d a̠
누르다	n uː ɾ ɯ d a̠
벌매	p ʌ̹ ɭ m e̞
한참	h a̠ n t͡ɕʰ a̠ m
타워	tʰ a̠ w ʌ̹
이점	iː d͡ʑ ʌ̹ m
마크	m a̠ k x ɯ
계절	k j e̞ː d͡ʑ ʌ̹ ɭ
오른쪽	o̞ ɾ ɯ n t͡ɕ͈ o̞ k̚
캄보디아	kʰ a̠ m b o̞ d i a̠
사건	sʰ a̠ː k͈ ʌ̹ n
교구	k j o ɡ u
청회색	t͡ɕʰ ʌ̹ ŋ β w e̞ sʰ e̞ k̚
몰개	m o̞ ɭ ɡ e̞
새홀리기	sʰ e̞ β o̞ ɭ ʎ i ɡ i
지명학	t͡ɕ i m j ʌ̹ ŋ ɦ a̠ k̚
코발트	kʰ o̞ b a̠ ɭ tʰ ɯ
곧은창자	k o̞ d ɯ n t͡ɕʰ a̠ ŋ d͡ʑ a̠
느낌표	n ɯ k͈ i m pʰ j o
신중하다	ɕʰ iː n d͡ʑ u ŋ ɦ a̠ d a̠
이야기하다	i j a̠ ɡ i ɦ a̠ d a̠
기여하다	k i j ʌ̹ ɦ a̠ d a̠
증명	t͡ɕ ɯ ŋ m j ʌ̹ ŋ
모자이크	m o̞ d͡ʑ a̠ i k x ɯ
주유소	t͡ɕ uː j u sʰ o̞
따뜻하다	t͈ a̠ t͈ ɯ tʰ a̠ d a̠
노르다	n o̞ ɾ ɯ d a̠
전압	t͡ɕ ɘː n a̠ p̚
블로그	p ɯ ɭ ɭ o̞ ɡ ɯ
표고	pʰ j o ɡ o̞
나비	n a̠ b i
정겹다	t͡ɕ ʌ̹ ŋ ɡ j ʌ̹ p̚ t͈ a̠
자백	t͡ɕ a̠ b e̞ k̚
차별	t͡ɕʰ a̠ b j ʌ̹ ɭ
의심	ɰ i ɕʰ i m
붙잡다	p u t̚ t͡ɕ͈ a̠ p̚ t͈ a̠
범성애	p ɘː m sʰ ʌ̹ ŋ e̞
유감	j u ɡ a̠ m
기둥	k i d u ŋ
한턱내다	h a̠ n tʰ ʌ̹ ŋ n e̞ d a̠
자식	t͡ɕ a̠ ɕʰ i k̚
문화적	m u n β w a̠ d͡ʑ ʌ̹ k̚
요금	j oː ɡ ɯ m
세계평화	sʰ e̞ ɡ j e̞ pʰ j ʌ̹ ŋ β w a̠
성찬	sʰ ʌ̹ ŋ t͡ɕʰ a̠ n
꺼내다	k͈ ɘː n e̞ d a̠
예전	j e̞ː d͡ʑ ʌ̹ n
영양	j ʌ̹ ŋ j a̠ ŋ
시베리아	ɕʰ i b e̞ ɾ i a̠
마법	m a̠ b ʌ̹ p̚
들소	t ɯː ɭ s͈ o̞
아침	a̠ t͡ɕʰ i m
춥다	t͡ɕʰ u p̚ t͈ a̠
잉어	iː ŋ ʌ̹
맥주	m e̞ k̚ t͡ɕ͈ u
흰자위	ç i n d͡ʑ a̠ ɥ i
근데	k ɯ n d e̞
연구하다	j ɘː n ɡ u ɦ a̠ d a̠
꼭대기	k͈ o̞ k̚ t͈ e̞ ɡ i
마취	m a̠ t͡ɕʰ ɥ i
경찰견	k j ɘː ŋ t͡ɕʰ a̠ ɭ ɡ j ʌ̹ n
주말	t͡ɕ u m a̠ ɭ
음성	ɯ m sʰ ʌ̹ ŋ
선로	sʰ ʌ̹ ɭ ɭ o̞
인텔리겐치아	i n tʰ e̞ ɭ ʎ i ɡ e̞ n t͡ɕʰ i a̠
제보	t͡ɕ e̞ b o̞
도금	t o̞ː ɡ ɯ m
돌고기	t o̞ ɭ ɡ o̞ ɡ i
조산부	t͡ɕ o̞ː sʰ a̠ n b u
요정	j o d͡ʑ ʌ̹ ŋ
오염되다	o̞ː j ʌ̹ m d w e̞ d a̠
사망	sʰ a̠ː m a̠ ŋ
암만	a̠ m m a̠ n
살인	sʰ a̠ ɾ i n
커닝하다	kʰ ʌ̹ n i ŋ ɦ a̠ d a̠
남아프리카공화국	n a̠ m a̠ pʰ ɯ ɾ i kʰ a̠ ɡ o̞ ŋ β w a̠ ɡ u k̚
중성자	t͡ɕ u ŋ sʰ ʌ̹ ŋ d͡ʑ a̠
백조	p e̞ k̚ t͡ɕ͈ o̞
경상남도	k j ɘː ŋ sʰ a̠ ŋ n a̠ m d o̞
오븐	o̞ b ɯ n
성대	sʰ ʌ̹ ŋ d e̞
얼음과자	ʌ̹ ɾ ɯ m ɡ w a̠ d͡ʑ a̠
러브호텔	ɾ ʌ̹ b ɯ β o̞ tʰ e̞ ɭ
강정	k a̠ ŋ d͡ʑ ʌ̹ ŋ
보수주의	p o̞ sʰ u d͡ʑ u ɰ i
치읓	t͡ɕʰ i ɯ t̚
불안하다	p u ɾ a̠ n ɦ a̠ d a̠
돌보다	t o̞ː ɭ b o̞ d a̠
범위	p ɘː m ɥ i
거즈	k ʌ̹ d͡ʑ ɯ
참되다	t͡ɕʰ a̠ m t͈ w e̞ d a̠
염병	j ɘː m b j ʌ̹ ŋ
라마	ɾ a̠ m a̠
성욕	sʰ ʌ̹ ŋ j o k̚
평면	pʰ j ʌ̹ ŋ m j ʌ̹ n
식전	ɕʰ i k̚ t͡ɕ͈ ʌ̹ n
걸치다	k ɘː ɭ t͡ɕʰ i d a̠
기후학	k i β u ɦ a̠ k̚
퀴즈	kʰ ɥ i d͡ʑ ɯ
채찍	t͡ɕʰ e̞ t͡ɕ͈ i k̚
집들	t͡ɕ i p̚ t͈ ɯ ɭ
창자	t͡ɕʰ a̠ ŋ d͡ʑ a̠
발바리차	p a̠ː ɭ b a̠ ɾ i t͡ɕʰ a̠
재미있다	t͡ɕ e̞ m i i t̚ t͈ a̠
닉네임	n i ŋ n e̞ i m
솔깃하다	sʰ o̞ ɭ ɡ i tʰ a̠ d a̠
흑자	x ɯ k̚ t͡ɕ͈ a̠
복숭아	p o̞ k s͈ u ŋ a̠
결론	k j ʌ̹ ɭ ɭ o̞ n
비치다	p i t͡ɕʰ i d a̠
금융	k ɯ m ɲ j u ŋ
이발사	iː b a̠ ɭ sʰ a̠
이러다	i ɾ ʌ̹ d a̠
코코넛	kʰ o̞ kʰ o̞ n ʌ̹ t̚
기만되다	k i m a̠ n d w e̞ d a̠
신화	ɕʰ i n β w a̠
생도	sʰ e̞ ŋ d o̞
장르	t͡ɕ a̠ ŋ n ɯ
슬라브	sʰ ɯ ɭ ɭ a̠ b ɯ
청천	t͡ɕʰ ʌ̹ ŋ t͡ɕʰ ʌ̹ n
노동법	n o̞ d o̞ ŋ p͈ ʌ̹ p̚
품질	pʰ uː m d͡ʑ i ɭ
마귀	m a̠ ɡ ɥ i
공업	k o̞ ŋ ʌ̹ p̚
풍부하다	pʰ u ŋ b u ɦ a̠ d a̠
가르치다	k a̠ ɾ ɯ t͡ɕʰ i d a̠
미용실	m iː j o ŋ ɕʰ i ɭ
루마니아	ɾ u m a̠ n i a̠
마름	m a̠ ɾ ɯ m
없이	ɘː p ɕ͈ i
큰머리돌고래	k x ɯ n m ʌ̹ ɾ i d o̞ ɭ ɡ o̞ ɾ e̞
외화	w e̞ː β w a̠
마시다	m a̠ ɕʰ i d a̠
잔돈	t͡ɕ a̠ n d o̞ n
감사하다	k a̠ː m sʰ a̠ ɦ a̠ d a̠
장정	t͡ɕ a̠ ŋ d͡ʑ ʌ̹ ŋ
여학생	j ʌ̹ ɦ a̠ k s͈ e̞ ŋ
색동다리	sʰ e̞ k̚ t͈ o̞ ŋ d a̠ ɾ i
케이프타운	kʰ e̞ i pʰ ɯ tʰ a̠ u n
맞선	m a̠ t̚ s͈ ʌ̹ n
미남	m iː n a̠ m
들판	t ɯː ɭ pʰ a̠ n
양모	j a̠ ŋ m o̞
복리	p o̞ ŋ n i
미래학	m iː ɾ e̞ ɦ a̠ k̚
새해	sʰ e̞ ɦ e̞
연속극	j ʌ̹ n sʰ o̞ k̚ k͈ ɯ k̚
실현하다	ɕʰ i ɾ ʝ j ʌ̹ n ɦ a̠ d a̠
글래머	k ɯ ɭ ɭ e̞ m ʌ̹
리모컨	ɾ i m o̞ kʰ ʌ̹ n
압도	a̠ p̚ t͈ o̞
스파이	sʰ ɯ pʰ a̠ i
무자맥질하다	m u d͡ʑ a̠ m e̞ k̚ t͡ɕ͈ i ɾ ɦ a̠ d a̠
듯싶다	t ɯ t̚ ɕ͈ i p̚ t͈ a̠
대농갱이	t e̞ n o̞ ŋ ɡ e̞ ŋ i
중공	t͡ɕ u ŋ ɡ o̞ ŋ
점프하다	t͡ɕ ʌ̹ m pʰ ɯ ɦ a̠ d a̠
밀가루	m i ɭ k͈ a̠ ɾ u
루블	ɾ u b ɯ ɭ
생물화학	sʰ e̞ ŋ m u ɾ β w a̠ ɦ a̠ k̚
튤립	tʰ j u ɭ ʎ i p̚
아라비아	a̠ ɾ a̠ b i a̠
자폐증	t͡ɕ a̠ pʰ j e̞ t͡ɕ͈ ɯ ŋ
상형	sʰ a̠ ŋ ʝ j ʌ̹ ŋ
컴맹	kʰ ʌ̹ m m e̞ ŋ
임대	iː m d e̞
금지	k ɯː m d͡ʑ i
그루지야어	k ɯ ɾ u d͡ʑ i j a̠ ʌ̹
멥쌀	m e̞ p s͈ a̠ ɭ
눈동자	n u n d o̞ ŋ d͡ʑ a̠
배꼽	p e̞ k͈ o̞ p̚
교만	k j o m a̠ n
패션	pʰ e̞ ɕʰ j ʌ̹ n
연세	j ʌ̹ n sʰ e̞
다크서클	t a̠ k x ɯ s͈ ʌ̹ k x ɯ ɭ
김멜	k i m m e̞ ɭ
카디건	kʰ a̠ d i ɡ ʌ̹ n
부탄	p u tʰ a̠ n
아나콘다	a̠ n a̠ kʰ o̞ n d a̠
입양	i b j a̠ ŋ
스푸트니크	sʰ ɯ pʰ u tʰ ɯ n i k x ɯ
명동	m j ʌ̹ ŋ d o̞ ŋ
붉은배새매	p u ɭ ɡ ɯ n b e̞ sʰ e̞ m e̞
변절	p j ɘː n d͡ʑ ʌ̹ ɭ
시리아	ɕʰ i ɾ i a̠
여관	j ʌ̹ ɡ w a̠ n
유죄	j uː d͡ʑ w e̞
미팅	m i tʰ i ŋ
밀크	m i ɭ k x ɯ
양상	j a̠ ŋ sʰ a̠ ŋ
속옷	sʰ o̞ː ɡ o̞ t̚
보리	p o̞ ɾ i
마드라스	m a̠ d ɯ ɾ a̠ sʰ ɯ
문지르다	m u n d͡ʑ i ɾ ɯ d a̠
고조되다	k o̞ d͡ʑ o̞ d w e̞ d a̠
타협하다	tʰ a̠ː ʝ j ʌ̹ pʰ a̠ d a̠
신시대	ɕʰ i n ɕʰ i d e̞
멈추다	m ʌ̹ m t͡ɕʰ u d a̠
예언	j e̞ː ʌ̹ n
커피	kʰ ʌ̹ pʰ i
약어	j a̠ ɡ ʌ̹
가나	k a̠ n a̠
마구	m a̠ ɡ u
크리스천	k x ɯ ɾ i sʰ ɯ t͡ɕʰ ʌ̹ n
허리띠	h ʌ̹ ɾ i t͈ i
강화도	k a̠ ŋ β w a̠ d o̞
거미	k ʌ̹ m i
헤로인	h e̞ ɾ o̞ i n
지정되다	t͡ɕ i d͡ʑ ʌ̹ ŋ d w e̞ d a̠
느냐	n ɯ ɲ j a̠
휴대전화	ç j u d e̞ d͡ʑ ʌ̹ n β w a̠
날짐승	n a̠ ɭ t͡ɕ͈ i m sʰ ɯ ŋ
뚜렷하다	t͈ u ɾ j ʌ̹ tʰ a̠ d a̠
피시	pʰ i ɕ͈ i
검은색	k ɘː m ɯ n sʰ e̞ k̚
타락	tʰ a̠ː ɾ a̠ k̚
보석	p o̞ː sʰ ʌ̹ k̚
드라마	t ɯ ɾ a̠ m a̠
나무늘보	n a̠ m u n ɯ ɭ b o̞
외심	w e̞ː ɕʰ i m
회음부	ɸ w e̞ː ɯ m b u
북숲쥐	p u k s͈ u p̚ t͡ɕ͈ ɥ i
반바지	p a̠ː n b a̠ d͡ʑ i
앙카라	a̠ ŋ kʰ a̠ ɾ a̠
클리토리스	k x ɯ ɭ ʎ i tʰ o̞ ɾ i sʰ ɯ
올리브	o̞ ɭ ʎ i b ɯ
체리	t͡ɕʰ e̞ ɾ i
개인적	k e̞ː i n d͡ʑ ʌ̹ k̚
타타르어	tʰ a̠ tʰ a̠ ɾ ɯ ʌ̹
비둘기	p i d u ɭ ɡ i
나이피다우	n a̠ i pʰ i d a̠ u
말하기	m a̠ː ɾ ɦ a̠ ɡ i
기수사	k i sʰ u sʰ a̠
기다리다	k i d a̠ ɾ i d a̠
월드컵	w ʌ̹ ɭ d ɯ kʰ ʌ̹ p̚
종합	t͡ɕ o̞ ŋ ɦ a̠ p̚
반시옷	p a̠ n ɕʰ i o̞ t̚
캐비어	kʰ e̞ b i ʌ̹
발생하다	p a̠ ɭ sʰ e̞ ŋ ɦ a̠ d a̠
빠지다	p͈ a̠ː d͡ʑ i d a̠
생박쥐	sʰ e̞ ŋ b a̠ k̚ t͡ɕ͈ ɥ i
습지	sʰ ɯ p̚ t͡ɕ͈ i
폭파	pʰ o̞ k̚ pʰ a̠
콜라보	kʰ o̞ ɭ ɭ a̠ b o̞
프랑스	pʰ ɯ ɾ a̠ ŋ sʰ ɯ
돌격	t o̞ ɭ ɡ j ʌ̹ k̚
더욱이	t ʌ̹ u ɡ i
용이	j o ŋ i
원고	w ʌ̹ n ɡ o̞
백로	p e̞ ŋ n o̞
졸업식	t͡ɕ o̞ ɾ ʌ̹ p ɕ͈ i k̚
무자맥질	m u d͡ʑ a̠ m e̞ k̚ t͡ɕ͈ i ɭ
우편함	u pʰ j ʌ̹ n ɦ a̠ m
하고	h a̠ ɡ o̞
인격	i n k͈ j ʌ̹ k̚
학생	h a̠ k s͈ e̞ ŋ
노랫말	n o̞ ɾ e̞ n m a̠ ɭ
놀라다	n o̞ː ɭ ɭ a̠ d a̠
삼겹살	sʰ a̠ m ɡ j ʌ̹ p s͈ a̠ ɭ
역시	j ʌ̹ k ɕ͈ i
음향	ɯ m ʝ j a̠ ŋ
두음	t u ɯ m
국가	k u k̚ k͈ a̠
부사	p u sʰ a̠
플러그인	pʰ ɯ ɭ ɭ ʌ̹ ɡ ɯ i n
개선하다	k e̞ː sʰ ʌ̹ n ɦ a̠ d a̠
아디스아바바	a̠ d i sʰ ɯ a̠ b a̠ b a̠
성폭행	sʰ ɘː ŋ pʰ o̞ kʰ e̞ ŋ
자격	t͡ɕ a̠ ɡ j ʌ̹ k̚
윗수염박쥐	ɥ i t̚ s͈ u j ʌ̹ m b a̠ k̚ t͡ɕ͈ ɥ i
프탈레인	pʰ ɯ tʰ a̠ ɭ ɭ e̞ i n
예니레	j e̞ n i ɾ e̞
브로민	p ɯ ɾ o̞ m i n
북극	p u k̚ k͈ ɯ k̚
관문	k w a̠ n m u n
애드웨어	e̞ d ɯ w e̞ ʌ̹
행군	h e̞ ŋ ɡ u n
힘주다	ç i m d͡ʑ u d a̠
이레	i ɾ e̞
특유	tʰ ɯ ɡ j u
호랑이	ɸʷ o̞ː ɾ a̠ ŋ i
모래상자	m o̞ ɾ e̞ sʰ a̠ ŋ d͡ʑ a̠
그루터기	k ɯ ɾ u tʰ ʌ̹ ɡ i
통근하다	tʰ o̞ ŋ ɡ ɯ n ɦ a̠ d a̠
연구원	j ɘː n ɡ u w ʌ̹ n
철도역	t͡ɕʰ ʌ̹ ɭ t͈ o̞ j ʌ̹ k̚
부딪히다	p u d i t͡ɕʰ i d a̠
어깨	ʌ̹ k͈ e̞
예배당	j e̞ b e̞ d a̠ ŋ
벤졸	p e̞ n d͡ʑ o̞ ɭ
널뛰기	n ʌ̹ ɭ t͈ ɥ i ɡ i
카나	kʰ a̠ n a̠
변절자	p j ɘː n d͡ʑ ʌ̹ ɭ d͡ʑ a̠
화장실	ɸ w a̠ d͡ʑ a̠ ŋ ɕʰ i ɭ
열여섯	j ʌ̹ ɭ ʎ j ʌ̹ sʰ ʌ̹ t̚
안타나나리보	a̠ n tʰ a̠ n a̠ n a̠ ɾ i b o̞
존중하다	t͡ɕ o̞ n d͡ʑ u ŋ ɦ a̠ d a̠
해묵다	h e̞ m u k̚ t͈ a̠
무어	m u ʌ̹
구체	k u t͡ɕʰ e̞
굴묵낭	k u ɭ m u ŋ n a̠ ŋ
루시	ɾ u ɕʰ i
손바닥	sʰ o̞ n p͈ a̠ d a̠ k̚
코소보	kʰ o̞ sʰ o̞ b o̞
급격하다	k ɯ p̚ k͈ j ʌ̹ kʰ a̠ d a̠
똥남아	t͈ o̞ ŋ n a̠ m a̠
건널목	k ɘː n n ʌ̹ ɭ m o̞ k̚
원곡	w ʌ̹ n ɡ o̞ k̚
계약	k j e̞ j a̠ k̚
중부	t͡ɕ u ŋ b u
출연	t͡ɕʰ u ɾ j ʌ̹ n
버터	p ʌ̹ tʰ ʌ̹
귀고리	k ɥ i ɡ o̞ ɾ i
빈곤	p i n ɡ o̞ n
남포	n a̠ m pʰ o̞
오르되브르	o̞ ɾ ɯ d w e̞ b ɯ ɾ ɯ
고조선	k o̞ d͡ʑ o̞ sʰ ʌ̹ n
떡붕어	t͈ ʌ̹ k̚ p͈ u ŋ ʌ̹
토오쿄	tʰ o̞ o̞ k ç j o
분위기	p u n ɥ i ɡ i
흔적	x ɯ n d͡ʑ ʌ̹ k̚
팬케이크	pʰ e̞ n kʰ e̞ i k x ɯ
오렌지윗수염박쥐	o̞ ɾ e̞ n d͡ʑ i ɥ i t̚ s͈ u j ʌ̹ m b a̠ k̚ t͡ɕ͈ ɥ i
탈영병	tʰ a̠ ɾ j ʌ̹ ŋ b j ʌ̹ ŋ
윈난	ɥ i n n a̠ n
민달팽이	m i n d a̠ ɭ pʰ e̞ ŋ i
외교	w e̞ː ɡ j o
날아가다	n a̠ ɾ a̠ ɡ a̠ d a̠
아악	a̠ː a̠ k̚
바다제비	p a̠ d a̠ d͡ʑ e̞ b i
차원	t͡ɕʰ a̠ w ʌ̹ n
머금다	m ʌ̹ ɡ ɯ m d a̠
트랙타	tʰ ɯ ɾ e̞ k̚ tʰ a̠
꿈꾸다	k͈ u m k͈ u d a̠
때늦다	t͈ e̞ n ɯ t̚ t͈ a̠
손목	sʰ o̞ n m o̞ k̚
당밀	t a̠ ŋ m i ɭ
상점	sʰ a̠ ŋ d͡ʑ ʌ̹ m
일광욕	i ɭ ɡ w a̠ ŋ j o k̚
희한히	ç i ɦ a̠ n ʝ i
모음	m o̞ ɯ m
돌멩이	t o̞ː ɭ m e̞ ŋ i
의향	ɰ iː ʝ j a̠ ŋ
말리다	m a̠ ɭ ʎ i d a̠
상식	sʰ a̠ ŋ ɕʰ i k̚
설계	sʰ ʌ̹ ɭ ɡ j e̞
카타르	kʰ a̠ tʰ a̠ ɾ ɯ
조랑말	t͡ɕ o̞ ɾ a̠ ŋ m a̠ ɭ
부리고래	p u ɾ i ɡ o̞ ɾ e̞
프탈라진	pʰ ɯ tʰ a̠ ɭ ɭ a̠ d͡ʑ i n
크바스	k x ɯ b a̠ sʰ ɯ
악티늄	a̠ k̚ tʰ i ɲ j u m
동사	t o̞ ŋ sʰ a̠
은행	ɯ n ɦ e̞ ŋ
이스마엘	i sʰ ɯ m a̠ e̞ ɭ
드렁허리	t ɯ ɾ ʌ̹ ŋ ɦ ʌ̹ ɾ i
업신여기다	ɘː p ɕ͈ i n ɲ j ʌ̹ ɡ i d a̠
간헐천	k a̠ː n ɦ ʌ̹ ɭ t͡ɕʰ ʌ̹ n
쓸데	s͈ ɯ ɭ t͈ e̞
벵골어	p e̞ ŋ ɡ o̞ ɾ ʌ̹
죄악	t͡ɕ w e̞ː a̠ k̚
뛰어가다	t͈ ɥ i ʌ̹ ɡ a̠ d a̠
젓가락질하다	t͡ɕ ʌ̹ t̚ k͈ a̠ ɾ a̠ k̚ t͡ɕ͈ i ɾ ɦ a̠ d a̠
그중	k ɯ d͡ʑ u ŋ
상상력	sʰ a̠ː ŋ sʰ a̠ ŋ ɲ j ʌ̹ k̚
늙은이	n ɯ ɭ ɡ ɯ n i
아무르산개구리	a̠ m u ɾ ɯ sʰ a̠ n ɡ e̞ ɡ u ɾ i
도플갱어	t o̞ pʰ ɯ ɭ ɡ e̞ ŋ ʌ̹
상사병	sʰ a̠ ŋ sʰ a̠ p͈ j ʌ̹ ŋ
적용	t͡ɕ ʌ̹ ɡ j o ŋ
엉뚱하다	ʌ̹ ŋ t͈ u ŋ ɦ a̠ d a̠
글라스노스트	k ɯ ɭ ɭ a̠ sʰ ɯ n o̞ sʰ ɯ tʰ ɯ
덕트	t ʌ̹ k̚ tʰ ɯ
닭쌈	t a̠ k s͈ a̠ m
콜라	kʰ o̞ ɭ ɭ a̠
일치하다	i ɭ t͡ɕʰ i ɦ a̠ d a̠
나빠지다	n a̠ p͈ a̠ d͡ʑ i d a̠
나나니	n a̠ n a̠ n i
지니다	t͡ɕ i n i d a̠
쇠재두루미	sʰ w e̞ d͡ʑ e̞ d u ɾ u m i
바나나	p͈ a̠ n a̠ n a̠
긍정적	k ɯː ŋ d͡ʑ ʌ̹ ŋ d͡ʑ ʌ̹ k̚
보신탕	p o̞ː ɕʰ i n tʰ a̠ ŋ
기술	k i sʰ u ɭ
준비	t͡ɕ uː n b i
도입	t o̞ː i p̚
헤어지다	h e̞ ʌ̹ d͡ʑ i d a̠
임실납자루	i m ɕʰ i ɭ ɭ a̠ p̚ t͡ɕ͈ a̠ ɾ u
강세	k a̠ ŋ sʰ e̞
채소	t͡ɕʰ e̞ː sʰ o̞
다락	t a̠ ɾ a̠ k̚
편람	pʰ j ʌ̹ ɭ ɭ a̠ m
일원	i ɾ w ʌ̹ n
암소	a̠ m sʰ o̞
의료	ɰ i ɾ j o
칠하다	t͡ɕʰ i ɾ ɦ a̠ d a̠
십날	ɕʰ i m n a̠ ɭ
지지	t͡ɕ i d͡ʑ i
제사	t͡ɕ e̞ː sʰ a̠
쇠가마우지	sʰ w e̞ ɡ a̠ m a̠ u d͡ʑ i
중매	t͡ɕ u ŋ m e̞
앞장서다	a̠ p̚ t͡ɕ͈ a̠ ŋ sʰ ʌ̹ d a̠
거듭	k ʌ̹ d ɯ p̚
디자이너	t i d͡ʑ a̠ i n ʌ̹
흑두루미	x ɯ k̚ t͈ u ɾ u m i
귀밑	k ɥ i m i t̚
멍청이	m ʌ̹ ŋ t͡ɕʰ ʌ̹ ŋ i
침묵하다	t͡ɕʰ i m m u kʰ a̠ d a̠
장시	t͡ɕ a̠ ŋ ɕʰ i
기록하다	k i ɾ o̞ kʰ a̠ d a̠
임마누엘	i m m a̠ n u e̞ ɭ
하플로그룹	h a̠ pʰ ɯ ɭ ɭ o̞ ɡ ɯ ɾ u p̚
네피도	n e̞ pʰ i d o̞
갑분싸	k a̠ p̚ p͈ u n s͈ a̠
다툼	t a̠ tʰ u m
오염	o̞ː j ʌ̹ m
안주애기박쥐	a̠ n d͡ʑ u e̞ ɡ i b a̠ k̚ t͡ɕ͈ ɥ i
열일곱	j ʌ̹ ɭ ʎ i ɭ ɡ o̞ p̚
제안	t͡ɕ e̞ a̠ n
도로	t o̞ː ɾ o̞
표면	pʰ j o m j ʌ̹ n
가죽	k a̠ d͡ʑ u k̚
열쇠	j ɘː ɭ s͈ w e̞
의욕	ɰ iː j o k̚
그늘지다	k ɯ n ɯ ɭ d͡ʑ i d a̠
시간	ɕʰ i ɡ a̠ n
싶다	ɕʰ i p̚ t͈ a̠
플루오르	pʰ ɯ ɭ ɭ u o̞ ɾ ɯ
백악기	p e̞ ɡ a̠ k̚ k͈ i
요괴	j o ɡ w e̞
둑중개	t u k̚ t͡ɕ͈ u ŋ ɡ e̞
피난처	pʰ iː n a̠ n t͡ɕʰ ʌ̹
특기	tʰ ɯ k̚ k͈ i
여진	j ʌ̹ d͡ʑ i n
식물	ɕʰ i ŋ m u ɭ
소설	sʰ o̞ː sʰ ʌ̹ ɭ
파시스트	pʰ a̠ ɕʰ i sʰ ɯ tʰ ɯ
바이오폴리머	p a̠ i o̞ pʰ o̞ ɭ ʎ i m ʌ̹
공언하다	k o̞ ŋ ʌ̹ n ɦ a̠ d a̠
수납장	sʰ u n a̠ p̚ t͡ɕ͈ a̠ ŋ
가없이	k a̠ː ʌ̹ p ɕ͈ i
전쟁	t͡ɕ ɘː n d͡ʑ e̞ ŋ
스페이드	sʰ ɯ pʰ e̞ i d ɯ
싸다	s͈ a̠ d a̠
근로자	k ɯ ɭ ɭ o̞ d͡ʑ a̠
근육	k ɯ ɲ j u k̚
이엉	i ʌ̹ ŋ
청동	t͡ɕʰ ʌ̹ ŋ d o̞ ŋ
구굴무치	k u ɡ u ɭ m u t͡ɕʰ i
토끼	tʰ o̞ k͈ i
수심	sʰ u ɕʰ i m
연예인	j ɘː ɲ j e̞ i n
달아나다	t a̠ ɾ a̠ n a̠ d a̠
대한제국	t e̞ː ɦ a̠ n d͡ʑ e̞ ɡ u k̚
우체통	u t͡ɕʰ e̞ tʰ o̞ ŋ
가이아나	k a̠ i a̠ n a̠
슈퍼스타	ɕʰ j u pʰ ʌ̹ sʰ ɯ tʰ a̠
미끈망둑	m i k͈ ɯ n m a̠ ŋ d u k̚
규모	k j u m o̞
북방토끼	p u k̚ p͈ a̠ ŋ tʰ o̞ k͈ i
허리	h ʌ̹ ɾ i
녹두나물	n o̞ k̚ t͈ u n a̠ m u ɭ
선교	sʰ ʌ̹ n ɡ j o
기본	k i b o̞ n
블룸폰테인	p ɯ ɭ ɭ u m pʰ o̞ n tʰ e̞ i n
끽반하다	k͈ i k̚ p͈ a̠ n ɦ a̠ d a̠
무당	m u d a̠ ŋ
밤참	p a̠ m t͡ɕʰ a̠ m
두건	t u ɡ ʌ̹ n
랜턴	ɾ e̞ n tʰ ʌ̹ n
힘내다	ç i m n e̞ d a̠
전학	t͡ɕ ɘː n ɦ a̠ k̚
암말	a̠ m m a̠ ɭ
감기	k a̠ː m ɡ i
니카라과	n i kʰ a̠ ɾ a̠ ɡ w a̠
수첩	sʰ u t͡ɕʰ ʌ̹ p̚
박다	p a̠ k̚ t͈ a̠
유난히	j uː n a̠ n ʝ i
소좌	sʰ o̞ː d͡ʑ w a̠
아스파라거스	a̠ sʰ ɯ pʰ a̠ ɾ a̠ ɡ ʌ̹ sʰ ɯ
에리트레아	e̞ ɾ i tʰ ɯ ɾ e̞ a̠
령도자	ɾ j ʌ̹ ŋ d o̞ d͡ʑ a̠
중반	t͡ɕ u ŋ b a̠ n
이어폰	i ʌ̹ pʰ o̞ n
흩어지다	x ɯ tʰ ʌ̹ d͡ʑ i d a̠
기온	k i o̞ n
원앙사촌	w ʌ̹ n a̠ ŋ sʰ a̠ t͡ɕʰ o̞ n
하늘	h a̠ n ɯ ɭ
숟가락	sʰ u t̚ k͈ a̠ ɾ a̠ k̚
망원경	m a̠ː ŋ w ʌ̹ n ɡ j ʌ̹ ŋ
자연환경	t͡ɕ a̠ j ʌ̹ n β w a̠ n ɡ j ʌ̹ ŋ
독재	t o̞ k̚ t͡ɕ͈ e̞
논다니	n o̞ː n d a̠ n i
홑이불	ɸʷ o̞ n n i b u ɭ
지역	t͡ɕ i j ʌ̹ k̚
새미	sʰ e̞ m i
부수	p uː sʰ u
빨간색	p͈ a̠ ɭ ɡ a̠ n sʰ e̞ k̚
으스름하다	ɯ sʰ ɯ ɾ ɯ m ɦ a̠ d a̠
의복	ɰ i b o̞ k̚
괴로움	k w e̞ ɾ o̞ u m
공개	k o̞ ŋ ɡ e̞
시설	ɕʰ iː sʰ ʌ̹ ɭ
하늘나라	h a̠ n ɯ ɭ ɭ a̠ ɾ a̠
중요하다	t͡ɕ uː ŋ j o ɦ a̠ d a̠
헌법	h ɘː n p͈ ʌ̹ p̚
아첨하다	a̠ t͡ɕʰ ʌ̹ m ɦ a̠ d a̠
가위	k a̠ ɥ i
여보	j ʌ̹ b o̞
여신	j ʌ̹ ɕʰ i n
적당	t͡ɕ ʌ̹ k̚ t͈ a̠ ŋ
충칭	t͡ɕʰ u ŋ t͡ɕʰ i ŋ
길거리	k i ɭ k͈ ʌ̹ ɾ i
사업	sʰ a̠ː ʌ̹ p̚
낱말	n a̠ː n m a̠ ɭ
유르트	j u ɾ ɯ tʰ ɯ
기생	k iː sʰ e̞ ŋ
유량	j u ɾ j a̠ ŋ
탐관오리	tʰ a̠ m ɡ w a̠ n o̞ ɾ i
필자	pʰ i ɭ t͡ɕ͈ a̠
혼란	ɸʷ o̞ː ɭ ɭ a̠ n
체첸어	t͡ɕʰ e̞ t͡ɕʰ e̞ n ʌ̹
득템	t ɯ k̚ tʰ e̞ m
조선어	t͡ɕ o̞ sʰ ʌ̹ n ʌ̹
브라자빌	p ɯ ɾ a̠ d͡ʑ a̠ b i ɭ
간균	k a̠ n ɡ j u n
그래	k ɯ ɾ e̞
악당	a̠ k̚ t͈ a̠ ŋ
어찌하다	ʌ̹ t͡ɕ͈ i ɦ a̠ d a̠
젖꼭지	t͡ɕ ʌ̹ t̚ k͈ o̞ k̚ t͡ɕ͈ i
난각	n a̠ː n ɡ a̠ k̚
글라스	k ɯ ɭ ɭ a̠ sʰ ɯ
어부	ʌ̹ b u
유충	j u t͡ɕʰ u ŋ
산맥	sʰ a̠ n m e̞ k̚
밸브	p e̞ ɭ b ɯ
고발	k o̞ː b a̠ ɭ
시동생	ɕʰ i d o̞ ŋ sʰ e̞ ŋ
물체	m u ɭ t͡ɕʰ e̞
대천사	t e̞ː t͡ɕʰ ʌ̹ n sʰ a̠
흔하다	x ɯ n ɦ a̠ d a̠
재잘거리다	t͡ɕ e̞ d͡ʑ a̠ ɭ ɡ ʌ̹ ɾ i d a̠
비잔티움	p i d͡ʑ a̠ n tʰ i u m
권하다	k w ɘː n ɦ a̠ d a̠
이목구비	i m o̞ k̚ k͈ u b i
어휘소	ʌ̹ ɦ ɥ i sʰ o̞
연골	j ɘː n ɡ o̞ ɭ
성채	sʰ ʌ̹ ŋ t͡ɕʰ e̞
베트남어	p e̞ tʰ ɯ n a̠ m ʌ̹
모조리	m o̞ d͡ʑ o̞ ɾ i
휴가	ç j u ɡ a̠
위안부	ɥ i a̠ n b u
관계자	k w a̠ n ɡ j e̞ d͡ʑ a̠
뼈대	p͈ j ʌ̹ d e̞
초원수리	t͡ɕʰ o̞ w ʌ̹ n sʰ u ɾ i
주고받다	t͡ɕ u ɡ o̞ b a̠ t̚ t͈ a̠
학설	h a̠ k s͈ ʌ̹ ɭ
신문	ɕʰ i n m u n
부지깽이	p u d͡ʑ i k͈ e̞ ŋ i
중화	t͡ɕ u ŋ β w a̠
애국자	e̞ː ɡ u k̚ t͡ɕ͈ a̠
홀스터	ɸʷ o̞ ɭ sʰ ɯ tʰ ʌ̹
잔가시고기	t͡ɕ a̠ n ɡ a̠ ɕʰ i ɡ o̞ ɡ i
솟다	sʰ o̞ t̚ t͈ a̠
살치	sʰ a̠ ɭ t͡ɕʰ i
통사리	tʰ o̞ ŋ sʰ a̠ ɾ i
당구	t a̠ ŋ ɡ u
여쭈다	j ɘː t͡ɕ͈ u d a̠
독신	t o̞ k ɕ͈ i n
시집보내다	ɕʰ i d͡ʑ i p̚ p͈ o̞ n e̞ d a̠
그리다	k ɯː ɾ i d a̠
설정	sʰ ʌ̹ ɭ t͡ɕ͈ ʌ̹ ŋ
그린란드	k ɯ ɾ i n n a̠ n d ɯ
버터밀크	p ʌ̹ tʰ ʌ̹ m i ɭ k x ɯ
혈장	ç j ʌ̹ ɭ d͡ʑ a̠ ŋ
시럽	ɕʰ i ɾ ʌ̹ p̚
거류	k ʌ̹ ɾ j u
미녀	m iː ɲ j ʌ̹
접두사	t͡ɕ ʌ̹ p̚ t͈ u sʰ a̠
끽연	k͈ i ɡ j ʌ̹ n
커닝	kʰ ʌ̹ n i ŋ
은연어	ɯ n ɲ j ʌ̹ n ʌ̹
현관	ç j ʌ̹ n ɡ w a̠ n
사타구니	sʰ a̠ tʰ a̠ ɡ u n i
푸젠	pʰ u d͡ʑ e̞ n
용지	j o ŋ d͡ʑ i
순박	sʰ u n b a̠ k̚
타다	tʰ a̠ d a̠
교차위	k j o t͡ɕʰ a̠ ɥ i
도망	t o̞ m a̠ ŋ
끓이다	k͈ ɯː ɾ i d a̠
기숙사	k i sʰ u k s͈ a̠
탄탈럼	tʰ a̠ n tʰ a̠ ɭ ɭ ʌ̹ m
마약	m a̠ j a̠ k̚
양면	j a̠ ŋ m j ʌ̹ n
개꿩	k e̞ː k͈ w ʌ̹ ŋ
청년	t͡ɕʰ ʌ̹ ŋ ɲ j ʌ̹ n
항로	h a̠ː ŋ n o̞
검은딸기	k ʌ̹ m ɯ n t͈ a̠ ɭ ɡ i
요르단	j o ɾ ɯ d a̠ n
자전	t͡ɕ a̠ d͡ʑ ʌ̹ n
네팔	n e̞ pʰ a̠ ɭ
희망하다	ç i m a̠ ŋ ɦ a̠ d a̠
강조하다	k a̠ ŋ d͡ʑ o̞ ɦ a̠ d a̠
세뇌	sʰ e̞ n w e̞
자동화	t͡ɕ a̠ d o̞ ŋ β w a̠
회장	ɸ w e̞ː d͡ʑ a̠ ŋ
희롱하다	ç i ɾ o̞ ŋ ɦ a̠ d a̠
장미	t͡ɕ a̠ ŋ m i
태어나다	tʰ e̞ ʌ̹ n a̠ d a̠
프테리딘	pʰ ɯ tʰ e̞ ɾ i d i n
알코올	a̠ ɭ kʰ o̞ o̞ ɭ
해골	h e̞ ɡ o̞ ɭ
아리랑	a̠ ɾ i ɾ a̠ ŋ
소맥	s͈ o̞ m e̞ k̚
소방차	sʰ o̞ b a̠ ŋ t͡ɕʰ a̠
노인학	n o̞ i n ɦ a̠ k̚
속마음	sʰ o̞ː ŋ m a̠ ɯ m
편종	pʰ j ʌ̹ n d͡ʑ o̞ ŋ
저마늄	t͡ɕ ʌ̹ m a̠ ɲ j u m
고양이	k o̞ j a̠ ŋ i
찐만두	t͡ɕ͈ i n m a̠ n d u
머핀	m ʌ̹ pʰ i n
트로이카	tʰ ɯ ɾ o̞ i kʰ a̠
약주	j a̠ k̚ t͡ɕ͈ u
기시감	k i ɕʰ i ɡ a̠ m
보라색	p o̞ ɾ a̠ sʰ e̞ k̚
다섯째	t a̠ sʰ ʌ̹ t̚ t͡ɕ͈ e̞
수표	sʰ u pʰ j o
약속	j a̠ k s͈ o̞ k̚
특히	tʰ ɯ k ç i
회랑	ɸ w e̞ ɾ a̠ ŋ
의지하다	ɰ i d͡ʑ i ɦ a̠ d a̠
기민하다	k i m i n ɦ a̠ d a̠
헬스	h e̞ ɭ sʰ ɯ
남자답다	n a̠ m d͡ʑ a̠ d a̠ p̚ t͈ a̠
폭넓다	pʰ o̞ ŋ n ʌ̹ ɭ t͈ a̠
합의	h a̠ b ɰ i
경상도	k j ʌ̹ ŋ sʰ a̠ ŋ d o̞
쇠뒤쥐	sʰ w e̞ d ɥ i d͡ʑ ɥ i
경영	k j ʌ̹ ŋ j ʌ̹ ŋ
함께	h a̠ m k͈ e̞
헌병	h ɘː n b j ʌ̹ ŋ
입력	i m ɲ j ʌ̹ k̚
구슬	k u sʰ ɯ ɭ
갈색얼가니새	k a̠ ɭ sʰ e̞ ɡ ʌ̹ ɭ ɡ a̠ n i sʰ e̞
외인	w e̞ː i n
북동	p u k̚ t͈ o̞ ŋ
된장	t w e̞ː n d͡ʑ a̠ ŋ
어휘	ɘː ɦ ɥ i
아니요	a̠ n i j o
싫다	ɕʰ i ɭ tʰ a̠
국제보조어	k uː k̚ t͡ɕ͈ e̞ b o̞ d͡ʑ o̞ ʌ̹
눈빛	n u n p͈ i t̚
홍송어	ɸʷ o̞ ŋ sʰ o̞ ŋ ʌ̹
흰줄박이오리	ç i n d͡ʑ u ɭ b a̠ ɡ i o̞ ɾ i
페르샤어	pʰ e̞ ɾ ɯ ɕʰ j a̠ ʌ̹
진심	t͡ɕ i n ɕʰ i m
파업	pʰ a̠ː ʌ̹ p̚
기차	k i t͡ɕʰ a̠
달걀	t a̠ ɭ ɡ j a̠ ɭ
비린내	p i ɾ i n n e̞
비구니	p iː ɡ u n i
열여덟째	j ʌ̹ ɭ ʎ j ʌ̹ d ʌ̹ ɭ t͡ɕ͈ e̞
대충	t e̞ː t͡ɕʰ u ŋ
권리	k w ʌ̹ ɭ ʎ i
루테늄	ɾ u tʰ e̞ ɲ j u m
누렇다	n uː ɾ ʌ̹ tʰ a̠
아랍	a̠ ɾ a̠ p̚
보리고래	p o̞ ɾ i ɡ o̞ ɾ e̞
아휴	a̠ ʝ j u
유니코드	j u n i kʰ o̞ d ɯ
곡조	k o̞ k̚ t͡ɕ͈ o̞
즐겁다	t͡ɕ ɯ ɭ ɡ ʌ̹ p̚ t͈ a̠
브로치	p ɯ ɾ o̞ t͡ɕʰ i
건너가다	k ɘː n n ʌ̹ ɡ a̠ d a̠
처녀막	t͡ɕʰ ɘː ɲ j ʌ̹ m a̠ k̚
저널리스트	t͡ɕ ʌ̹ n ʌ̹ ɭ ʎ i sʰ ɯ tʰ ɯ
타지키스탄	tʰ a̠ d͡ʑ i k ç i sʰ ɯ tʰ a̠ n
쇼비니즘	ɕʰ j o b i n i d͡ʑ ɯ m
기호	k i β o̞
볼일	p o̞ ɾ i ɭ
지하실	t͡ɕ i ɦ a̠ ɕʰ i ɭ
분석	p u n sʰ ʌ̹ k̚
검둥오리사촌	k ʌ̹ m d u ŋ o̞ ɾ i sʰ a̠ t͡ɕʰ o̞ n
방심	p a̠ ŋ ɕʰ i m
벤또	p e̞ n t͈ o̞
사탕	sʰ a̠ tʰ a̠ ŋ
폐기종	pʰ j e̞ː ɡ i d͡ʑ o̞ ŋ
무제한	m u d͡ʑ e̞ ɦ a̠ n
포화	pʰ o̞ː β w a̠
화제	ɸ w a̠ d͡ʑ e̞
신라	ɕʰ i ɭ ɭ a̠
폴로늄	pʰ o̞ ɭ ɭ o̞ ɲ j u m
지구의	t͡ɕ i ɡ u ɰ i
불가능하다	p u ɭ ɡ a̠ n ɯ ŋ ɦ a̠ d a̠
어둡다	ʌ̹ d u p̚ t͈ a̠
사과하다	sʰ a̠ː ɡ w a̠ ɦ a̠ d a̠
오룔	o̞ ɾ j o ɭ
모래	m o̞ ɾ e̞
무료	m u ɾ j o
황태후	ɸ w a̠ ŋ tʰ e̞ β u
중고기	t͡ɕ uː ŋ ɡ o̞ ɡ i
집오리	t͡ɕ i b o̞ ɾ i
화요일	ɸ w a̠ j o i ɭ
부러뜨리다	p u ɾ ʌ̹ t͈ ɯ ɾ i d a̠
자칫하면	t͡ɕ a̠ t͡ɕʰ i tʰ a̠ m j ʌ̹ n
놔두다	n w a̠ d u d a̠
겨를	k j ʌ̹ ɾ ɯ ɭ
둘러보다	t u ɭ ɭ ʌ̹ b o̞ d a̠
큰부리고래	k x ɯ n b u ɾ i ɡ o̞ ɾ e̞
크기	k x ɯ ɡ i
힌디어	ç i n d i ʌ̹
엘살바도르	e̞ ɭ sʰ a̠ ɭ b a̠ d o̞ ɾ ɯ
설산	sʰ ʌ̹ ɭ s͈ a̠ n
스테아르산	sʰ ɯ tʰ e̞ a̠ ɾ ɯ sʰ a̠ n
흐느끼다	x ɯ n ɯ k͈ i d a̠
초롱초롱	t͡ɕʰ o̞ ɾ o̞ ŋ t͡ɕʰ o̞ ɾ o̞ ŋ
루테튬	ɾ u tʰ e̞ tʰ j u m
녹음	n o̞ ɡ ɯ m
륙십	ɾ j u k ɕ͈ i p̚
병사	p j ʌ̹ ŋ sʰ a̠
현상	ç j ɘː n sʰ a̠ ŋ
석류	sʰ ʌ̹ ŋ ɲ j u
잉글랜드	i ŋ ɡ ɯ ɭ ɭ e̞ n d ɯ
뜨리다	t͈ ɯ ɾ i d a̠
델리	t e̞ ɭ ʎ i
고산	k o̞ sʰ a̠ n
연애	j ɘː n e̞
티오펜	tʰ i o̞ pʰ e̞ n
알다	a̠ː ɭ d a̠
아내	a̠ n e̞
귀절	k ɥ i d͡ʑ ʌ̹ ɭ
무늬망둑	m u n i m a̠ ŋ d u k̚
빅토리아	p i k̚ tʰ o̞ ɾ i a̠
정육점	t͡ɕ ʌ̹ ŋ j u k̚ t͡ɕ͈ ʌ̹ m
서호납줄갱이	sʰ ʌ̹ β o̞ n a̠ p̚ t͡ɕ͈ u ɭ ɡ e̞ ŋ i
우유	u j u
들꿩	t ɯ ɭ k͈ w ʌ̹ ŋ
반경	p a̠ː n ɡ j ʌ̹ ŋ
연애편지	j ɘː n e̞ pʰ j ʌ̹ n d͡ʑ i
의하다	ɰ i ɦ a̠ d a̠
물어뜯다	m u ɾ ʌ̹ t͈ ɯ t̚ t͈ a̠
숙박	sʰ u k̚ p͈ a̠ k̚
독신자	t o̞ k ɕ͈ i n d͡ʑ a̠
감미료	k a̠ m m i ɾ j o
순수하다	sʰ u n sʰ u ɦ a̠ d a̠
낭비	n a̠ː ŋ b i
새끼	sʰ e̞ k͈ i
둘러싸다	t u ɭ ɭ ʌ̹ s͈ a̠ d a̠
젖다	t͡ɕ ʌ̹ t̚ t͈ a̠
오르간	o̞ ɾ ɯ ɡ a̠ n
작작	t͡ɕ a̠ k̚ t͡ɕ͈ a̠ k̚
싸움터	s͈ a̠ u m tʰ ʌ̹
극장	k ɯ k̚ t͡ɕ͈ a̠ ŋ
밴댕이	p e̞ n d e̞ ŋ i
류음	ɾ j u ɯ m
큰가시고기	k x ɯ n ɡ a̠ ɕʰ i ɡ o̞ ɡ i
고질병	k o̞ d͡ʑ i ɭ p͈ j ʌ̹ ŋ
맡다	m a̠ t̚ t͈ a̠
왕실	w a̠ ŋ ɕʰ i ɭ
가제	k a̠ d͡ʑ e̞
모든	m o̞ː d ɯ n
원장	w ʌ̹ n d͡ʑ a̠ ŋ
먹이그물	m ʌ̹ ɡ i ɡ ɯ m u ɭ
평생	pʰ j ʌ̹ ŋ sʰ e̞ ŋ
큰고니	k x ɯ n ɡ o̞ n i
방접원	p a̠ ŋ d͡ʑ ʌ̹ b w ʌ̹ n
두만가시고기	t u m a̠ n ɡ a̠ ɕʰ i ɡ o̞ ɡ i
경죄	k j ʌ̹ ŋ d͡ʑ w e̞
연안	j ʌ̹ n a̠ n
사랑스럽다	sʰ a̠ ɾ a̠ ŋ sʰ ɯ ɾ ʌ̹ p̚ t͈ a̠
대사	t e̞ː sʰ a̠
소시지	sʰ o̞ ɕʰ i d͡ʑ i
반란	p a̠ː ɭ ɭ a̠ n
나중	n a̠ː d͡ʑ u ŋ
공인	k o̞ ŋ i n
요오드	j o o̞ d ɯ
엄격하다	ʌ̹ m k͈ j ʌ̹ kʰ a̠ d a̠
랭장고	ɾ e̞ː ŋ d͡ʑ a̠ ŋ ɡ o̞
주다	t͡ɕ u d a̠
지배하다	t͡ɕ i b e̞ ɦ a̠ d a̠
중백로	t͡ɕ u ŋ b e̞ ŋ n o̞
콤플렉스	kʰ o̞ m pʰ ɯ ɭ ɭ e̞ k s͈ ɯ
눈사태	n uː n sʰ a̠ tʰ e̞
국자	k u k̚ t͡ɕ͈ a̠
역사가	j ʌ̹ k s͈ a̠ ɡ a̠
증권사	t͡ɕ ɯ ŋ k͈ w ʌ̹ n sʰ a̠
난시	n a̠ː n ɕʰ i
페샤와르	pʰ e̞ ɕʰ j a̠ w a̠ ɾ ɯ
언문	ɘː n m u n
맞서다	m a̠ t̚ s͈ ʌ̹ d a̠
방명	p a̠ ŋ m j ʌ̹ ŋ
반침	p a̠ n t͡ɕʰ i m
침팬지	t͡ɕʰ i m pʰ e̞ n d͡ʑ i
살피다	sʰ a̠ ɭ pʰ i d a̠
주민	t͡ɕ uː m i n
이랑	i ɾ a̠ ŋ
월세	w ʌ̹ ɭ s͈ e̞
거의	k ʌ̹ ɰ i
수필	sʰ u pʰ i ɭ
갈수록	k a̠ ɭ s͈ u ɾ o̞ k̚
데이터베이스	t e̞ i tʰ ʌ̹ b e̞ i sʰ ɯ
으르다	ɯ ɾ ɯ d a̠
흰넓적다리붉은쥐	ç i n n ʌ̹ p̚ t͡ɕ͈ ʌ̹ k̚ t͈ a̠ ɾ i b u ɭ ɡ ɯ n d͡ʑ ɥ i
대문	t e̞ː m u n
공해	k o̞ ŋ ɦ e̞
안녕히	a̠ n ɲ j ʌ̹ ŋ ʝ i
휴일	ç j u i ɭ
피로	pʰ i ɾ o̞
목격자	m o̞ k̚ k͈ j ʌ̹ k̚ t͡ɕ͈ a̠
밀어	m i ɾ ʌ̹
천진	t͡ɕʰ ʌ̹ n d͡ʑ i n
만남	m a̠ n n a̠ m
경구	k j ɘː ŋ ɡ u
태우다	tʰ e̞ u d a̠
사철	sʰ a̠ t͡ɕʰ ʌ̹ ɭ
받침	p a̠ t̚ t͡ɕʰ i m
데리다	t e̞ ɾ i d a̠
좀구굴치	t͡ɕ o̞ m ɡ u ɡ u ɭ t͡ɕʰ i
레늄	ɾ e̞ ɲ j u m
옥중	o̞ k̚ t͡ɕ͈ u ŋ
수력	sʰ u ɾ j ʌ̹ k̚
육서	j u k s͈ ʌ̹
녹음기	n o̞ ɡ ɯ m ɡ i
광역시	k w a̠ː ŋ j ʌ̹ k ɕ͈ i
위증	ɥ i d͡ʑ ɯ ŋ
을게	ɯ ɭ k͈ e̞
란제리	ɾ a̠ n d͡ʑ e̞ ɾ i
드시다	t ɯ ɕʰ i d a̠
어디여	ʌ̹ d i j ʌ̹
체육관	t͡ɕʰ e̞ j u k̚ k͈ w a̠ n
목표	m o̞ k̚ pʰ j o
뱉다	p e̞ː t̚ t͈ a̠
현자	ç j ʌ̹ n d͡ʑ a̠
금성	k ɯ m sʰ ʌ̹ ŋ
줍다	t͡ɕ uː p̚ t͈ a̠
오징어	o̞ d͡ʑ i ŋ ʌ̹
다소	t a̠ sʰ o̞
등피	t ɯ ŋ pʰ i
연구소	j ʌ̹ n ɡ u sʰ o̞
뮤지컬	m j u d͡ʑ i kʰ ʌ̹ ɭ
보통	p o̞ː tʰ o̞ ŋ
온통	o̞ː n tʰ o̞ ŋ
덴푸라	t e̞ n pʰ u ɾ a̠
비웃다	p iː u t̚ t͈ a̠
리터	ɾ i tʰ ʌ̹
행진	h e̞ ŋ d͡ʑ i n
꾸르륵꾸르륵	k͈ u ɾ ɯ ɾ ɯ k̚ k͈ u ɾ ɯ ɾ ɯ k̚
음바바네	ɯ m b a̠ b a̠ n e̞
편경	pʰ j ʌ̹ n ɡ j ʌ̹ ŋ
외할아버지	w e̞ ɦ a̠ ɾ a̠ b ʌ̹ d͡ʑ i
브라이드고래	p ɯ ɾ a̠ i d ɯ ɡ o̞ ɾ e̞
스튜디오	s͈ ɯ tʰ j u d i o̞
다카	t a̠ kʰ a̠
붉은발슴새	p u ɭ ɡ ɯ n b a̠ ɭ sʰ ɯ m sʰ e̞
감로	k a̠ m n o̞
사생팬	sʰ a̠ sʰ e̞ ŋ pʰ e̞ n
까까	k͈ a̠ k͈ a̠
프랑스어	pʰ ɯ ɾ a̠ ŋ sʰ ɯ ʌ̹
삼다	sʰ a̠ː m t͈ a̠
경어	k j ɘː ŋ ʌ̹
해병	h e̞ː b j ʌ̹ ŋ
보호하다	p o̞ː β o̞ ɦ a̠ d a̠
의성어	ɰ i sʰ ʌ̹ ŋ ʌ̹
놀다	n o̞ː ɭ d a̠
남동생	n a̠ m d o̞ ŋ sʰ e̞ ŋ
약실	j a̠ k ɕ͈ i ɭ
인식	i n ɕʰ i k̚
의미론	ɰ iː m i ɾ o̞ n
백금	p e̞ k̚ k͈ ɯ m
브라더	p ɯ ɾ a̠ d ʌ̹
기상학	k i sʰ a̠ ŋ ɦ a̠ k̚
멍에	m ʌ̹ ŋ e̞
일어	i ɾ ʌ̹
갈기	k a̠ː ɭ ɡ i
인장	i n d͡ʑ a̠ ŋ
대합실	t e̞ː ɦ a̠ p ɕ͈ i ɭ
항원	h a̠ ŋ w ʌ̹ n
흐릿하다	x ɯ ɾ i tʰ a̠ d a̠
삼인칭	sʰ a̠ m i n t͡ɕʰ i ŋ
지식	t͡ɕ i ɕʰ i k̚
어덩이	ʌ̹ d ʌ̹ ŋ i
벨기에	p e̞ ɭ ɡ i e̞
이두	iː d u
차리다	t͡ɕʰ a̠ ɾ i d a̠
왕태자	w a̠ ŋ tʰ e̞ d͡ʑ a̠
폭동	pʰ o̞ k̚ t͈ o̞ ŋ
인터페이스	i n tʰ ʌ̹ pʰ e̞ i sʰ ɯ
뉴욕	ɲ j u j o k̚
화장장	ɸ w a̠ː d͡ʑ a̠ ŋ d͡ʑ a̠ ŋ
식량	ɕʰ i ŋ ɲ j a̠ ŋ
믹서	m i k s͈ ʌ̹
여러	j ʌ̹ ɾ ʌ̹
부젓가락	p u d͡ʑ ʌ̹ t̚ k͈ a̠ ɾ a̠ k̚
남서부	n a̠ m sʰ ʌ̹ b u
초록빛	t͡ɕʰ o̞ ɾ o̞ k̚ p͈ i t̚
오래	o̞ ɾ e̞
구매하다	k u m e̞ ɦ a̠ d a̠
습니다	s͈ ɯ m n i d a̠
성조	sʰ ʌ̹ ŋ d͡ʑ o̞
우리말	u ɾ i m a̠ ɭ
어떤	ʌ̹ t͈ ʌ̹ n
덮밥	t ʌ̹ p̚ p͈ a̠ p̚
수산기	sʰ u sʰ a̠ n ɡ i
사라예보	sʰ a̠ ɾ a̠ j e̞ b o̞
스캔들	sʰ ɯ kʰ e̞ n d ɯ ɭ
크레파스	k x ɯ ɾ e̞ pʰ a̠ sʰ ɯ
군만두	k uː n m a̠ n d u
종아리	t͡ɕ o̞ː ŋ a̠ ɾ i
남미	n a̠ m m i
텔레타이프	tʰ e̞ ɭ ɭ e̞ tʰ a̠ i pʰ ɯ
도끼	t o̞ k͈ i
욕조	j o k̚ t͡ɕ͈ o̞
혼돈하다	ɸʷ o̞ n d o̞ n ɦ a̠ d a̠
반칙	p a̠ː n t͡ɕʰ i k̚
갈비뼈	k a̠ ɭ b i p͈ j ʌ̹
넓적다리	n ʌ̹ p̚ t͡ɕ͈ ʌ̹ k̚ t͈ a̠ ɾ i
관련성	k w a̠ ɭ ʎ j ʌ̹ n s͈ ʌ̹ ŋ
지나치다	t͡ɕ i n a̠ t͡ɕʰ i d a̠
개인숭배	k e̞ː i n sʰ u ŋ b e̞
면적	m j ɘː n d͡ʑ ʌ̹ k̚
찡그리다	t͡ɕ͈ i ŋ ɡ ɯ ɾ i d a̠
카페테리아	kʰ a̠ pʰ e̞ tʰ e̞ ɾ i a̠
력사	ɾ j ʌ̹ k s͈ a̠
직위	t͡ɕ i ɡ ɥ i
금속	k ɯ m sʰ o̞ k̚
지랄하다	t͡ɕ i ɾ a̠ ɾ ɦ a̠ d a̠
유월	j u w ʌ̹ ɭ
정원	t͡ɕ ʌ̹ ŋ w ʌ̹ n
모스코븀	m o̞ sʰ ɯ kʰ o̞ b j u m
오렌지	o̞ ɾ e̞ n d͡ʑ i
유행병	j u ɦ e̞ ŋ b j ʌ̹ ŋ
군관	k u n ɡ w a̠ n
이슬람	i sʰ ɯ ɭ ɭ a̠ m
만화	m a̠ː n β w a̠
저쪽	t͡ɕ ʌ̹ t͡ɕ͈ o̞ k̚
피라졸	pʰ i ɾ a̠ d͡ʑ o̞ ɭ
숨기다	sʰ u m ɡ i d a̠
발음하다	p a̠ ɾ ɯ m ɦ a̠ d a̠
초점	t͡ɕʰ o̞ t͡ɕ͈ ʌ̹ m
약국	j a̠ k̚ k͈ u k̚
오직	o̞ d͡ʑ i k̚
숫자	sʰ uː t̚ t͡ɕ͈ a̠
정상치	t͡ɕ ɘː ŋ sʰ a̠ ŋ t͡ɕʰ i
만주	m a̠ n d͡ʑ u
노랗다	n o̞ː ɾ a̠ tʰ a̠
백내장	p e̞ ŋ n e̞ d͡ʑ a̠ ŋ
구류	k u ɾ j u
놋쇠	n o̞ t̚ s͈ w e̞
멸종	m j ʌ̹ ɭ t͡ɕ͈ o̞ ŋ
동그라미	t o̞ ŋ ɡ ɯ ɾ a̠ m i
스테이플러	sʰ ɯ tʰ e̞ i pʰ ɯ ɭ ɭ ʌ̹
다이어트	t a̠ i ʌ̹ tʰ ɯ
가련히	k a̠ ɾ j ʌ̹ n ʝ i
최상급	t͡ɕʰ w e̞ː sʰ a̠ ŋ ɡ ɯ p̚
도깨비	t o̞ k͈ e̞ b i
덮이다	t ʌ̹ pʰ i d a̠
기능	k i n ɯ ŋ
미니스커트	m i n i sʰ ɯ kʰ ʌ̹ tʰ ɯ
에르븀	e̞ ɾ ɯ b j u m
마스카라	m a̠ sʰ ɯ kʰ a̠ ɾ a̠
야구장	j a̠ː ɡ u d͡ʑ a̠ ŋ
망하다	m a̠ ŋ ɦ a̠ d a̠
모두	m o̞ d u
발끝	p a̠ ɭ k͈ ɯ t̚
기망	k i m a̠ ŋ
등장하다	t ɯ ŋ d͡ʑ a̠ ŋ ɦ a̠ d a̠
항생제	h a̠ː ŋ sʰ e̞ ŋ d͡ʑ e̞
짚다	t͡ɕ i p̚ t͈ a̠
간직하다	k a̠ n d͡ʑ i kʰ a̠ d a̠
온도계	o̞ n d o̞ ɡ j e̞
은하단	ɯ n ɦ a̠ d a̠ n
관리	k w a̠ ɭ ʎ i
아가씨	a̠ ɡ a̠ ɕ͈ i
학부모	h a̠ k̚ p͈ u m o̞
가내공업	k a̠ n e̞ ɡ o̞ ŋ ʌ̹ p̚
얌차	j a̠ m t͡ɕʰ a̠
편리하다	pʰ j ʌ̹ ɭ ʎ i ɦ a̠ d a̠
조이다	t͡ɕ o̞ i d a̠
불법	p u ɭ b ʌ̹ p̚
서표	sʰ ʌ̹ pʰ j o
누리	n u ɾ i
마나마	m a̠ n a̠ m a̠
승냥이	sʰ ɯ ŋ ɲ j a̠ ŋ i
심부름하다	ɕʰ i m b u ɾ ɯ m ɦ a̠ d a̠
속쓰림	sʰ o̞ː k s͈ ɯ ɾ i m
우크라이나	u k x ɯ ɾ a̠ i n a̠
빨갛다	p͈ a̠ ɭ ɡ a̠ tʰ a̠
메모	m e̞ m o̞
에터	e̞ tʰ ʌ̹
어여머리	ʌ̹ j ʌ̹ m ʌ̹ ɾ i
술탄	sʰ u ɭ tʰ a̠ n
글쎄	k ɯ ɭ s͈ e̞
과대평가	k w a̠ː d e̞ pʰ j ʌ̹ ŋ ɡ a̠
수화기	sʰ u β w a̠ ɡ i
알부민	a̠ ɭ b u m i n
관코박쥐	k w a̠ n kʰ o̞ b a̠ k̚ t͡ɕ͈ ɥ i
동양	t o̞ ŋ j a̠ ŋ
오늬	o̞ n i
큰발윗수염박쥐	k x ɯ n b a̠ ɾ ɥ i t̚ s͈ u j ʌ̹ m b a̠ k̚ t͡ɕ͈ ɥ i
무척	m u t͡ɕʰ ʌ̹ k̚
갑자기	k a̠ p̚ t͡ɕ͈ a̠ ɡ i
파인애플	pʰ a̠ i n e̞ pʰ ɯ ɭ
고니	k o̞ n i
방기	p a̠ ŋ ɡ i
벨라루스	p e̞ ɭ ɭ a̠ ɾ u sʰ ɯ
의연금	ɰ iː j ʌ̹ n ɡ ɯ m
시민	ɕʰ iː m i n
기기	k i ɡ i
동성애	t o̞ ŋ sʰ ʌ̹ ŋ e̞
확인하다	ɸ w a̠ ɡ i n ɦ a̠ d a̠
빈칸	p i n kʰ a̠ n
돗자리	t o̞ t̚ t͡ɕ͈ a̠ ɾ i
굴뚝	k uː ɭ t͈ u k̚
빌딩	p i ɭ d i ŋ
호지명	ɸʷ o̞ d͡ʑ i m j ʌ̹ ŋ
날것	n a̠ ɭ ɡ ʌ̹ t̚
방학	p a̠ ŋ ɦ a̠ k̚
복날	p o̞ ŋ n a̠ ɭ
수없이	sʰ uː ʌ̹ p ɕ͈ i
지원	t͡ɕ i w ʌ̹ n
풋내기	pʰ u n n e̞ ɡ i
민주주의자	m i n d͡ʑ u d͡ʑ u ɰ i d͡ʑ a̠
녹색	n o̞ k s͈ e̞ k̚
매우	m e̞ u
연하다	j ɘː n ɦ a̠ d a̠
일꾼	i ɭ k͈ u n
교탁	k j oː tʰ a̠ k̚
넙치	n ʌ̹ p̚ t͡ɕʰ i
사로잡다	sʰ a̠ ɾ o̞ d͡ʑ a̠ p̚ t͈ a̠
전사	t͡ɕ ɘː n sʰ a̠
인근	i n ɡ ɯ n
오크로시카	o̞ k x ɯ ɾ o̞ ɕʰ i kʰ a̠
머루	m ʌ̹ ɾ u
서방	sʰ ʌ̹ b a̠ ŋ
모샘치	m o̞ sʰ e̞ m t͡ɕʰ i
외교관	w e̞ː ɡ j o ɡ w a̠ n
박히다	p a̠ k ç i d a̠
추천	t͡ɕʰ u t͡ɕʰ ʌ̹ n
셀러리	sʰ e̞ ɭ ɭ ʌ̹ ɾ i
상원	sʰ a̠ː ŋ w ʌ̹ n
효과적	ç j oː k͈ w a̠ d͡ʑ ʌ̹ k̚
예약하다	j e̞ː j a̠ kʰ a̠ d a̠
러시아	ɾ ʌ̹ ɕʰ i a̠
마케도니아어	m a̠ kʰ e̞ d o̞ n i a̠ ʌ̹
소개하다	sʰ o̞ ɡ e̞ ɦ a̠ d a̠
원망하다	w ɘː n m a̠ ŋ ɦ a̠ d a̠
식기세척기	ɕʰ i k̚ k͈ i sʰ e̞ t͡ɕʰ ʌ̹ k̚ k͈ i
나근나근	n a̠ ɡ ɯ n n a̠ ɡ ɯ n
튀김	tʰ ɥ i ɡ i m
옥내	o̞ ŋ n e̞
세가락메추라기	sʰ e̞ː ɡ a̠ ɾ a̠ ŋ m e̞ t͡ɕʰ u ɾ a̠ ɡ i
모이다	m o̞ i d a̠
취직	t͡ɕʰ ɥ iː d͡ʑ i k̚
오류	o̞ː ɾ j u
높임말	n o̞ pʰ i m m a̠ ɭ
연주하다	j ɘː n d͡ʑ u ɦ a̠ d a̠
진실하다	t͡ɕ i n ɕʰ i ɾ ɦ a̠ d a̠
군주국	k u n d͡ʑ u ɡ u k̚
차색	t͡ɕʰ a̠ sʰ e̞ k̚
학문	h a̠ ŋ m u n
불친절하다	p u ɭ t͡ɕʰ i n d͡ʑ ʌ̹ ɾ ɦ a̠ d a̠
마법사	m a̠ b ʌ̹ p s͈ a̠
걸림씨	k ʌ̹ ɭ ʎ i m ɕ͈ i
을까	ɯ ɭ k͈ a̠
해결하다	h e̞ ɡ j ʌ̹ ɾ ɦ a̠ d a̠
유리기	j u ɾ i ɡ i
생기다	sʰ e̞ ŋ ɡ i d a̠
피센	pʰ i sʰ e̞ n
네다섯	n e̞ː d a̠ sʰ ʌ̹ t̚
나찰	n a̠ t͡ɕʰ a̠ ɭ
무언증	m u ʌ̹ n d͡ʑ ɯ ŋ
돌잔치	t o̞ ɭ d͡ʑ a̠ n t͡ɕʰ i
후보자	ɸʷ u b o̞ d͡ʑ a̠
실현	ɕʰ i ɾ ʝ j ʌ̹ n
도교	t o̞ː ɡ j o
크루아상	k x ɯ ɾ u a̠ sʰ a̠ ŋ
산소	sʰ a̠ n sʰ o̞
음계	ɯ m ɡ j e̞
세포핵	sʰ e̞ː pʰ o̞ ɦ e̞ k̚
지시봉	t͡ɕ i ɕʰ i b o̞ ŋ
유도기	j u d o̞ ɡ i
암탉	a̠ m tʰ a̠ k̚
아오자이	a̠ o̞ d͡ʑ a̠ i
물리학	m u ɭ ʎ i ɦ a̠ k̚
노선	n o̞ sʰ ʌ̹ n
달리	t a̠ ɭ ʎ i
거실	k ʌ̹ ɕʰ i ɭ
쇠향고래	sʰ w e̞ ʝ j a̠ ŋ ɡ o̞ ɾ e̞
겨드랑이	k j ʌ̹ d ɯ ɾ a̠ ŋ i
팔각형	pʰ a̠ ɭ ɡ a̠ k ç j ʌ̹ ŋ
명성	m j ʌ̹ ŋ sʰ ʌ̹ ŋ
십륙	ɕʰ i m ɲ j u k̚
포기하다	pʰ o̞ː ɡ i ɦ a̠ d a̠
위대하다	ɥ i d e̞ ɦ a̠ d a̠
골무	k o̞ ɭ m u
십이월	ɕʰ i b i w ʌ̹ ɭ
출출하다	t͡ɕʰ u ɭ t͡ɕʰ u ɾ ɦ a̠ d a̠
기억나다	k i ʌ̹ ŋ n a̠ d a̠
난간	n a̠ n ɡ a̠ n
이질	iː d͡ʑ i ɭ
진행자	t͡ɕ iː n ɦ e̞ ŋ d͡ʑ a̠
앞서다	a̠ p s͈ ʌ̹ d a̠
전환	t͡ɕ ɘː n β w a̠ n
방주	p a̠ ŋ d͡ʑ u
겨레	k j ʌ̹ ɾ e̞
안휘	a̠ n ɦ ɥ i
적막	t͡ɕ ʌ̹ ŋ m a̠ k̚
성립되다	sʰ ʌ̹ ŋ n i p̚ t͈ w e̞ d a̠
발해	p a̠ ɾ ɦ e̞
부정	p u d͡ʑ ʌ̹ ŋ
에피소드	e̞ pʰ i sʰ o̞ d ɯ
실컷	ɕʰ i ɭ kʰ ʌ̹ t̚
갈퀴	k a̠ ɭ kʰ ɥ i
검찰청	k ɘː m t͡ɕʰ a̠ ɭ t͡ɕʰ ʌ̹ ŋ
항의하다	h a̠ː ŋ ɰ i ɦ a̠ d a̠
핵무기	h e̞ ŋ m u ɡ i
그래프	k ɯ ɾ e̞ pʰ ɯ
국화	k u kʰ w a̠
게장	k e̞ d͡ʑ a̠ ŋ
깨트리다	k͈ e̞ tʰ ɯ ɾ i d a̠
원주율	w ʌ̹ n d͡ʑ u j u ɭ
라우터	ɾ a̠ u tʰ ʌ̹
개미	k e̞ː m i
치는	t͡ɕʰ i n ɯ n
봉기	p o̞ ŋ ɡ i
구급차	k uː ɡ ɯ p̚ t͡ɕʰ a̠
강요하다	k a̠ː ŋ j o ɦ a̠ d a̠
조카	t͡ɕ o̞ kʰ a̠
미소년	m iː sʰ o̞ ɲ j ʌ̹ n
갯첨서	k e̞ t̚ t͡ɕʰ ʌ̹ m sʰ ʌ̹
비난	p iː n a̠ n
앞다리	a̠ p̚ t͈ a̠ ɾ i
흰죽지	ç i n d͡ʑ u k̚ t͡ɕ͈ i
자리	t͡ɕ a̠ ɾ i
오트밀	o̞ tʰ ɯ m i ɭ
자장면	t͡ɕ a̠ d͡ʑ a̠ ŋ m j ʌ̹ n
자기소개	t͡ɕ a̠ ɡ i sʰ o̞ ɡ e̞
갖추다	k a̠ t̚ t͡ɕʰ u d a̠
수사학	sʰ u sʰ a̠ ɦ a̠ k̚
하와	h a̠ w a̠
오사카	o̞ sʰ a̠ kʰ a̠
미역	m i j ʌ̹ k̚
영수증	j ʌ̹ ŋ sʰ u d͡ʑ ɯ ŋ
고량주	k o̞ ɾ j a̠ ŋ d͡ʑ u
거문고	k ʌ̹ m u n ɡ o̞
대우	t e̞ u
송아지	sʰ o̞ ŋ a̠ d͡ʑ i
맞춤	m a̠ t̚ t͡ɕʰ u m
유신론	j u ɕʰ i n n o̞ n
작은땃쥐	t͡ɕ a̠ ɡ ɯ n t͈ a̠ t̚ t͡ɕ͈ ɥ i
언어학	ʌ̹ n ʌ̹ ɦ a̠ k̚
어뢰	ʌ̹ ɾ w e̞
달성	t a̠ ɭ s͈ ʌ̹ ŋ
정직하다	t͡ɕ ɘː ŋ d͡ʑ i kʰ a̠ d a̠
문자	m u n t͡ɕ͈ a̠
곱하다	k o̞ pʰ a̠ d a̠
여울	j ʌ̹ u ɭ
단풍나무	t a̠ n pʰ u ŋ n a̠ m u
암살자	a̠ː m sʰ a̠ ɭ t͡ɕ͈ a̠
박람회	p a̠ ŋ n a̠ m β w e̞
트림	tʰ ɯː ɾ i m
눈두덩	n u n d u d ʌ̹ ŋ
누구세요	n u ɡ u sʰ e̞ j o
아흔	a̠ ɣ ɯ n
계란	k j e̞ ɾ a̠ n
면책조항	m j ʌ̹ n t͡ɕʰ e̞ k̚ t͡ɕ͈ o̞ ɦ a̠ ŋ
행동	h e̞ ŋ d o̞ ŋ
계사	k j e̞ː sʰ a̠
자장가	t͡ɕ a̠ d͡ʑ a̠ ŋ ɡ a̠
마트료시카	m a̠ tʰ ɯ ɾ j o ɕʰ i kʰ a̠
예수회	j e̞ sʰ u β w e̞
담당	t a̠ m d a̠ ŋ
모루	m o̞ː ɾ u
의심하다	ɰ i ɕʰ i m ɦ a̠ d a̠
이태리	i tʰ e̞ ɾ i
이데올로기	i d e̞ o̞ ɭ ɭ o̞ ɡ i
전람회	t͡ɕ ɘː ɭ ɭ a̠ m β w e̞
해산물	h e̞ sʰ a̠ n m u ɭ
짧은부리참돌고래	t͡ɕ͈ a̠ ɭ b ɯ n b u ɾ i t͡ɕʰ a̠ m d o̞ ɭ ɡ o̞ ɾ e̞
지식인	t͡ɕ i ɕʰ i ɡ i n
졸다	t͡ɕ o̞ː ɭ d a̠
파라오	pʰ a̠ ɾ a̠ o̞
충분히	t͡ɕʰ u ŋ b u n ʝ i
혜택	ç j e̞ː tʰ e̞ k̚
식사하다	ɕʰ i k s͈ a̠ ɦ a̠ d a̠
가래	k a̠ ɾ e̞
미용사	m iː j o ŋ sʰ a̠
어엿하다	ʌ̹ j ʌ̹ tʰ a̠ d a̠
부르심	p u ɾ ɯ ɕʰ i m
통행인	tʰ o̞ ŋ ɦ e̞ ŋ i n
설치되다	sʰ ʌ̹ ɭ t͡ɕʰ i d w e̞ d a̠
총각	t͡ɕʰ o̞ː ŋ ɡ a̠ k̚
바다말	p a̠ d a̠ m a̠ ɭ
칼슘	kʰ a̠ ɭ ɕʰ j u m
포경수술	pʰ o̞ː ɡ j ʌ̹ ŋ sʰ u sʰ u ɭ
사슬	sʰ a̠ sʰ ɯ ɭ
적어도	t͡ɕ ɘː ɡ ʌ̹ d o̞
개발되다	k e̞ b a̠ ɭ d w e̞ d a̠
인덴	i n d e̞ n
노크하다	n o̞ k x ɯ ɦ a̠ d a̠
출연하다	t͡ɕʰ u ɾ j ʌ̹ n ɦ a̠ d a̠
바꾸다	p a̠ k͈ u d a̠
알락해오라기	a̠ ɭ ɭ a̠ kʰ e̞ o̞ ɾ a̠ ɡ i
연습하다	j ɘː n sʰ ɯ pʰ a̠ d a̠
꼬집다	k͈ o̞ d͡ʑ i p̚ t͈ a̠
글리세린	k ɯ ɭ ʎ i sʰ e̞ ɾ i n
두르다	t u ɾ ɯ d a̠
대표	t e̞ː pʰ j o
선진국	sʰ ʌ̹ n d͡ʑ i n ɡ u k̚
미인	m iː i n
갈옷	k a̠ ɾ o̞ t̚
보장	p o̞ː d͡ʑ a̠ ŋ
수갑	sʰ u ɡ a̠ p̚
과학	k w a̠ ɦ a̠ k̚
미얀마	m i j a̠ n m a̠
연휴	j ʌ̹ n ʝ j u
굳어지다	k u d ʌ̹ d͡ʑ i d a̠
장로교	t͡ɕ a̠ː ŋ n o̞ ɡ j o
꽃잎	k͈ o̞ n n i p̚
보병	p o̞ː b j ʌ̹ ŋ
알리고	a̠ ɭ ʎ i ɡ o̞
정말로	t͡ɕ ɘː ŋ m a̠ ɭ ɭ o̞
약혼녀	j a̠ kʰ o̞ n ɲ j ʌ̹
재봉틀	t͡ɕ e̞ b o̞ ŋ tʰ ɯ ɭ
오딘	o̞ d i n
동굴	t o̞ː ŋ ɡ u ɭ
응당	ɯ ŋ d a̠ ŋ
등나무	t ɯ ŋ n a̠ m u
사탄교	sʰ a̠ tʰ a̠ n ɡ j o
노르웨이어	n o̞ ɾ ɯ w e̞ i ʌ̹
철판	t͡ɕʰ ʌ̹ ɭ pʰ a̠ n
한여름	h a̠ n ɲ j ʌ̹ ɾ ɯ m
도기	t o̞ ɡ i
말똥가리	m a̠ ɭ t͈ o̞ ŋ ɡ a̠ ɾ i
잭프루트	t͡ɕ e̞ k̚ pʰ ɯ ɾ u tʰ ɯ
소제하다	sʰ o̞ː d͡ʑ e̞ ɦ a̠ d a̠
성과	sʰ ʌ̹ ŋ k͈ w a̠
능력	n ɯ ŋ ɲ j ʌ̹ k̚
계속되다	k j e̞ː sʰ o̞ k̚ t͈ w e̞ d a̠
집회	t͡ɕ i pʰ w e̞
쉽다	ʃʰ ɥ iː p̚ t͈ a̠
답사	t a̠ p s͈ a̠
핥다	h a̠ ɭ t͈ a̠
비늘	p i n ɯ ɭ
말뚝망둥어	m a̠ ɭ t͈ u ŋ m a̠ ŋ d u ŋ ʌ̹
중학교	t͡ɕ u ŋ ɦ a̠ k̚ k͈ j o
컬래버레이션	kʰ ʌ̹ ɭ ɭ e̞ b ʌ̹ ɾ e̞ i ɕʰ j ʌ̹ n
어차피	ʌ̹ t͡ɕʰ a̠ pʰ i
욕심	j o k ɕ͈ i m
쉬다	ʃʰ ɥ iː d a̠
관계대명사	k w a̠ n ɡ j e̞ d e̞ m j ʌ̹ ŋ sʰ a̠
공갈	k o̞ː ŋ ɡ a̠ ɭ
나시	n a̠ ɕʰ i
성탄절	sʰ ɘː ŋ tʰ a̠ n d͡ʑ ʌ̹ ɭ
특정	tʰ ɯ k̚ t͡ɕ͈ ʌ̹ ŋ
복사하다	p o̞ k s͈ a̠ ɦ a̠ d a̠
ㄴㄴ	n o̞ n o̞
따오기	t͈ a̠ o̞ ɡ i
계산대	k j e̞ː sʰ a̠ n d e̞
양탄자	j a̠ ŋ tʰ a̠ n d͡ʑ a̠
귀엣말하다	k ɥ i e̞ n m a̠ ɾ ɦ a̠ d a̠
정도	t͡ɕ ʌ̹ ŋ d o̞
성인	sʰ ʌ̹ ŋ i n
계획	k j e̞ː β w e̞ k̚
인식론	i n ɕʰ i ŋ n o̞ n
제일	t͡ɕ e̞ː i ɭ
디바이스	t i b a̠ i sʰ ɯ
직접화법	t͡ɕ i k̚ t͡ɕ͈ ʌ̹ pʰ w a̠ b ʌ̹ p̚
연옥	j ɘː n o̞ k̚
장관	t͡ɕ a̠ː ŋ ɡ w a̠ n
같다	k a̠ t̚ t͈ a̠
고전	k o̞ː d͡ʑ ʌ̹ n
들리다	t ɯ ɭ ʎ i d a̠
뿜다	p͈ uː m t͈ a̠
쌍정	s͈ a̠ ŋ d͡ʑ ʌ̹ ŋ
가면	k a̠ː m j ʌ̹ n
알카인	a̠ ɭ kʰ a̠ i n
부담	p uː d a̠ m
신성	ɕʰ i n sʰ ʌ̹ ŋ
어버이	ʌ̹ b ʌ̹ i
십구	ɕʰ i p̚ k͈ u
본성	p o̞ n sʰ ʌ̹ ŋ
살다	sʰ a̠ː ɭ d a̠
아이티	a̠ i tʰ i
불러일으키다	p u ɭ ɭ ʌ̹ i ɾ ɯ k ç i d a̠
이것	i ɡ ʌ̹ t̚
살찌다	sʰ a̠ ɭ t͡ɕ͈ i d a̠
교대	k j o d e̞
소녀	sʰ o̞ː ɲ j ʌ̹
사물	sʰ a̠ː m u ɭ
백합	p e̞ kʰ a̠ p̚
원자력	w ʌ̹ n d͡ʑ a̠ ɾ j ʌ̹ k̚
부럼없다	p u ɾ ʌ̹ m ʌ̹ p̚ t͈ a̠
현실적	ç j ɘː n ɕʰ i ɭ t͡ɕ͈ ʌ̹ k̚
반올림	p a̠ː n o̞ ɭ ʎ i m
아무렇다	a̠ː m u ɾ ʌ̹ tʰ a̠
재정	t͡ɕ e̞ d͡ʑ ʌ̹ ŋ
비로소	p i ɾ o̞ sʰ o̞
편의점	pʰ j ʌ̹ n ɰ i d͡ʑ ʌ̹ m
오케이	o̞ kʰ e̞ i
파랑	pʰ a̠ ɾ a̠ ŋ
저항	t͡ɕ ɘː ɦ a̠ ŋ
곤난	k o̞ n n a̠ n
내각	n e̞ː ɡ a̠ k̚
아끼다	a̠ k͈ i d a̠
멧토끼	m e̞ t̚ tʰ o̞ k͈ i
청와대	t͡ɕʰ ʌ̹ ŋ w a̠ d e̞
염주	j ɘː m d͡ʑ u
부름	p u ɾ ɯ m
사모바르	sʰ a̠ m o̞ b a̠ ɾ ɯ
첫째	t͡ɕʰ ʌ̹ t̚ t͡ɕ͈ e̞
전망	t͡ɕ ɘː n m a̠ ŋ
바스스카프	p a̠ sʰ ɯ sʰ ɯ kʰ a̠ pʰ ɯ
춤꾼	t͡ɕʰ u m k͈ u n
측위	t͡ɕʰ ɯ ɡ ɥ i
지느러미	t͡ɕ i n ɯ ɾ ʌ̹ m i
골인	k͈ o̞ ɾ i n
민서	m i n s͈ ʌ̹
치타	t͡ɕʰ i tʰ a̠
유해하다	j uː ɦ e̞ ɦ a̠ d a̠
습니까	s͈ ɯ m n i k͈ a̠
양식	j a̠ ŋ ɕʰ i k̚
추락	t͡ɕʰ u ɾ a̠ k̚
호주머니	ɸʷ o̞ d͡ʑ u m ʌ̹ n i
봉투	p o̞ ŋ tʰ u
라면	ɾ a̠ m j ʌ̹ n
딱지	t͈ a̠ k̚ t͡ɕ͈ i
