ယမ်းတောင့်	j á ɴ d a̰ ʊ ɴ
ကောက်ညှင်း	k a ʊ ʔ ɲ̊ ɪ́ ɴ
လေမုန်တိုင်း	l è m ò ʊ ɴ d á ɪ ɴ
နီး	n í
ကလီစာ	k ə l ì z à
မတ်ပဲ	m a ʔ p ɛ́
ဘဏ်	b à ɴ
လေထု	l è d ṵ
သွားကြားထိုးတံ	θ w á d͡ʑ á tʰ ó d à ɴ
ရိုင်ဖယ်	ɹ à ɪ ɴ pʰ ɛ̀
စိတ်ရောဂါ	s e ɪ ʔ j ɔ́ ɡ à
ငှက်	ŋ̊ ɛ ʔ
ပန်းပု	b ə b ṵ
ဆရာသမား	sʰ a̰ j à θ ə m á
မုန်လာဥနီ	m ò ʊ ɴ l à ʔ ṵ n ì
ဂျာမန်	d͡ʑ à m à ɴ
အမှတ်	ʔ ə m̥ a ʔ
စာရင်းကိုင်	s ə j ɪ́ ɴ ɡ à ɪ ɴ
မျို	m j ò
ဗီတာမင်	b ì t à m ɪ̀ ɴ
သံမဏိ	θ à ɴ m ə n ḭ
မင်းမြောက်တန်ဆာ	m ɪ́ ɴ m j a ʊ ʔ d ə z à
နဲ့	n ɛ̰
အကြေး	ʔ ə t͡ɕ é
ဟဲလို	h ɛ́ l ò
အောင်	ʔ à ʊ ɴ
အစေ့	ʔ ə s ḭ
သော့	θ ɔ̰
ပခုက္ကူ	p ə kʰ ù k k ù
ရုပ်ကလာပ်	j o ʊ ʔ k ə l a ʔ
အစိုးရ	ʔ ə s ó j a̰
ညွန့်	ɲ ʊ̰ ɴ
ဂြိုဟ်	d͡ʑ ò
ပိန်းဥ	p é ɪ ɴ ʔ ṵ
ချဉ်ပေါင်	t͡ɕʰ ɪ̀ ɴ b à ʊ ɴ
ပစ္စုပ္ပန်	p ɪ ʔ s o ʊ ʔ p à ɴ
ဂါထာ	ɡ à tʰ à
စက်ဆုပ်	s ɛ ʔ sʰ o ʊ ʔ
မြစ်ကြီးနား	m j ɪ ʔ t͡ɕ í n á
ကျိုက်ထို	t͡ɕ a ɪ ʔ tʰ ò
ရနံ့	j ə n a̰ ɴ
နာမ်	n à ɴ
အနုရုဒ္ဓါ	ʔ ə n ṵ j o ʊ ʔ d à
သမင်	θ ə m ɪ̀ ɴ
ကုန်	k ò ʊ ɴ
ပုံသေနည်း	p ò ʊ ɴ ð è n í
ရဝေ	j ə w è
ဘရဏီ	b a̰ j ə n ì
ကြေးနန်း	t͡ɕ é n á ɴ
ရှယ်	ʃ ɛ̀
မိုဇမ်ဘစ်	m ò z à ɴ b ɪ ʔ
သိဝ	θ ḭ w a̰
ကိုမိုရို	k ò m ò ɹ ò
လျှာရည်	ʃ à j ì
နိခါတကဗေဒ	n ḭ kʰ à t ə k a̰ b è d a̰
ခေတ္တ	kʰ ɪ ʔ t a̰
လဲ	l ɛ́
ဗီဇာ	b ì z à
ဗုဒ္ဓဟူး	b o ʊ ʔ d a̰ h ú
ဆိုင်း	sʰ á ɪ ɴ
ပြန်ကြား	p j à ɴ t͡ɕ á
နေရာငါးသွယ်	n è j à ŋ á θ w ɛ̀
မဆလာ	m a̰ sʰ ə l à
ဆပ္ပတ်	sʰ a ʔ p a ʔ
ဖက်ဝန်း	pʰ ɛ ʔ w ʊ́ ɴ
ကြမ်း	t͡ɕ á ɴ
စာရေး	s ə j é
အမျိုးလေးပါး	ʔ ə m j ó l é b á
မျက်နှာဖုံး	m j ɛ ʔ n̥ ə pʰ ó ʊ ɴ
ကိုယ်ဝန်	k ò j w ʊ̀ ɴ
တပည့်တော်မ	d ə b ḭ d ɔ̀ m a̰
အမှန်တရား	ʔ ə m̥ à ɴ t ə j á
ခြည်	t͡ɕʰ ì
တာမွေ	t à m w è
ညကလေး	ɲ a̰ k ə l é
မံသ	m à ɴ θ a̰
ပိုက်ဆံအိတ်	p a ɪ ʔ sʰ à ɴ ʔ e ɪ ʔ
ကွန်ဖရင့်	k ʊ̀ ɴ pʰ ə ɹ ɪ̰ ɴ
အကွာအဝေး	ʔ ə k w à ʔ ə w é
သစ်ကုလားအုတ်	θ ɪ ʔ k ə l ə ʔ o ʊ ʔ
သွေးကြော	θ w é d͡ʑ ɔ́
တရားရုံး	t ə j á j ó ʊ ɴ
လည်ပင်း	l ɛ̀ b ɪ́ ɴ
စေတနာ	s è d ə n à
ပစ္ဆိမ	p j ɪ ʔ sʰ e ɪ ʔ m a̰
ဗုန်း	b ó ʊ ɴ
လိပ်ခေါင်း	l e ɪ ʔ ɡ á ʊ ɴ j ɔ́ ɡ à
တံပူ	d ə b ù
သိထိလ	θ ḭ tʰ ḭ l a̰
ပျော့	p j ɔ̰
ဘင်္ဂါလီ	b ɪ̀ ɴ ɡ à l ì
ဆင်	sʰ ɪ̀ ɴ
လာအို	l à ʔ ò
သောသော	θ ɔ́ ð ɔ́
တော်လှန်	t ɔ̀ l̥ à ɴ
အချုပ်ခန်း	ʔ ə t͡ɕʰ o ʊ ʔ kʰ á ɴ
ဗိုင်း	b á ɪ ɴ
ဝမ်းသာ	w ʊ́ ɴ θ à
ညှာ	ɲ̊ à
ဒေါင်းလန်း	d á ʊ ɴ l á ɴ
လူသတ်သမား	l ù θ a ʔ ð ’ မ ာ
ဩဇာသီး	ʔ ɔ́ z à θ í
ညောင်လေးပင်	ɲ à ʊ ɴ l é p ɪ̀ ɴ
မြင်းလှည်း	m j ɪ́ ɴ l̥ ɛ́
တက်	t ɛ ʔ
ငါးမုန့်	ŋ á m o̰ ʊ ɴ
ဆရာ	sʰ ə j à
ကမ္ဗလာ	ɡ ə b ə l à
သိပ္ပံ	θ e ɪ ʔ p à ɴ
မုန့်ဟင်းခါး	m o̰ ʊ ɴ h ɪ́ ɴ ɡ á
ကုမ္ပဏီ	k ò ʊ ɴ p ə n ì
လှုလှု	l̥ ṵ l̥ ṵ
တမန်	t ə m à ɴ
လေပွေ	l è b w è
ပန်းထိမ်	b ə d è ɪ ɴ
အမည်	ʔ ə m j ì
နင်	n ɪ̀ ɴ
ဘွားဘွား	pʰ w á pʰ w á
ဆီထမင်း	sʰ ì tʰ ə m ɪ́ ɴ
အဘိုး	ʔ ə pʰ ó
ကော်ပြန့်	k ɔ̀ p j a̰ ɴ
လှုပ်လှုပ်	l̥ o ʊ ʔ l̥ o ʊ ʔ
အကြမ်းဖက်သမား	ʔ ə t͡ɕ á ɴ pʰ ɛ ʔ θ ə m á
ဘိက္ခုနီ	b ì k kʰ ṵ n ì
စာဆို	s à z ò
အငတ်	ʔ ə ŋ a ʔ
ဂရု	ɡ ə j ṵ
အားကိုး	ʔ á k ó
နွားမ	n ə m a̰
ခရိုမီယမ်	kʰ ə ɹ ò m ì j à ɴ
သင်္ဂဟ	θ ɪ̰ ɴ ɡ ə h a̰
အဲလစ်ဇဘက်	ʔ ɛ́ l ɪ ʔ z a̰ b ɛ ʔ
မုစလိန္ဒ	m ṵ s ə l è ɪ ɴ d a̰
ဓာတ်ငွေ့	d a ʔ ŋ w ḛ
စားဖို	s ə pʰ ò
ဒုံး	d ó ʊ ɴ
ငြိမ်းချမ်းရေး	ɲ é ɪ ɴ d͡ʑ á ɴ j é
ကမ်းခြေ	k á ɴ d͡ʑ è
ဇွန်း	z ʊ́ ɴ
ဒွိလိင်	d w ḭ l è ɪ ɴ
နေ့	n ḛ
ကနစိုး	k ə n ə z ó
ရှည်	ʃ è
စိမ်း	s é ɪ ɴ
ဦးနှောက်	ʔ ó ʊ ɴ n̥ a ʊ ʔ
ကုဋေ	ɡ ə d è
အငြိမ့်	ʔ ə ɲ ḛ ɪ ɴ
နာမည်	n à m j ì
နေရာ	n è j à
နေ့လယ်	n ḛ l ɛ̀
ဒိန်ခဲ	d è ɪ ɴ ɡ ɛ́
မာရ်နတ်	m à n a ʔ
ဗင်နီဇွဲလား	b ɪ̀ ɴ n ì z w ɛ́ l á
စာသင်ခန်း	s à θ ɪ̀ ɴ ɡ á ɴ
လျှာနာခွာနာ	ʃ à n à kʰ w à n à
ရေလက်ဝါး	j è l ɛ ʔ w á
အာမေဍိတ်	ʔ à m è d e ɪ ʔ
မီးခွက်	m í ɡ w ɛ ʔ
အင်ဒိုရာ	ʔ ɪ̀ ɴ d ò ɹ à
ပုစွန်	b ə z ʊ̀ ɴ
ခေတ်	kʰ ɪ ʔ
ဇယ	z ə j a̰
သို့မဟုတ်	ð o̰ m ə h o ʊ ʔ
သွေးပေါ်	θ w é p ɔ̀
ဝေလငါး	w è l a̰ ŋ á
ရိုး	j ó
ဆေးရုံ	sʰ é j ò ʊ ɴ
စားဖိုဆောင်	s ə pʰ ò z à ʊ ɴ
မဟာသာဝက	m ə h à θ à w ə k a̰
သဘော	ð ə b ɔ́
ပဲဆီ	p ɛ́ z ì
စစ်ကဲ	s ɪ ʔ k ɛ́
အရက်ဆိုင်	ʔ ə j ɛ ʔ sʰ à ɪ ɴ
သဒ္ဒဗေဒ	θ a ʔ d a̰ b è d a̰
သည်းခြေ	θ í d͡ʑ è
ကွန်ဖြူးရှပ်	k ʊ̀ ɴ pʰ j ú ʃ a ʔ
ညစ်	ɲ ɪ ʔ
ရွှေထမင်း	ʃ w è tʰ ə m ɪ́ ɴ
ဓာတ်ပုံ	d a ʔ p ò ʊ ɴ
အုန်းနို့	ʔ ó ʊ ɴ n o̰
ဆိတ်ကုလား	sʰ e ɪ ʔ k ə l á
ခြမ်း	t͡ɕʰ á ɴ
ပြည်ထောင်စုလွှတ်တော်	p j ì d à ʊ ɴ z ṵ l̥ ʊ ʔ t ɔ̀
ချဒ်	t͡ɕʰ à d
ကာလသားရောဂါ	k à l a̰ θ á j ɔ́ ɡ à
ဗော့ဒ်ကာ	b ɔ̰ d k à
ပါတာနီ	p à t à n ì
ရှား	ʃ á
စတုဒိသာ	s a̰ t ṵ d ḭ θ à
နတ်ဆိုး	n a ʔ sʰ ó
လှလှ	l̥ a̰ l̥ a̰
ရွှဲ	ʃ w ɛ́
နိပော	n ḭ p ɔ́
သတ္တုရိုင်း	θ a ʔ t ṵ j á ɪ ɴ
တေးသွား	t é ð w á
အတာအိုး	ʔ ə t à ʔ ó
နမူနာ	n ə m ù n à
ကန့်လန့်ကာ	k ə l ə ɡ à
သိုးထိန်း	θ ó d é ɪ ɴ
ဣန္ဒာ	ʔ ḭ n d à
ပိုးတောင်မာ	p ó d à ʊ ɴ m à
သမ္မာကျမ်း	θ ə m à t͡ɕ á ɴ
ဘုရင်မ	b a̰ j ɪ̀ ɴ m a̰
ရုပ်မြင်သံကြား	j o ʊ ʔ m j ɪ̀ ɴ θ à ɴ d͡ʑ á
သား	θ á
သတ္တိ	θ a ʔ t ḭ
ဝိသေသ	w ḭ θ è θ a̰
ကော်ပြန့်ကြော်	k ɔ̀ p j a̰ ɴ d͡ʑ ɔ̀
ငါးရံ့	ŋ ə j a̰ ɴ
သင်ခန်းစာ	θ ɪ̀ ɴ ɡ á ɴ z à
ဘိက္ခူ	b e ɪ ʔ kʰ ù
နတ်	n a ʔ
ကျားသစ်	t͡ɕ ə θ ɪ ʔ
ရာဇာဓိရာဇဂုရု	j à z a̰ d ḭ j à z a̰ ɡ ṵ ɹ ṵ
စိတ္တဗေဒ	s e ɪ ʔ t a̰ b è d a̰
စက်ခေါင်း	s ɛ ʔ ɡ á ʊ ɴ
ဝက်အူချောင်း	w ɛ ʔ ʔ ù d͡ʑ á ʊ ɴ
မုဆိုးဖို	m ṵ sʰ ó b ò
ထွန်စက်	tʰ ʊ̀ ɴ z ɛ ʔ
သမ္ဗန္ဓ	θ à ɴ b à ɴ d a̰
ခွေးမသား	kʰ w é m a̰ ð á
နိုင်ငံကူးလက်မှတ်	n à ɪ ɴ ŋ à ɴ ɡ ú l ɛ ʔ m̥ a ʔ
ကုလသမဂ္ဂ	k ṵ l a̰ θ a̰ m ɛ ʔ ɡ a̰
မဂ္ဂင်ရှစ်ပါး	m ɛ ʔ ɡ ɪ̀ ɴ ʃ ɪ ʔ b á
လိမ်း	l é ɪ ɴ
ဘာ	b à
သစ်သီးရည်	θ ɪ ʔ θ í j è
သော့တံ	θ ɔ̰ d à ɴ
ကျောက်ဖရုံ	t͡ɕ a ʊ ʔ pʰ ə j ò ʊ ɴ
ခြောက်	t͡ɕʰ a ʊ ʔ
လုံးလုံး	l ó ʊ ɴ l ó ʊ ɴ
ဒိန်းမတ်	d é ɪ ɴ m a ʔ
ပိုက်သမား	p a ɪ ʔ θ ə m á
အဘိုးကြီး	ʔ ə pʰ ó d͡ʑ í
မိုးကုတ်	m ó k o ʊ ʔ
ပြင်သည်	p j ɪ̀ ɴ θ ì
မီးရထား	m í j ə tʰ á
တိုင်	t à ɪ ɴ
အရောင်းအဝယ်	ʔ ə j á ʊ ɴ ʔ ə w ɛ̀
သောင်းသောင်း	θ á ʊ ɴ ð á ʊ ɴ
မျိုးဆက်	m j ó z ɛ ʔ
မဲဇလီ	m ɛ́ z ə l ì
ငါးပိရည်	ŋ ə p ḭ j è
အညာသား	ʔ ə ɲ à ð á
ဘူးသီးတောင်	b ú ð í d à ʊ ɴ
သကြားလုံး	ð ə d͡ʑ á l ó ʊ ɴ
ပဲကြီး	p ɛ́ d͡ʑ í
လျှာ	ʃ à
ယစ်ထုတ်	j ɪ ʔ tʰ o ʊ ʔ
ဒီမိုကရေစီ	d ì m ò k ə ɹ è s ì
မည်သူ	m ì ð ù
ဆွမ်း	sʰ ʊ́ ɴ
တံ့တံ့	t a̰ ɴ d a̰ ɴ
ကွန်ဒုံး	k ʊ̀ ɴ d ó ʊ ɴ
ပရိဘောဂ	p ə ɹ ḭ b ɔ́ ɡ a̰
ဌေး	tʰ é
ဆီးပူညောင်းကျ	sʰ í p ù ɲ á ʊ ɴ t͡ɕ a̰
ရှက်	ʃ ɛ ʔ
ရေမိုင်	j è m à ɪ ɴ
ခြား	t͡ɕʰ á
သွန်းသွန်း	θ ʊ́ ɴ ð ʊ́ ɴ
ယတြာ	j ə d ə j à
ဟင်းသီးဟင်းရွက်	h ɪ́ ɴ ð í h ɪ́ ɴ j w ɛ ʔ
အာရာမ	ʔ à j à m a̰
မတ်ခွက်	m a ʔ kʰ w ɛ ʔ
အာရိုက်	ʔ à j a ɪ ʔ
ယပင့်	j a̰ p ɪ̰ ɴ
ဆိုင်းဝိုင်း	sʰ á ɪ ɴ w á ɪ ɴ
ပဲခူး	b ə ɡ ó
အီရတ်	ʔ ì ɹ a ʔ
ရပ်	j a ʔ
ကားရုံ	k á j ò ʊ ɴ
သစ်သီး	θ ɪ ʔ θ í
စင်္ကြံ	z ɪ́ ɴ d͡ʑ à ɴ
စာမေးပွဲ	s à m é b w ɛ́
နတ်ကွန်း	n a ʔ k ʊ́ ɴ
ညောင်	ɲ à ʊ ɴ
သီရိ	θ ì ɹ ḭ
နားကွင်း	n á ɡ w ɪ́ ɴ
ဆိုထုံး	sʰ ò d ó ʊ ɴ
နေရာထိုင်ခင်း	n è j à tʰ à ɪ ɴ ɡ ɪ́ ɴ
ပနားမား	p a̰ n á m á
ကောလာဟလ	k ɔ́ l à h a̰ l a̰
သက်တံ	θ ɛ ʔ t à ɴ
ဗာလချောင်	b à l a̰ t͡ɕʰ à ʊ ɴ
တဏှာ	t ə n̥ à
ပုန်ကန်	p ò ʊ ɴ k à ɴ
တိုက်အိမ်	t a ɪ ʔ ʔ è ɪ ɴ
မိုနာကို	m ò n à k ò
ဆိတ်ချေး	sʰ e ɪ ʔ t͡ɕʰ í
ဝတ်	w ʊ ʔ
ဇာတ်	z a ʔ
ဘက်	b ɛ ʔ
အာဇာနည်	ʔ à z à n ì
လေသာခန်း	l è ð à ɡ á ɴ
အကြွေးဝယ်ကတ်ပြား	ʔ ə t͡ɕ w é w ɛ̀ k a ʔ p j á
ပေါက်တူး	p a ʊ ʔ t ú
ပုဒ်ကလေး	p o ʊ ʔ k ə l é
အင်းဆက်	ʔ ɪ́ ɴ sʰ ɛ ʔ
အဖို့	ʔ ə pʰ o̰
ဝက်သားချဉ်	w ɛ ʔ θ á t͡ɕʰ ɪ̀ ɴ
ရမ်းရမ်း	j á ɴ j á ɴ
ညာ	ɲ à
ပညတ်	p j ɪ̰ ɴ n a ʔ
စိတ်ဓာတ်	s e ɪ ʔ d à t
ပုံ	p ò ʊ ɴ
ညစ်ထည်း	ɲ ɪ ʔ tʰ é
ကူဖီ	k ù pʰ ì
ဝါစင်္ဂ	w à z ɪ̀ ɴ ɡ a̰
ရွရွ	j w a̰ j w a̰
ဘာသာစကား	b à θ à z ə ɡ á
အချပ်	ʔ ə t͡ɕʰ a ʔ
သင်္ချာ	θ ɪ̀ ɴ t͡ɕʰ à
ကြက်မောက်သီး	t͡ɕ ɛ ʔ m a ʊ ʔ θ í
ထင်စား	tʰ ɪ̀ ɴ z á
ဘင်	b ɪ̀ ɴ
ဓနိတ	d ə n ḭ t a̰
ပြည်သူ	p j ì ð ù
နံနံ	n à ɴ n à ɴ
ဆပ်သွားဖူး	sʰ a ʔ θ w á pʰ ú
ရွှေရင်အေး	ʃ w è j ɪ̀ ɴ ʔ é
ကြံ	t͡ɕ à ɴ
အဉ္ဇလီ	ʔ ɪ̀ ɴ z ə l ì
ရာသီ	j à ð ì
ခြံ	t͡ɕʰ à ɴ
နှစ်ဆန်းတစ်ရက်	n̥ ɪ ʔ sʰ á ɴ t ə j ɛ ʔ
သာဓု	θ à d ṵ
အမ	ʔ ə m a̰
ရာဇဝတ်ကောင်	j à z ə w ʊ ʔ k à ʊ ɴ
တူး	t ú
အသည်းနှလုံး	ʔ ə θ ɛ́ n̥ ə l ó ʊ ɴ
ရှိုက်	ʃ a ɪ ʔ
ကွမ်းမွှေး	k ʊ́ ɴ m̥ w é
ဆွေခုနစ်ဆက်မျိုးခုနစ်ဆက်	sʰ w è kʰ ə n ə z ɛ ʔ m j ó kʰ ə n ə z ɛ ʔ
လူသား	l ù ð á
ကွန်ပျူတာ	k ʊ̀ ɴ p j ù t à
ပိုတက်ဆီယမ်	p ò t ɛ ʔ sʰ ì j à ɴ
ပူဇော်	p ù z ɔ̀
ခရိုအေးရှား	kʰ ə ɹ ò ʔ é ʃ á
ကမန်	k a̰ m à ɴ
တန်ဆောင်မုန်း	d ə z à ʊ ɴ m ó ʊ ɴ
သံပရို	θ à ɴ b a̰ j ò
အချိတ်	ʔ ə t͡ɕʰ e ɪ ʔ
သတ္တဗေဒ	θ a ʔ t a̰ b è d a̰
မြို့နယ်	m j o̰ n ɛ̀
မီးပန်း	m í b á ɴ
မူး	m ú
ဆီချက်	sʰ ì d͡ʑ ɛ ʔ
တိပိဋက	t ḭ p ḭ t ə k a̰
ယသောဓရာ	j a̰ θ ɔ́ d ə j à
သံဖြူ	θ à ɴ b j ù
အမြဲတမ်း	ʔ ə m j ɛ́ d á ɴ
အောက်သား	ʔ a ʊ ʔ ð á
တူရိယာ	t ù ɹ ḭ j à
ရှူ	ʃ ù
ပါ	p à
ယောဂ	j ɔ́ ɡ ì
မိုးကုပ်စက်ဝိုင်း	m ó ɡ o ʊ ʔ s ɛ ʔ w á ɪ ɴ
သမ်း	θ á ɴ
ရမ္မက်	j ə m ɛ ʔ
ယုတ္တိဗေဒ	j o ʊ ʔ t ḭ b è d a̰
ပါရရာ	p à ɹ ə j à
မြေး	m j é
ဇင့်ခ်	z ɪ̰ ɴ
တင်ဒါ	t ɪ̀ ɴ d à
တံတောင်	d ə d à ʊ ɴ
တစောင်း	d ə z á ʊ ɴ
ဂျပန်	d͡ʑ ə p à ɴ
အလုံး	ʔ ə l ó ʊ ɴ
ဆိုး	sʰ ó
ကန္တာရ	k à ɴ t à j a̰
ချိုး	t͡ɕʰ ó
ကျောင်းသုံးစာအုပ်	t͡ɕ á ʊ ɴ ð ó ʊ ɴ s à ʔ o ʊ ʔ
ရပါတယ်	j a̰ b à d ɛ̀
ယူနိုက်တက်ကင်းဒမ်း	j ù n a ɪ ʔ t ɛ ʔ k ɪ́ ɴ d á ɴ
ချွံချွံ	t͡ɕʰ ʊ̀ ɴ d͡ʑ ʊ̀ ɴ
ပုဒ်	p o ʊ ʔ
လင်ကောင်ပိုး	l ɪ̀ ɴ ɡ à ʊ ɴ b ó
လေလည်	l è l è
မဏိပူရ	m ə n ḭ p ù j a̰
တရား	t ə j á
တိုးနရား	t ó n ə j á
ဝံသ	w ʊ̀ ɴ θ a̰
တမန်တော်	t ə m à ɴ d ɔ̀
အကျော်ဇေယျ	ʔ ə t͡ɕ ɔ̀ z è j a̰
မီးလင်းဖို	m í l ɪ́ ɴ b ò
သမီး	θ ə m í
ဘိန်း	b é ɪ ɴ
ဆံတော်ချ	sʰ à ɴ t ɔ̀ t͡ɕʰ a̰
စာပေ	s à p è
သမက်	θ ə m ɛ ʔ
အချိန်	ʔ ə t͡ɕʰ è ɪ ɴ
ထွန်	tʰ ʊ̀ ɴ
မဟာကဿပ	m ə h à k a ʔ θ ə p a̰
အဆင့်	ʔ ə sʰ ɪ̰ ɴ
လိုအပ်	l ò ʔ a ʔ
ကရစ်ကက်	k ə ɹ ɪ ʔ k ɛ ʔ
လျားလျား	j á j á
အပင်	ʔ ə p ɪ̀ ɴ
အစားအစာ	ʔ ə s á ʔ ə s à
မေတ္တာ	m j ɪ ʔ t à
အယ်လ်ဘေးနီးယား	ʔ ɛ̀ l b é n í j á
ဇန်နဝါရီ	z à ɴ n ə w à ɹ ì
ဒေါ်လာ	d ɔ̀ l à
ဩသဓ	ʔ ɔ́ θ ə d a̰
အသား	ʔ ə θ á
ဘိုင်	b à ɪ ɴ
စက်သုံးဆီဆိုင်	s ɛ ʔ θ ó ʊ ɴ sʰ ì sʰ à ɪ ɴ
သက်ဦးဆံပိုင်	θ ɛ ʔ ʔ ú sʰ à ɴ b à ɪ ɴ
ပြော	p j ɔ́
အရေပြားရောဂါ	ʔ ə j è b j á j ɔ́ ɡ à
ပန်းချီဆရာ	b ə d͡ʑ ì sʰ ə j à
ပုန်းရည်ကြီး	p ó ʊ ɴ j è d͡ʑ í
အလံ	ʔ ə l à ɴ
ဇာတ်ခုံ	z a ʔ kʰ ò ʊ ɴ
တပ်ခွဲတပ်ကြပ်ကြီး	t a ʔ kʰ w ɛ́ t a ʔ t͡ɕ a ʔ t͡ɕ í
ဖို့	pʰ o̰
ထိကပေါက်	tʰ ḭ ɡ ə b a ʊ ʔ
ကြက်ခြေ	t͡ɕ ɛ ʔ t͡ɕʰ è
အဖွဲ့ချုပ်	ʔ ə pʰ w ɛ̰ d͡ʑ o ʊ ʔ
အမြစ်	ʔ ə m j ɪ ʔ
စေတနာရှင်	s è d ə n à ʃ ɪ̀ ɴ
ရာဂ	j à ɡ a̰
တဘက်	d ə b ɛ ʔ
တနင်္ဂနွေ	t ə n ɪ̀ ɴ ɡ ə n w è
ကွန်	k ʊ̀ ɴ
ဂွမ်း	ɡ ʊ́ ɴ
ယုန်	j ò ʊ ɴ
ဂျမေကာ	d͡ʑ ə m è k à
အနက်	ʔ ə n ɛ ʔ
ကြီးမား	t͡ɕ í m á
စုလျား	s ṵ j á
တိရစ္ဆာန်	t ə ɹ e ɪ ʔ sʰ à ɴ
သတင်းစာ	ð ə d ɪ́ ɴ z à
အနာဂတ်	ʔ ə n à ɡ a ʔ
ဆန်းဒဝစ်	sʰ á ɴ d ə w ɪ ʔ
အချစ်	ʔ ə t͡ɕʰ ɪ ʔ
လောက်	l a ʊ ʔ
အမျိုးသမီး	ʔ ə m j ó ð ə m í
စန္ဒာ	s à ɴ d à
ချစ်သူ	t͡ɕʰ ɪ ʔ θ ù
စန္ဒြာ	s à ɴ d ɹ à
ဘောဂဗေဒ	b ɔ́ ɡ a̰ t a̰ b è d a̰
ယောက်ျား	j a ʊ ʔ t͡ɕ á
ဗိုင်းရပ်စ်	b á ɪ ɴ ɹ a ʔ s
အရှင်ဘုရား	ʔ ə ʃ ɪ̀ ɴ pʰ ə j á
လစ်ဗျား	l ɪ ʔ b j á
ပြဿနာ	p j a ʔ θ ə n à
အိမ်လည်	ʔ è ɪ ɴ l è
ဒိုင်ခွက်	d à ɪ ɴ ɡ w ɛ ʔ
နိုင်ငံခြားသား	n à ɪ ɴ ɡ à ɴ d͡ʑ á ð à
ဆီးရီးယား	sʰ í ɹ í j á
ကြွ	t͡ɕ w a̰
ဈေးနှုန်း	z é n̥ ó ʊ ɴ
စန္ဒီ	s à ɴ d ì
တော်လှန်ရေး	t ɔ̀ l̥ à ɴ j é
ဝေဒနာ	w è d ə n à
အဖျား	ʔ ə pʰ j á
အဝင်	ʔ ə w ɪ̀ ɴ
ကျင်ချောင်း	t͡ɕ ɪ̀ ɴ t͡ɕʰ á ʊ ɴ
အရည်	ʔ ə j ì
ပင်စင်စား	p ɪ̀ ɴ s ɪ̀ ɴ s á
တို	t ò
ဆေးတံ	sʰ é d à ɴ
စက္ကရီတေရီ	s ɛ ʔ k ə ɹ ì t è j ì
နှာခေါင်းပေါက်	n̥ ə kʰ á ʊ ɴ b a ʊ ʔ
လယ်	l ɛ̀
မဲဆန္ဒရှင်	m ɛ́ sʰ à ɴ d a̰ ʃ ɪ̀ ɴ
မဟာလတာ	m ə h à l ə t à
ဆူ	sʰ ù
ဟွန်ဒူးရပ်စ်	h ʊ̀ ɴ d ú ɹ a ʔ s
အရုဏ်	ʔ ə j ù n
ဖျင်ဖျင်	pʰ j ɪ̀ ɴ b j ɪ̀ ɴ
လူတော	l ù d ɔ́
ယုဂ်	j o ʊ ʔ
ဂရိတ်ဗြိတိန်	ɡ ə ɹ e ɪ ʔ b j ḭ t è ɪ ɴ
သိရှိ	θ ḭ ʃ ḭ
လက်ထပ်	l ɛ ʔ tʰ a ʔ
မျက်ရည်	m j ɛ ʔ j è
ကကြီး	k a̰ d͡ʑ í
ရဲဘော်	j ɛ́ b ɔ̀
အားနာ	ʔ á n à
ရထား	j ə tʰ á
သဝဏ်လွှာ	θ ə w ʊ̀ ɴ l̥ w à
ဟင့်အင်း	h ɪ̰ ɴ ʔ ɪ́ ɴ
ချက်သမ္မတ	t͡ɕʰ ɛ ʔ θ ə m ə d a̰
ချာတိတ်	t͡ɕʰ à t e ɪ ʔ
ကျား	t͡ɕ á
ခံယူချက်	kʰ à ɴ j ù d͡ʑ ɛ ʔ
ပီဇာ	p ì z à
ဂေဟဗေဒ	ɡ è h a̰ t a̰ b è d a̰
အဖွဲ့	ʔ ə pʰ w ɛ̰
နိုး	n ó
ပျားတူ	b a̰ d ù
လုပ်ငန်း	l o ʊ ʔ ŋ á ɴ
ပခုံး	p ə kʰ ó ʊ ɴ
အပြာ	ʔ ə p j à
ကြငှန်း	t͡ɕ ə ŋ̊ á ɴ
ဂီတာ	ɡ ì t à
သစ်သစ်	θ ɪ ʔ θ ɪ ʔ
ပီတိ	p ì t ḭ
ကြက်ဆီထမင်း	t͡ɕ ɛ ʔ sʰ ì tʰ ə m ɪ́ ɴ
ပြည်ကြီးငါး	p j ì d͡ʑ í ŋ á
ဒု	d ṵ
ခေါင်းအုံး	ɡ á ʊ ɴ ʔ ó ʊ ɴ
နိုဝင်ဘာ	n ò w ɪ̀ ɴ b à
မောင်	m à ʊ ɴ
ဗျုပ္ပတ်	b j o ʊ ʔ p a ʔ
ဆက်	sʰ ɛ ʔ
ဝဏ္ဏ	w ʊ̀ ɴ n a̰
အကြံ	ʔ ə t͡ɕ à ɴ
အယူ	ʔ ə j ù
တံပိုး	d ə b ó
သစ်ပုပ်	θ ɪ ʔ p o ʊ ʔ
အင်ဒိုနီးရှား	ʔ ɪ̀ ɴ d ò n í ʃ á
သန်လျက်	θ à ɴ j ɛ ʔ
တိုးတက်ခြင်း	t ó t ɛ ʔ d͡ʑ ɪ̀ ɴ
မြင်းကျား	m j ɪ́ ɴ d͡ʑ á
ပုဆိုး	p ə sʰ ó
စင်ကာပူ	s ɪ̀ ɴ ɡ ə p ù
ဥရုဂ္ဝေး	ʔ ṵ ɹ ù ɡ w é
အန်တီ	ʔ à ɴ t ì
ဆွယ်တာ	sʰ w ɛ̀ t à
ဘူမိဗေဒ	b ù m ḭ b è d a̰
လှပ်လှပ်	l̥ a ʔ l̥ a ʔ
အတိတ်	ʔ ə t e ɪ ʔ
ကျွန်	t͡ɕ ʊ̀ ɴ
လှုံ	l̥ ò ʊ ɴ
ခေါက်ဆွဲသုပ်	kʰ a ʊ ʔ sʰ w ɛ́ θ o ʊ ʔ
ဥပုသ်	ʔ ṵ b o ʊ ʔ
ပန်းတမော့	p á ɴ d ə m ɔ̰
လိပ်ကျောက်	l e ɪ ʔ t͡ɕ a ʊ ʔ
လေ	l è
ခွာ	kʰ w à
မဟာယာန	m ə h à j à n a̰
ကုသိုလ်ရှင်	k ṵ θ ò ʃ ɪ̀ ɴ
ခန်တမာ	kʰ à ɴ t ə m à
တူနီးရှား	t ù n í ʃ á
မည်	m j ì
သရက်ရွက်	θ ə j ɛ ʔ j w ɛ ʔ
ဗလ	b ə l a̰
လေအေးစက်	l è ʔ é z ɛ ʔ
ရတနာ	j ɛ̀ d ə n à
ရဲစခန်း	j ɛ́ s ə kʰ á ɴ
စားစရာ	s á z ə j à
အမျိုး	ʔ ə m j ó
တြိ	t ə ɹ ḭ
ကပ်	k a ʔ
သုတ	θ ṵ t a̰
ထုံးစံ	tʰ ó ʊ ɴ z à ɴ
ပန်းယွန်း	p á ɴ j ʊ́ ɴ
အဓိဌာန်	ʔ ə d e ɪ ʔ tʰ à ɴ
လိုက်	l a ɪ ʔ
ဂါဘွန်	ɡ à b ʊ̀ ɴ
အချို	ʔ ə t͡ɕʰ ò
ဂန်ဒူး	ɡ à ɴ d ú
ဟောက်	h a ʊ ʔ
အော့အန်	ʔ ɔ̰ ʔ à ɴ
တယ်လီဗီးရှင်း	t ɛ̀ l ì b í ʃ ɪ́ ɴ
ကိုရီးယား	k ò ɹ í j á
ဗြဟ္မစိုရ်တရား	b j ə m ə z ò j t ə j á
ပိုက်	p a ɪ ʔ
တန်ဇေးနီးယား	t à ɴ z é n í j á
အသိပညာ	ʔ ə θ ḭ p j ɪ̀ ɴ ɲ à
အာစရိယ	ʔ à s a̰ ɹ ḭ j a̰
မလေးရှား	m ə l é ʃ á
ချင်	t͡ɕʰ ɪ̀ ɴ
တရုတ်	t ə j o ʊ ʔ
သုခ	θ ṵ kʰ a̰
ဘုဉ်းပေး	b ó ʊ ɴ p é
အထိန်း	ʔ ə tʰ é ɪ ɴ
သီတင်း	ð ə d ɪ́ ɴ
ကြွေး	t͡ɕ w é
အတွင်းတာရာ	ʔ ə t w ɪ́ ɴ t à j à
ဂရိ	ɡ ə ɹ ḭ
မာလကာသီး	m à l ə k à θ í
လက်သည်	l ɛ ʔ θ ɛ̀
ဘဲ	b ɛ́
ခုခံအားကျရောဂါ	kʰ ṵ ɡ à ɴ ʔ á t͡ɕ a̰ j ɔ́ ɡ à
ညီလာခံ	ɲ ì l à ɡ à ɴ
ဗိုလ်ချုပ်	b ò d͡ʑ o ʊ ʔ
ပရိုဂျက်	p ə ɹ ò d͡ʑ ɛ ʔ
ဘင်္ဂလားဒေ့ရှ်	b ɪ̀ ɴ l á d ḛ ʃ
သတို့သမီး	ð ə d o̰ θ ə m í
ခြေနင်း	t͡ɕʰ è n ɪ́ ɴ
သစ္စာ	θ ɪ ʔ s à
ခေါ်	kʰ ɔ̀
ဝရန်တာ	w ə ɹ à ɴ d à
အမျိုးသားနေ့	ʔ ə m j ó ð á n ḛ
ရူပ	j ù p a̰
ပီကင်း	p ì k ɪ́ ɴ
ငရဲကြီးရှစ်ထပ်	ŋ ə j ɛ́ d͡ʑ í ʃ ɪ ʔ tʰ a ʔ
ဖခင်	pʰ a̰ ɡ ɪ̀ ɴ
ဘယ်ရီလီယမ်	b ɛ̀ ɹ ì l ì j à ɴ
အာယုဗ္ဗေဒ	ʔ à j o ʊ ʔ b è d a̰
ဒေါ်လေး	d ɔ̀ l é
ဗေ့စဘော	b ḛ s ə b ɔ́
အပွင့်	ʔ ə p w ɪ̰ ɴ
မိ	m ḭ
ဟယ်လီကော့ပတာ	h ɛ̀ l ì k ɔ̰ p ə t à
တန	t a̰ n a̰
ဟေတီ	h è t ì
အိပ်ရာ	ʔ e ɪ ʔ j à
အညစ်အကြေး	ʔ ə ɲ ɪ ʔ ʔ ə t͡ɕ é
ကူလီ	k ù l ì
လမု	l ə m ṵ
ကော်လာ	k ɔ̀ l à
ဗိုလ်မှူးကြီး	b ò m̥ ú d͡ʑ í
နှင့်	n̥ ɪ̰ ɴ
ပွေး	p w é
အပြာကား	ʔ a̰ p j à k á
အထက်သား	ʔ ə tʰ ɛ ʔ ð á
ဝယ်	w ɛ̀
အရီးကြီး	ʔ ə j í d͡ʑ í
ပတ်စပို့	p a ʔ s ə p o̰
ဗို့	b o̰
ကထိန်	k ə tʰ è ɪ ɴ
ညနေခင်း	ɲ a̰ n è ɡ ɪ́ ɴ
တစ်ပင်တိုင်မင်းသမီး	d ə b ɪ̀ ɴ d à ɪ ɴ m ɪ́ ɴ ð ə m í
စတုရန်း	s ə t ṵ j á ɴ
ဆော့ဖ်ဝဲလ်	sʰ a ʊ ʔ w ɛ́
အရှိန်	ʔ ə ʃ è ɪ ɴ
ပသျှူး	p ə ʃ ú
နဂါး	n ə ɡ á
သင်ကြား	θ ɪ̀ ɴ t͡ɕ á
အတောင်	ʔ ə t à ʊ ɴ
စပျစ်သီး	z ə b j ɪ ʔ θ í
ဆစ်ဒနီ	sʰ ɪ ʔ d ə n ì
ပညာရှင်	p j ɪ̀ ɴ ɲ à ʃ ɪ̀ ɴ
အတွင်း	ʔ ə t w ɪ́ ɴ
လမ်း	l á ɴ
ဝင်း	w ɪ́ ɴ
အမာ	ʔ a̰ m à
စမူဆာ	s ə m ù z à
ဟလဝါ	h a̰ l a̰ w à
အသိတရား	ʔ ə θ ḭ t ə j á
စကြာဝဠာဗေဒ	s ɛ ʔ t͡ɕ à w ə l à b è d a̰
ဘတ်ဂျက်	b a ʔ d͡ʑ ɛ ʔ
ထာဝရဥစ္စာ	tʰ à w ə j a̰ ʔ o ʊ ʔ s à
ဘူတာရုံ	b ù d à j ò ʊ ɴ
အထုပ်	ʔ ə tʰ o ʊ ʔ
ခေါင်းလျှော်ရည်	ɡ á ʊ ɴ ʃ ɔ̀ j è
ဟူ	h ù
အမျှင်	ʔ ə m̥ j ɪ̀ ɴ
မနုဿီဟ	m ə n o ʊ ʔ θ ì h a̰
ပင်လယ်	p ɪ̀ ɴ l ɛ̀
ဟင်းရည်	h ɪ́ ɴ j è
ပါးစပ်	p ə z a ʔ
ကော်ဖီ	k ɔ̀ pʰ ì
သာဝတ္ထိ	θ à w ʊ ʔ tʰ ḭ
ကြာဆံသုပ်	t͡ɕ à z à ɴ θ o ʊ ʔ
အရွယ်ဆယ်ပါး	ʔ ə j w ɛ̀ sʰ ɛ̀ b á
ကြက်သွန်ဖြူ	t͡ɕ ɛ ʔ θ ʊ̀ ɴ b j ù
ပဏ္ဍိတ	p à n d ḭ t a̰
ကုသိုလ်	k ṵ θ ò
ဗြိတိန်	b j ḭ t è ɪ ɴ
ထောက်	tʰ a ʊ ʔ
နိစ္စ	n è s a̰
ခုံတန်းလျား	kʰ ò ʊ ɴ t á ɴ j á
မိန်းမ	m é ɪ ɴ m a̰
ပတ္ထနာ	p ə tʰ ə n à
လှေ	l̥ è
ဦးစင်း	ʔ ú ' z ɪ́ ɴ
ရိုင်ရိုင်	j à ɪ ɴ j à ɪ ɴ
ငြာ	ɲ à
သိုး	θ ó
ဒီနေ့	d ì n ḛ
မောင်တော	m à ʊ ɴ t ɔ́
လက်နက်	l ɛ ʔ n ɛ ʔ
ခေါပုတ်	kʰ ɔ́ b o ʊ ʔ
ဥတ္တရ	ʔ o ʊ ʔ t ə j a̰
ပိုးလောင်း	p ó l á ʊ ɴ
ကျ	t͡ɕ a̰
အနုရာဓပူရ	ʔ ə n ṵ j à d a̰ p ù ɹ a̰
ရောဂါဗေဒ	j ɔ́ ɡ à b è d a̰
ကြီး	t͡ɕ í
ညှင်း	ɲ̊ ɪ́ ɴ
အူမကြီး	ʔ ù m a̰ d͡ʑ í
လမုန့်	l a̰ m o̰ ʊ ɴ
ဗညား	b ə ɲ á
အရှင်	ʔ ə ʃ ɪ̀ ɴ
နှင်း	n̥ ɪ́ ɴ
ထင်း	tʰ ɪ́ ɴ
ကျွဲ	t͡ɕ w ɛ́
သူရဲ	θ ə j ɛ́
အီကွေဒေါ	ʔ ì k w è d ɔ́
ဓလေ့	d ə l ḛ
နှေး	n̥ é
စိတ်	s e ɪ ʔ
စံပယ်	z ə b ɛ̀
မင်္ဂလာ	m ɪ̀ ɴ ɡ ə l à
နယူးယောက်	n ə j ú j a ʊ ʔ
မတ်မတ်	m a ʔ m a ʔ
အဘွား	ʔ ə pʰ w á
လေး	l é
တိမ်	t è ɪ ɴ
ဒီမှာ	d ì m̥ à
ကျန်း	t͡ɕ á ɴ
ခရစ္စမတ်	kʰ ə ɹ ɪ ʔ s ə m a ʔ
ကျွန်းကလေး	t͡ɕ ʊ́ ɴ ɡ ə l é
အတူ	ʔ ə t ù
ချိုချဉ်	t͡ɕʰ ò t͡ɕʰ ɪ̀ ɴ
ဝစ်ရှင်နရီ	w ɪ ʔ ʃ ɪ̀ ɴ n ə ɹ ì
နိယာမ	n ḭ j à m a̰
စမ်း	s á ɴ
ငါးဖန်ခွက်	ŋ ə pʰ à ɴ ɡ w ɛ ʔ
အက်တမ်	ʔ ɛ ʔ t à ɴ
အရေပြား	ʔ ə j è b j á
ပီကေ	p ì k è
မယ်	m ɛ̀
အကျဉ်းထောင်	ʔ ə t͡ɕ ɪ́ ɴ d à ʊ ɴ
ခါး	kʰ á
သဉ္ဇာ	θ ɪ̀ ɴ z à
တင်ပါ့ဘုရား	t ɪ̀ ɴ b a̰ pʰ ə j á
ပြည့်တန်ဆာ	p j ḭ d ə z à
ကာယကံ	k à j ə ɡ à ɴ
ပုစ္ဆာ	p o ʊ ʔ sʰ à
ပသီ	p ə θ ì
ဘီယာ	b ì j à
အဆီ	ʔ ə sʰ ì
စစ်တွေ	s ɪ ʔ t w è
မြက်ခြောက်	m j ɛ ʔ t͡ɕʰ a ʊ ʔ
လှော်ကား	l̥ ɔ̀ ɡ á
နဝရူပ	n a̰ w a̰ j ù p a̰
ကတွတ်ယို	k ə d ʊ ʔ j ò
အတိုင်ပင်ခံ	ʔ ə t à ɪ ɴ b ɪ̀ ɴ ɡ à ɴ
စို	s ò
နေ့လယ်စာ	n ḛ l ɛ̀ z à
ဆရာမ	sʰ ə j à m a̰
ဂေါတမ	ɡ ɔ́ t ə m a̰
ဇူလိုင်	z ù l à ɪ ɴ
ဉာဏ်ပူဇော်ခ	ɲ à n p ù z ɔ̀ kʰ a̰
အာဏာရှင်	ʔ à n à ʃ ɪ̀ ɴ
အီရီထရီးယား	ʔ ì ɹ ì tʰ ə ɹ í j á
ချော်	t͡ɕʰ ɔ̀
ကြက်သား	t͡ɕ ɛ ʔ θ á
ကသည်း	k ə θ í
ဘဟားမား	b a̰ h á m á
ကူး	k ú
ရွတ်ရွတ်	j ʊ ʔ j ʊ ʔ
သလိပ်	θ ə l e ɪ ʔ
လက္ခဏာ	l ɛ ʔ kʰ ə n à
စော	s ɔ́
နက္ခတ္တဗေဒ	n ɛ ʔ kʰ ə t a̰ b è d a̰
ပလပ်စတစ်	p ə l a ʔ s ə t ɪ ʔ
ရတနာသုံးပါး	j ɛ̀ d ə n à θ ó ʊ ɴ b á
မဟာမိတ်	m ə h à m e ɪ ʔ
မာ	m à
အချို့	ʔ ə t͡ɕʰ o̰
ကွန်ပါ	k ʊ̀ ɴ p à
ဆီးအောင့်ရောဂါ	sʰ í ʔ a̰ ʊ ɴ j ɔ́ ɡ à
စွန်ကုပ်	s ʊ̀ ɴ ɡ o ʊ ʔ
ချယ်ရီ	t͡ɕʰ ɛ̀ ɹ ì
ကာဂစ်စတန်	k ə ɡ ɪ ʔ s ə t à ɴ
ကဝေ	k ə w è
တင်းထိမ်	t ɪ́ ɴ d è ɪ ɴ
ဟင်း	h ɪ́ ɴ
ရေခွက်	j è ɡ w ɛ ʔ
မျှော်	m̥ j ɔ̀
လစ်	l ɪ ʔ
အကောက်	ʔ ə k a ʊ ʔ
ကြာသပတေး	t͡ɕ à θ a̰ p a̰ d é
ဒါပါပဲ	d à b à b ɛ́
သင်္ဂဟတရားလေးပါး	θ ɪ̀ ɴ ɡ a̰ h a̰ t a̰ j á l é p á
သင်္ကဒူး	θ ɪ́ ɴ ɡ ə d ú
ကျောင်း	t͡ɕ á ʊ ɴ
ပလောင်	p ə l à ʊ ɴ
တပ်ကြပ်ကြီး	t a ʔ t͡ɕ a ʔ t͡ɕ í
သမင်မ	θ ə m ɪ̀ ɴ m a̰
ဗဟုသုတ	b ə h ṵ θ ṵ t a̰
တံစဉ်း	d ə z ɪ́ ɴ
ညစာ	ɲ a̰ z à
နဖူး	n a̰ pʰ ú
အဇာဘိုင်ဂျန်	ʔ a̰ z ə b à ɪ ɴ d͡ʑ à ɴ
ပတ္တလား	p a ʔ t a̰ l á
နှစ်ဆန်းတစ်ရက်နေ့	n̥ ɪ ʔ sʰ á ɴ t ə j ɛ ʔ n ḛ
ကြက်သွန်	t͡ɕ ɛ ʔ θ ʊ̀ ɴ
ယိုးဒယား	j ó d ə j á
စွမ်းအင်	s w á ɴ ʔ ɪ̀ ɴ
မည်သည်	m ì ð ì
အသော	ʔ ə θ ɔ́
နှုတ်ခမ်း	n̥ o ʊ ʔ kʰ á ɴ
ငါးပိထောင်း	ŋ á p ḭ tʰ á ʊ ɴ
သရုပ်	θ ə j o ʊ ʔ
ဇီဝကမ္မဗေဒ	z ì w a̰ k à ɴ m a̰ b è d a̰
ကိုးကန့်	k ó ɡ a̰ ɴ
တောင်းပန်	t á ʊ ɴ b à ɴ
လည်ပင်းကြီးရောဂါ	l ì b ɪ́ ɴ d͡ʑ í j ɔ́ ɡ à
မလုပ်တာနီ	m ə l o ʊ ʔ t à n ì
ဟိန္ဒူ	h è ɪ ɴ d ù
လဟု	l ə h ṵ
ခု	kʰ ṵ
နမီးဘီးယား	n a̰ m í b í j á
ရူပဗေဒ	j ù p a̰ b è d a̰
သရဖူ	θ ə ɹ ə pʰ ù
ကမ္ဘာဂြိုဟ်	ɡ ə b à d͡ʑ ò
ပြာ	p j à
အာဟာရ	ʔ à h à j a̰
မာန်အောင်	m à n ʔ à ʊ ɴ
ပါဆယ်	p à sʰ ɛ̀
ခင်မင်မှု	kʰ ɪ̀ ɴ m ɪ̀ ɴ m̥ ṵ
ကျပ်	t͡ɕ a ʔ
သုည	θ ò ʊ ɴ ɲ a̰
ဒွယံဒွယံ	d w a̰ j à ɴ d w a̰ j à ɴ
ဆီ	sʰ ì
လက်ဆွဲသေတ္တာ	l ɛ ʔ sʰ w ɛ́ θ ɪ ʔ t à
မာလကာ	m à l ə k à
ကျို	t͡ɕ ò
အသုံး	ʔ ə θ ó ʊ ɴ
ကျောက်ဖြူ	t͡ɕ a ʊ ʔ pʰ j ù
မာတိကာ	m à t ḭ k à
ဗုဒ္ဓသာသနာ	θ à ð ə n à
အစီရင်ခံစာ	ʔ ə s ì j ɪ̀ ɴ kʰ à ɴ z à
ကင်း	k ɪ́ ɴ
အပြင်	ʔ ə p j ɪ̀ ɴ
ထိုင်ခုံ	tʰ à ɪ ɴ ɡ ò ʊ ɴ
တြိဂံ	t ɹ ḭ ɡ à ɴ
ဇလဗေဒ	z ə l a̰ b è d a̰
သီလရှင်	θ ì l a̰ ʃ ɪ̀ ɴ
ဖုန်စုပ်စက်	pʰ ò ʊ ɴ s o ʊ ʔ s ɛ ʔ
မြည်း	m j í
ဗုဒ္ဓဘာသာ	b o ʊ ʔ d a̰ b à θ à
သတ္တု	θ a ʔ t ṵ
သိဒ္ဓတ္ထ	θ e ɪ ʔ d a ʔ tʰ a̰
မြေပုံသီး	m j è b ò ʊ ɴ ð í
နီတိ	n ì t ḭ
နန်း	n á ɴ
အဏ္ဏဝါ	ʔ à ɴ n ə w à
ဝက်သားမျှစ်ချဉ်	w ɛ ʔ θ á m̥ j ɪ ʔ t͡ɕʰ ɪ̀ ɴ
မြင်	m j ɪ̀ ɴ
ဆိတ်	sʰ e ɪ ʔ
စစ်	s ɪ ʔ
ဇာတိ	z à t ḭ
ရေသူမ	j è ð ù m a̰
ကြိမ်	t͡ɕ è ɪ ɴ
ပြဌာန်း	p j a̰ tʰ á ɴ
ကြွေ	t͡ɕ w è
သီတာဒေဝီ	θ ì d à d è w ì
သခွားမသီး	θ ə kʰ ə m a̰ ð í
ကြက်တူရွေး	t͡ɕ ɛ ʔ t ù j w é
အသင်း	ʔ ə θ ɪ́ ɴ
ဒူးလေး	d ú l é
သစ်ပင်	θ ɪ ʔ p ɪ̀ ɴ
တင့်ကား	t ɪ̰ ɴ k á
ပုဏ္ဏား	p ò ʊ ɴ n á
လောင်စာ	l à ʊ ɴ z à
နယ်	n ɛ̀
ဆယ့်နှစ်ရာသီ	sʰ ɛ̰ n̥ ə j à θ ì
သွား	θ w á
အမဲသား	ʔ ə m ɛ́ ð á
စင်စင်	s ɪ̀ ɴ z ɪ̀ ɴ
လက်ပံ	l ɛ ʔ p à ɴ
ဖြော်ဖြော်	pʰ j ɔ̀ b j ɔ̀
နနွင်း	sʰ ə n w ɪ́ ɴ
ကျုပ်	t͡ɕ o ʊ ʔ
ဘုန်းကြီးပျံ	pʰ ó ʊ ɴ d͡ʑ í b j à ɴ
စားချဉ့်ပြန်	s ə t͡ɕʰ ɪ̰ ɴ p j à ɴ
လည်	l è
ဖိလစ်ပိုင်	pʰ ḭ l ɪ ʔ p à ɪ ɴ
ခဲ	kʰ ɛ́
သီတာ	θ ì d à
ဖိနပ်	pʰ ə n a ʔ
ပုတ်သင်ညို	p o ʊ ʔ θ ɪ̀ ɴ ɲ ò
မြွေ	m w è
ဗောဓိညောင်	b ɔ́ d ḭ ɲ à ʊ ɴ
သတ္တုဗေဒ	θ a ʔ t ṵ b è d a̰
တိုင်းရင်းသား	t á ɪ ɴ j ɪ́ ɴ ð á
ကြော်ငြာစာ	t͡ɕ ɔ̀ ɲ à z à
နင်တို့	n ɪ̀ ɴ d o̰
သရီရ	θ ə ɹ ì ɹ a̰
ဗျည်း	b j í
စူးစူး	s ú z ú
အမဲလိုက်	ʔ ə m ɛ́ l a ɪ ʔ
ပညာ	p j ɪ̀ ɴ ɲ à
ဒွိ	d w ḭ
ဆေး	sʰ é
ဘင်နာ	b ɪ̀ ɴ n à
ခေါင်းလောင်း	kʰ á ʊ ɴ l á ʊ ɴ
နားကြပ်	n ə d͡ʑ a ʔ
မင်္ဂလသုတ်	m ɪ̀ ɴ ɡ ə l a̰ θ o ʊ ʔ
ခတ္တိယ	kʰ a ʔ t ḭ j a̰
ဆာဂျင်	sʰ à d͡ʑ ɪ̀ ɴ
ဂဏန်းတွက်စက်	ɡ ə n á ɴ t w ɛ ʔ s ɛ ʔ
အိမ်မြှောင်	ʔ è ɪ ɴ m̥ j à ʊ ɴ
မီးခေါင်း	m í ɡ á ʊ ɴ
မျှို့	m̥ j o̰
ကြက်	t͡ɕ ɛ ʔ
ခေါက်ဆွဲဆိုင်	kʰ a ʊ ʔ sʰ w ɛ́ z à ɪ ɴ
ဇနပုဒ်	z ə n ə p o ʊ ʔ
ခြင်္သေ့ကလေး	t͡ɕʰ ɪ̀ ɴ ð ḛ ɡ ə l é
ပိတ်	p e ɪ ʔ
ဘု	b ṵ
ချက်ကြိုး	t͡ɕʰ ɛ ʔ t͡ɕ ó
နတ်တော်	n ə d ɔ̀
မိငယ်	m ḭ ŋ ɛ̀
ကျမ	t͡ɕ ə m a̰
သုံးဆယ်	θ ó ʊ ɴ sʰ ɛ̀
သုသာန်	θ o ʊ ʔ θ à ɴ
မဟာ	m a̰ h à
ဒန်ပူ	d ə b ù
အစ	ʔ ə s a̰
ကျည်ဖူး	t͡ɕ ì b ú
မိုက်ကယ်	m a ɪ ʔ k ɛ̀
မြင်းမိုရ်	m j ɪ́ ɴ m ò
ကြယ်သီး	t͡ɕ ɛ̀ θ í
မှန်ပါ့ဘုရား	m̥ à ɴ b a̰ pʰ ə j á
မီးသီး	m í θ í
တိုက်ပွဲ	t a ɪ ʔ p w ɛ́
သူရိယမာသ	θ ù ɹ ḭ j a̰ m à θ a̰
အခွင့်အရေး	ʔ ə kʰ w ɪ̰ ɴ ʔ ə j é
အသားဝါရောဂါ	ʔ a̰ θ á w à j ɔ́ ɡ à
ဂိုင်ယာနာ	ɡ à ɪ ɴ j à n à
တတ်	t a ʔ
ကဆုန်လပြည့်နေ့	k ə sʰ ò ʊ ɴ l a̰ p j ḭ n ḛ
ဂေါက်	ɡ a ʊ ʔ
အသျှင်	ʔ ə ʃ ɪ̀ ɴ
အနွယ်	ʔ ə n w ɛ̀
မိတ္ထီလာ	m e ɪ ʔ tʰ ì l à
ဝန်စည်စလယ်	w ʊ̀ ɴ z ì z ə l ɛ̀
ပြေး	p j é
ကာမ	k à m a̰
ကြော်	t͡ɕ ɔ̀
ဇင်းမယ်	z ɪ́ ɴ m ɛ̀
မေဃာလယ	m è ɡ à l ə j a̰
ဝန်	w ʊ̀ ɴ
ပထမဘွဲ့	p a̰ tʰ ə m a̰ b w ɛ̰
စာအုပ်	s à ʔ o ʊ ʔ
ငါ	ŋ à
ဝေလ	w è l a̰
ဂီနီ	ɡ ì n ì
ပေါ့	p ɔ̰
ဓမ္မ	d ə m a̰
အစဉ်	ʔ ə s ɪ̀ ɴ
ဘုရားကိုးဆူ	b ṵ j á k ó sʰ ù
သတင်းစာဆရာ	ð ə d ɪ́ ɴ z à sʰ ə j à
နည်းနည်း	n ɛ́ n ɛ́
မယ်တော်	m ɛ̀ d ɔ̀
မိုးကာအင်္ကျီ	m ó ɡ à ʔ ɪ̀ ɴ d͡ʑ ì
အဖျားဖြတ်ဆေး	ʔ a̰ pʰ j á pʰ j a ʔ sʰ é
မိုး	m ó
ဆိုက်	sʰ a ɪ ʔ
မှန်စီရွှေချ	m̥ à ɴ z ì ʃ w è t͡ɕʰ a̰
ရုရု	j ṵ j ṵ
သင်္ကြန်	θ ɪ́ ɴ d͡ʑ à ɴ
ကြက်အူချောင်း	t͡ɕ ɛ ʔ ʔ ù d͡ʑ á ʊ ɴ
ဆလိုဗားကီးယား	sʰ ə l ò b á k í j á
ပန်းသေးခေါက်ဆွဲ	p á ɴ θ é kʰ a ʊ ʔ sʰ w ɛ́
မနက်ဖြန်	m ə n ɛ ʔ pʰ j à ɴ
ဥဂ္ဂါ	ʔ ṵ ɡ ɡ à
ဈာန်	z à n
မြီ	m j ì
အီစတာ	ʔ ì s ə t à
မျက်နှာသုတ်ပဝါ	m j ɛ ʔ n̥ à θ o ʊ ʔ p a̰ w à
သဒ္ဒါ	ð ə d à
ကြွက်နို့	t͡ɕ w ɛ ʔ n o̰
ဖယောင်း	pʰ ə j á ʊ ɴ
မလိုင်	m a̰ l à ɪ ɴ
ကြေးဝါ	t͡ɕ é w à
ကြက်ဆင်	t͡ɕ ɛ ʔ sʰ ɪ̀ ɴ
နွေရာသီ	n w è j à ð ì
လို	l ò
လင်	l ɪ̀ ɴ
ငရဲ	ŋ ə j ɛ́
ကြား	t͡ɕ á
မောင်နှမ	m à ʊ ɴ n̥ ə m a̰
နမ်း	n á ɴ
လိင်ပညာ	l è ɪ ɴ p j ɪ̀ ɴ ɲ à
ရုံ	j ò ʊ ɴ
ရတီ	j ə t ì
ဆီချက်ခေါက်ဆွဲ	sʰ ì d͡ʑ ɛ ʔ kʰ a ʊ ʔ sʰ w ɛ́
လယ်ပြင်	l ɛ̀ b j ɪ̀ ɴ
ချစ်ခင်	t͡ɕʰ ɪ ʔ kʰ ɪ̀ ɴ
ကလမောင်း	k ə l ə m á ʊ ɴ
နီ	n ì
ဘုံကျောင်း	b ò ʊ ɴ d͡ʑ á ʊ ɴ
ဒစ္စကို	d ɪ ʔ s a̰ k ò
အကိုင်း	ʔ ə k á ɪ ɴ
ရွှေကြည်	ʃ w è d͡ʑ ì
သီးသီး	θ í ð í
ဝင်	w ɪ̀ ɴ
ယီမင်	j ì m ɪ̀ ɴ
အလုပ်ရှင်	ʔ ə l o ʊ ʔ ʃ ɪ̀ ɴ
ဥက္ကဌ	ʔ o ʊ ʔ k ə θ a̰
သောကြာဂြိုဟ်	θ a ʊ ʔ t͡ɕ à d͡ʑ ò
မုန်ညင်းဖြူ	m ò ʊ ɴ ɲ ɪ́ ɴ pʰ j ù
ဗျူရို	b j ù ɹ ò
ဒူးဝါး	d ú w á
အတွင်းခံ	ʔ ə t w ɪ́ ɴ ɡ à ɴ
ဝှက်	ʍ ɛ ʔ
ကျွန်တော်	t͡ɕ ʊ̀ ɴ d ɔ̀
တောင်ငူ	t à ʊ ɴ ŋ ù
မယ်ဇလီ	m ɛ̀ z ə l ì
ငှက်ပျောပေါင်း	ŋ̊ ə b j ɔ́ b á ʊ ɴ
လက်ရန်း	l ɛ ʔ j á ɴ
တံခွန်	d ə ɡ ʊ̀ ɴ
ကျေးဇူးတင်	t͡ɕ é z ú t ɪ̀ ɴ
ရေတပ်	j è d a ʔ
မဏိမေခလာ	m ə n ḭ m è kʰ ə l à
မုဆိုးမ	m ṵ sʰ ó m a̰
လပ်	l a ʔ
ပြည်ထောင်စုတော်လှန်ရေးကောင်စီအဖွဲ့	p j ì d à ʊ ɴ z ṵ t ɔ̀ l̥ à ɴ j é k à ʊ ɴ s ì ʔ ə pʰ w ɛ̰
ကြေးစည်	t͡ɕ é z ì
ရည်	j ì
စာ	s à
တီထွင်	t ì tʰ w ɪ̀ ɴ
ဟိုက်ဒရိုဂျင်	h a ɪ ʔ d ə ɹ ò d͡ʑ ɪ̀ ɴ
အတူတူ	ʔ ə t ù d ù
ဆန်း	sʰ á ɴ
ဈေးချို	z é t͡ɕʰ ò
အိမ်နီးချင်း	ʔ è ɪ ɴ n í d͡ʑ ɪ́ ɴ
ခဲယဉ်း	kʰ ɛ́ j ɪ́ ɴ
ကြယ်တံခွန်	t͡ɕ ɛ̀ d ə ɡ ʊ̀ ɴ
နယုန်	n ə j ò ʊ ɴ
ချင်းသုပ်	d͡ʑ ɪ́ ɴ ð o ʊ ʔ
ကြည့်မြင်တိုင်	t͡ɕ ḭ m j ɪ̀ ɴ d à ɪ ɴ
ချူးအင်းဂမ်း	t͡ɕʰ ú ʔ ɪ́ ɴ ɡ á ɴ
နားထင်	n á tʰ ɪ̀ ɴ
ကျန်	t͡ɕ à ɴ
စုပ်	s o ʊ ʔ
ရာသီဥတု	j à ð ì ʔ ṵ d ṵ
သုတ်	θ o ʊ ʔ
နိုင်ငံသားအဖြစ်	n à ɪ ɴ ŋ à ɴ ð á ʔ ə pʰ j ɪ ʔ
ပါရမီ	p à ɹ ə m ì
ပင်လယ်ဓားပြ	p ɪ̀ ɴ l ɛ̀ d ə m j a̰
ချုပ်	t͡ɕʰ o ʊ ʔ
ဖျား	pʰ j á
ဇရပ်	z ə j a ʔ
ဓားပြား	d ə b j á
ကျိုက်မရော	t͡ɕ a ɪ ʔ m ə ɹ ɔ́
အဝါ	ʔ ə w à
အာလယ	ʔ à l ə j a̰
မုန်တိုင်း	m ò ʊ ɴ d á ɪ ɴ
နံနက်	n à ɴ n ɛ ʔ
ဆယ်	sʰ ɛ̀
ဝီကီပီးဒီးယား	w ì k ì p í d í j á
ကောက်ရိုး	k a ʊ ʔ j ó
နိုင်ငံသား	n à ɪ ɴ ŋ à ɴ ð á
ဇနီး	z ə n í
သိကြား	ð ə d͡ʑ á
ရသ	j a̰ ð à
ကျော	t͡ɕ ɔ́
နောက်ကျ	n a ʊ ʔ t͡ɕ a̰
ကယား	k ə j á
ခရီးသည်	kʰ ə j í ð è
ဃကြီး	ɡ a̰ d͡ʑ í
မုန်ညင်းဆီ	m ò ʊ ɴ ɲ ɪ́ ɴ sʰ ì
အထိ	ʔ ə tʰ ḭ
ဘရာဇီး	b ə ɹ à z í
ပြီး	p í
ဆန်ခါ	z ə ɡ à
ကာတွန်း	k à t ʊ́ ɴ
ဝရဏဗေဒ	w ə j ə n a̰ d a̰ b è d a̰
ဘိဘိသန	b ḭ b ḭ θ ə n a̰
သောကြာ	θ a ʊ ʔ t͡ɕ à
တာဝတိံသာ	t à w a̰ t è ɪ ɴ θ à
အလွန်	ʔ ə l ʊ̀ ɴ
ဟိုမှာ	h ò m̥ à
တောင်ကြား	t à ʊ ɴ d͡ʑ á
ကုန်စည်	k ò ʊ ɴ z ì
သရဲ	θ ə j ɛ́
အင်တာဗျူး	ʔ ɪ̀ ɴ t ə b j ú
အမေရိကန်ပြည်ထောင်စု	ʔ ə m è ɹ ḭ k à ɴ p j ì d à ʊ ɴ z ṵ
နာမဝိသေသန	n à m a̰ w ḭ θ è θ ə n a̰
ဘဝ	b a̰ w a̰
သံချေး	θ à ɴ d͡ʑ í
ပဲမှုန့်	p ɛ́ m̥ o̰ ʊ ɴ
ကြက်ဆူ	t͡ɕ ɛ ʔ sʰ ù
ဝိဇ္ဇာ	w e ɪ ʔ z à
အိမ်သူ	ʔ è ɪ ɴ ð ù
ဂေါ်	ɡ ɔ̀
မြင်းသံခွာ	m j ɪ́ ɴ θ à ɴ kʰ w à
လောကဝတ်	l ɔ́ ɡ ə w ʊ ʔ
မာလီ	m à l ì
စိတ်မှတ်	s e ɪ ʔ m̥ a ʔ
အိုး	ʔ ó
သွားဖုံး	θ ə pʰ ó ʊ ɴ
ထည်	tʰ ɛ̀
စစ်ဗိုလ်	s ɪ ʔ b ò
ဥစ္စာ	ʔ o ʊ ʔ s à
ဆိပ်	sʰ e ɪ ʔ
ဘုန်းကြီးကျောင်း	pʰ ó ʊ ɴ d͡ʑ í t͡ɕ á ʊ ɴ
စွေ့စွေ့	s w ḛ z w ḛ
ရေ	j è
အချိုပွဲ	ʔ ə t͡ɕʰ ò b w ɛ́
ဖော်	pʰ ɔ̀
ဥပဓိရုပ်	ʔ ṵ p a̰ d ḭ j o ʊ ʔ
စူပါမားကတ်	s ù p ə m á k a ʔ
ထိပ်စုဖုရား	tʰ e ɪ ʔ s ṵ pʰ ə j á
ကြေး	t͡ɕ é
ဘိုကလေး	b ò ɡ ə l é
နဝမ	n ə w ə m a̰
ပရိုဂရမ်	p ə ɹ ò ɡ ə ɹ à ɴ
ဖဲ	pʰ ɛ́
ရေချိုး	j è t͡ɕʰ ó
ရည်းစား	j í z á
ဒုတိယဗိုလ်ချုပ်ကြီး	d ṵ t ḭ j a̰ b ò d͡ʑ o ʊ ʔ d͡ʑ í
ထောက်ခံ	tʰ a ʊ ʔ kʰ à ɴ
နယူးဒေလီ	n ə j ú d è l ì
ပြည်	p j ì
ဝါဂွမ်း	w à ɡ w á ɴ
မီးသင်္ဘော	m í θ ɪ̀ ɴ b ɔ́
ရာမ	j à m a̰
သတ်	θ a ʔ
ဖက်	pʰ ɛ ʔ
ငါးသလောက်ပေါင်း	ŋ ə θ ə l a ʊ ʔ b á ʊ ɴ
ဓမ္မပါလ	d à ɴ m a̰ p à l a̰
ဟာသ	h à θ a̰
လက်ဖက်ရည်ဆိုင်	l ə pʰ ɛ ʔ j è z à ɪ ɴ
အာဏာ	ʔ à n à
ဒေဝ	d è w a̰
တစ်ရာ	t ə j à
အက်စစ်	ʔ ɛ ʔ s ɪ ʔ
ဦလန်ဘာတာ	ʔ ù l à ɴ b à t à
ပို့	p o̰
အကောင့်	ʔ ə k a̰ ʊ ɴ
ဖျံ	pʰ j à ɴ
ကမာရွတ်	k ə m à j ʊ ʔ
ညောင်းကျရောဂါ	ɲ á ʊ ɴ t͡ɕ a̰ j ɔ́ ɡ à
အမြွှာ	ʔ ə m̥ w à
သံ	θ à ɴ
အမွေး	ʔ ə m w é
အဏုဇီဝဗေဒ	ʔ ə n ṵ z ì w a̰ b è d a̰
ထမနဲ	tʰ a̰ m a̰ n ɛ́
ကျေးဇူးရှင်	t͡ɕ é z ú ʃ ɪ̀ ɴ
အဖေ	ʔ ə pʰ è
ဒုတိယဗိုလ်မှူးကြီး	d ṵ t ḭ j a̰ b ò m̥ ú d͡ʑ í
ဂရမ်	ɡ ə ɹ à ɴ
ဆိုဗီယက်	sʰ ò b ì j ɛ ʔ
မော်စကို	m ɔ̀ s ə k ò
ထံ	tʰ à ɴ
ဝါဆို	w à sʰ ò
ဖောက်	pʰ a ʊ ʔ
တဆေး	t ə sʰ é
ပန်းနာရင်ကျပ်	p á ɴ n à j ɪ̀ ɴ t͡ɕ a ʔ
ကူးစက်ရောဂါ	k ú z ɛ ʔ j ɔ́ ɡ à
အယ်လ်ဂျီးရီးယား	ʔ ɛ̀ l d͡ʑ í ɹ í j á
ကံ	k à ɴ
သောမနဿ	θ ɔ́ m ə n a ʔ θ a̰
တန်ခူး	d ə ɡ ú
ဆွပ်	sʰ ʊ ʔ
ကျွန်တော်တို့	t͡ɕ ʊ̀ ɴ d ɔ̀ d o̰
ဆက္ကဂံ	sʰ ɛ ʔ k ə ɡ à ɴ
ကာယပညာ	k à j a̰ p a̰ ɲ à
သပိတ်	ð ə b e ɪ ʔ
ငူတူတူ	ŋ ù t ù d ù
အညို	ʔ ə ɲ ò
အလှမ်း	ʔ ə l̥ á ɴ
ဒုံးပျံ	d ó ʊ ɴ b j à ɴ
အရာခံဗိုလ်	ʔ ə j à ɡ à ɴ b ò
သိဒ္ဓိ	θ e ɪ ʔ d ḭ
အမေ	ʔ ə m è
ကုလားအုတ်	k ə l ə ʔ o ʊ ʔ
ပြက္ခဒိန်	p j ɛ ʔ ɡ ə d è ɪ ɴ
ဓာတ်ပြား	d a ʔ p j à
မတော်တဆမှု	m ə t ɔ̀ t ə sʰ a̰ m̥ ṵ
ဘိုရွန်	b ò ɹ ʊ̀ ɴ
ဩကာသ	ʔ ɔ́ ɡ à θ a̰
ကောင်းကင်ကြိုး	k á ʊ ɴ ɡ ɪ̀ ɴ d͡ʑ ó
အနှီဟာ	ʔ ə n̥ ì h à
ပွား	p w á
ယူရို	j ù ɹ ò
ဝံ	w ʊ̀ ɴ
ကောင်းကင်တမန်	k á ʊ ɴ ɡ ɪ̀ ɴ t ə m à ɴ
လပို့	l ə b o̰
ကော်ပီ	k ɔ̀ p ì
ဒါ	d à
မျက်တောင်	m j ɛ ʔ t à ʊ ɴ
သွင်သွင်	θ w ɪ̀ ɴ ð w ɪ̀ ɴ
မုတ္ထမ	m o ʊ ʔ t ə m a̰
မလေး	m ə l é
သုဒ္ဓေါဒန	θ ù d d ɔ́ d ə n a̰
ပေါင်မုန့်	p à ʊ ɴ m o̰ ʊ ɴ
သွတ်သွတ်	θ ʊ ʔ θ ʊ ʔ
တိုက်ပုံ	t a ɪ ʔ p ò ʊ ɴ
ပြည်သူ့ဆိုင်	p j ì ð ṵ sʰ à ɪ ɴ
နိုင်ဂျီးရီးယား	n à ɪ ɴ d͡ʑ í ɹ í j á
တာဝန်	t à w ʊ̀ ɴ
သတင်းပို့	ð ə d ɪ́ ɴ p o̰
အတိုး	ʔ ə t ó
ဥတု	ʔ ṵ d ṵ
အက်	ʔ ɛ ʔ
နှာဘူး	n̥ à b ú
သူရ	θ ù j a̰
တောက်တဲ့	t a ʊ ʔ t ɛ̰
ထိမ်းမြား	tʰ é ɪ ɴ m j á
ကော်တွန်	k ɔ̀ t ʊ̀ ɴ
ငှက်ဆိုး	ŋ̊ ɛ ʔ sʰ ó
ဖရုံဆွဲ	pʰ ə j ò ʊ ɴ z w ɛ́
ကောင်း	k á ʊ ɴ
စည်းပုံ	s í b ò ʊ ɴ
ပိုင်း	p á ɪ ɴ
သဲကန္တာရ	θ é ɡ à ɴ d à j a̰
မကိုဋ်	m ə ɡ a ɪ ʔ
မနောကံ	m ə n ɔ́ ɡ à ɴ
ပြတိုက်	p j a̰ d a ɪ ʔ
ကျောက်သင်ပုန်း	t͡ɕ a ʊ ʔ θ ɪ̀ ɴ b ó ʊ ɴ
ကောင်	k à ʊ ɴ
ပြင်းဟုပ်	p j ɪ́ ɴ h o ʊ ʔ
ရင်ခံ	j ɪ̀ ɴ kʰ à ɴ
ကျောက်ဂွမ်း	t͡ɕ a ʊ ʔ ɡ ʊ́ ɴ
ပန်းခြံ	p á ɴ d͡ʑ à ɴ
လူမျိုးရေးဝါဒ	l ù m j ó j é w à d a̰
စာရင်း	s ə j ɪ́ ɴ
ရေကူးကန်	j è k ú ɡ à ɴ
နှမ်းစေ့	n̥ á ɴ z ḛ
မြီးရှေ	m j í ʃ è
ရေတံခွန်	j è d à ɡ ʊ̀ ɴ
ပေါ်တူဂီ	p ɔ̀ t ù ɡ ì
အစည်းအဝေး	ʔ ə s í ʔ ə w é
ခြ	t͡ɕʰ a̰
ကဲ့	k ɛ̰
ဝက်အူ	w ɛ ʔ ʔ ù
ပစ္စည်းလေးပါး	p j ɪ ʔ s í l é b á
နှော	n̥ ɔ́
လက်ဖက်ထုပ်	l ə pʰ ɛ ʔ tʰ o ʊ ʔ
အာကာသစိုး	ʔ à k à θ a̰ z ó
အိုင်ဒီယာ	ʔ à ɪ ɴ d ì j à
တိုက်ခန်း	t a ɪ ʔ kʰ á ɴ
အရုပ်စာ	ʔ ə j o ʊ ʔ s à
ပျစ်	p j ɪ ʔ
ဝှေးစေ့	ʍ é z ḭ
ကီလိုဂရမ်	k ì l ò ɡ ə ɹ à ɴ
မောင်း	m á ʊ ɴ
မျှော်လင့်	m̥ j ɔ̀ l ɪ̰ ɴ
အဏ္ဏဝါဗေဒ	ʔ à n n ə w à b è d a̰
နှစ်	n̥ ɪ ʔ
ဝလာဟကမြင်း	w ə l à h ə k a̰ m j ɪ́ ɴ
ဟောင်း	h á ʊ ɴ
အခွန်	ʔ ə kʰ ʊ̀ ɴ
မတ်	m a ʔ
ကုတ်ဟီးနာ	k o ʊ ʔ h í n à
မော်ရိုကို	m ɔ̀ ɹ ò k ò
ဒဿနဗေဒ	d a̰ θ ə n a̰ b è d a̰
ရုပ်သေး	j o ʊ ʔ θ é
ကျဉ်း	t͡ɕ ɪ́ ɴ
ဆောင်းပါး	sʰ á ʊ ɴ b á
ရှင့်	ʃ ɪ̰ ɴ
ကင်ညာ	k ɪ̀ ɴ ɲ à
နံနက်စာ	n à ɴ n ɛ ʔ s à
ဓာတ်ခဲ	d a ʔ kʰ é
စတု	z ə t ṵ
ဧကရီ	ʔ è k ə j ì
ပြွန်	p j ʊ̀ ɴ
တင်းတင်း	t ɪ́ ɴ t ɪ́ ɴ
ဂျူး	d͡ʑ ú
အင်တာနက်	ʔ ɪ̀ ɴ t à n ɛ ʔ
ပျားရည်	p j á j è
ပြုံယမ်း	p j ò ʊ ɴ j á ɴ
လူမျိုး	l ù m j ó
ပါရီ	p à ɹ ì
ပီရူး	p ì ɹ ú
ဂါနာ	ɡ à n à
ဝိဘတ်	w ḭ b a ʔ
တပေါင်း	d ə b á ʊ ɴ
ကာကွယ်ဆေး	k à ɡ w ɛ̀ z é
ဝက်သား	w ɛ ʔ θ á
အရိုးစု	ʔ ə j ó z ṵ
နွားနို့ခေါက်ဆွဲ	n w á n o̰ kʰ a ʊ ʔ sʰ w ɛ́
သံအမတ်	θ à ɴ ʔ ə m a ʔ
ပြိတ္တာ	p j e ɪ ʔ t à
ကျယ်	t͡ɕ ɛ̀
တုတ်	d o ʊ ʔ
ဝါခေါင်	w à ɡ à ʊ ɴ
ပုံး	p ó ʊ ɴ
ထားဝယ်	d ə w ɛ̀
တေဇော	t è z ɔ́
နယူးဇီလန်	n ə j ú z ì l à ɴ
တယော	t ə j ɔ́
သိဒ္ဓတ်မင်း	θ e ɪ ʔ d a ʔ m ɪ́ ɴ
ဗိုလ်မှူး	b ò m̥ ú
အထက်လွှတ်တော်	ʔ ə tʰ ɛ ʔ l̥ ʊ ʔ t ɔ̀
ဝေဿ	w ɪ ʔ θ a̰
မှုန်	m̥ ò ʊ ɴ
လှည်းကူး	l̥ í k ú
ကောလိပ်	k ɔ́ l e ɪ ʔ
ဆိုင်းဘုတ်	sʰ á ɪ ɴ b o ʊ ʔ
နွားနို့	n w á n o̰
အချိုမှုန့်	ʔ ə t͡ɕʰ ò m̥ o̰ ʊ ɴ
နိုင်ဂျာ	n à ɪ ɴ d͡ʑ à
ခင်ဗျာ	kʰ ə m j à
စကားထာ	z ə ɡ ə tʰ à
နိဒ္ဒေသ	n e ɪ ʔ d è θ a̰
ကူဝိတ်	k ù w e ɪ ʔ
ဒီဗီဒီ	d ì b ì d ì
မံ	m à ɴ
ပို	p ò
ချဉ်	t͡ɕʰ ɪ̀ ɴ
မတော်တဆ	m ə t ɔ̀ t ə sʰ a̰
အနံ့	ʔ ə n a̰ ɴ
လစ်သူယေးနီးယား	l ɪ ʔ θ ù j é n í j á
ပေါင်းဖို	p á ʊ ɴ b ò
မိုးရာသီ	m ó j à ð ì
တား	t á
အလေး	ʔ ə l é
နဒီ	n ə d ì
အိမ်ထောင်ပြု	ʔ è ɪ ɴ d à ʊ ɴ p j ṵ
ယောနိ	j ɔ́ n ḭ
ဒက္ခိဏ	d ɛ ʔ kʰ ḭ n a̰
တင်းနစ်	t ɪ́ ɴ n ɪ ʔ
ကြွက်သား	t͡ɕ w ɛ ʔ θ á
ကော်ရည်ခေါက်ဆွဲ	k ɔ̀ j ì kʰ a ʊ ʔ sʰ w ɛ́
ရုံးပတီ	j ó ʊ ɴ b ə t ì
နန်းမတော်	n á ɴ m ə d ɔ̀
ဘိုက်	b a ɪ ʔ
နှင်းခဲ	n̥ ɪ́ ɴ ɡ ɛ́
ပြာသာဒ်	p j a ʔ θ a ʔ
ပဝေဏီ	p ə w è n ì
နှာ	n̥ à
သံပန်း	θ à ɴ b á ɴ
မုတ်ဆိတ်	m o ʊ ʔ sʰ e ɪ ʔ
ပြုတ်	p j o ʊ ʔ
လေစုန်	l è z ò ʊ ɴ
ဆောင်ပုဒ်	sʰ à ʊ ɴ b o ʊ ʔ
ပီပီ	p ì b ì
သီး	θ í
လှေကား	l̥ è ɡ á
ဥက္ကာခဲ	ʔ o ʊ ʔ k à ɡ ɛ́
ရေပိုက်	j è p a ɪ ʔ
အီးပေါက်	ʔ í p a ʊ ʔ
လီတာ	l ì t à
ကင်မရွန်း	k ɪ̀ ɴ m a̰ ɹ ʊ́ ɴ
ကဖီး	k ə pʰ í
မှုန့်	m̥ o̰ ʊ ɴ
မက္ကဆီကို	m ɛ ʔ k ə sʰ ì k ò
အတွင်းရန်	ʔ ə t w ɪ́ ɴ j à ɴ
သန်တူ	θ à ɴ t ù
ထပ်	tʰ a ʔ
ယွန်းယွန်း	j ʊ́ ɴ j ʊ́ ɴ
ယောဇနာ	j ɔ́ z ə n à
ဘန်ကောက်	b à ɴ k a ʊ ʔ
လျှပ်စစ်ဓာတ်	l̥ j a ʔ s ɪ ʔ d a ʔ
ရန်	j à ɴ
ရောင်း	j á ʊ ɴ
အင်္ဂလန်	ʔ ɪ̀ ɴ ɡ ə l à ɴ
ငယ်	ŋ ɛ̀
ဘော့ဆွာနာ	b ɔ̰ sʰ w à n à
စုပ်စုပ်	s o ʊ ʔ s o ʊ ʔ
ဂျင်းဘောင်းဘီ	d͡ʑ ɪ́ ɴ b á ʊ ɴ b ì
ဇီဝဓာတုဗေဒ	z ì w a̰ d à t ṵ b è d a̰
ခကွေး	kʰ a̰ ɡ w é
နည်းပညာ	n í p j ɪ̀ ɴ ɲ à
ပန်းစည်း	p á ɴ z í
တံမြက်စည်း	d ə b j ɛ ʔ s í
မိဘ	m ḭ b a̰
လုံချည်	l ò ʊ ɴ d͡ʑ ì
ငါးပေါင်းထုပ်	ŋ ə b á ʊ ɴ d o ʊ ʔ
ဒါပေမဲ့	d à b è m ɛ̰
ပျူ	p j ù
ကဆုန်	k ə sʰ ò ʊ ɴ
အချွဲ	ʔ ə t͡ɕʰ w ɛ́
နိဒါန်း	n ḭ d á ɴ
သစ်ကြံပိုး	θ ɪ ʔ d͡ʑ ə b ó
လူ့အဖွဲ့အစည်း	l ṵ ʔ ə pʰ w ɛ̰ ʔ ə s í
ဆရာတော်	sʰ ə j à d ɔ̀
ရှင်းရှင်း	ʃ ɪ́ ɴ ʃ ɪ́ ɴ
ဝက်ဆီ	w ɛ ʔ sʰ ì
သီတင်းကျွတ်	ð ə d ɪ́ ɴ d͡ʑ ʊ ʔ
တော်	t ɔ̀
ယမ်း	j á ɴ
ဂဏန်း	ɡ ə n á ɴ
အောက်	ʔ a ʊ ʔ
တိုက်	t a ɪ ʔ
ကျိန္တလီ	t͡ɕ è ɪ ɴ t a̰ l ì
အရေ	ʔ ə j è
အစုံအစုံ	ʔ ə s ò ʊ ɴ ʔ ə s ò ʊ ɴ
ဝိပတ္တိတရားလေးပါး	w ḭ p a ʔ t ḭ t ə j á l é b á
လည်လိမ်နာ	l ì l è ɪ ɴ n à
ပြုပြင်	p j ṵ b j ɪ̀ ɴ
သုံးဆောင်	θ ó ʊ ɴ sʰ à ʊ ɴ
သံတမန်	θ à ɴ t ə m à ɴ
နားထောင်	n á tʰ à ʊ ɴ
လီဆူ	l ì sʰ ù
နှစ်ရာ	n̥ ə j à
မျက်နှာ	m j ɛ ʔ n̥ à
အုံး	ʔ ó ʊ ɴ
မြင်းစားဂျုံ	m j ɪ́ ɴ z á d͡ʑ ò ʊ ɴ
ရွာစား	j w à z á
ပစ္စယာ	p j ɪ ʔ s ə j à
အမျိုးသားသီချင်း	ʔ ə m j ó ð á θ ə t͡ɕʰ ɪ́ ɴ
ဒီဇိုင်း	d ì z á ɪ ɴ
တပ်ကြပ်	t a ʔ t͡ɕ a ʔ
ဥက္ကာ	ʔ o ʊ ʔ k à
စတေဒီယံ	s ə t è d ì j à ɴ
သတ္တမ	θ a ʔ t ə m a̰
ဂြိုဟ်တု	d͡ʑ ò h d ṵ
နေပြည်တော်	n è p j ì d ɔ̀
လျောင်း	l j á ʊ ɴ
ကိန္နရာ	k è ɪ ɴ n ə j à
နံကထိုင်	n à ɴ k ə tʰ à ɪ ɴ
ချွန်	t͡ɕʰ ʊ̀ ɴ
ဂရပ်	ɡ ə ɹ a ʔ
စကြာ	s ɛ ʔ t͡ɕ à
ရေးချ	j é t͡ɕʰ a̰
မဟာဂီတ	m ə h à ɡ ì t a̰
သန်း	θ á ɴ
ဖြီး	pʰ í
အနုတ်လက္ခဏာ	ʔ ə n̥ o ʊ ʔ l ɛ ʔ kʰ ə n à
ဆလတ်	sʰ ə l a ʔ
လမ်းဘေးဆိုင်	l á ɴ b é z à ɪ ɴ
ပင့်ကူအိမ်	p ɪ̰ ɴ ɡ ù ʔ è ɪ ɴ
ဘယ်တုန်းက	b ɛ̀ d ó ʊ ɴ ɡ a̰
သက်သေ	θ ɛ ʔ θ è
ခမောက်	kʰ ə m a ʊ ʔ
ခရမ်းသီး	kʰ ə j á ɴ θ í
ပါးဟက်	p ə h ɛ ʔ
ဩဇာ	ʔ ɔ́ z à
ဝက်ဝံ	w ɛ ʔ w ʊ̀ ɴ
စွယ်	s w ɛ̀
အလီ	ʔ ə l ì
တေသံ	t è ð à ɴ
အခွံမာသီး	ʔ ə kʰ ʊ̀ ɴ m à ð í
မှန်မှန်	m̥ à ɴ m̥ à ɴ
ကစားစရာ	ɡ ə z á z ə j à
ဗမာ့	b ə m a̰
အမိန့်	ʔ ə m ḛ ɪ ɴ
ယွန်း	j ʊ́ ɴ
ဂန္ထဝင်	ɡ à ɴ d ə w ɪ̀ ɴ
မိတ်	m e ɪ ʔ
ယေရှု	j è ʃ ṵ
တော်လေးဝ	t ɔ̀ l é w a̰
ခြားနား	t͡ɕʰ á n á
ဗိုက်ကြီး	b a ɪ ʔ t͡ɕ í
ပျပျ	p j a̰ b j a̰
ကျားမ	t͡ɕ á m a̰
ဘာလိ	b à l ḭ
တလိုင်း	t ə l á ɪ ɴ
နို့သီးခေါင်း	n o̰ ð í ɡ á ʊ ɴ
နားရွက်	n ə j w ɛ ʔ
ဆီနီဂေါ	sʰ ì n ì ɡ ɔ́
ဂယ်လက်ဆီ	ɡ ɛ̀ l ɛ ʔ sʰ ì
တကွ	d ə ɡ w a̰
နိုက်ထရိုဂျင်	n a ɪ ʔ tʰ ə ɹ ò d͡ʑ ɪ̀ ɴ
စပါး	z ə b á
တီရှပ်	t ì ʃ a ʔ
၎င်း	l ə ɡ à ʊ ɴ
အီနောင်	ʔ ì n à ʊ ɴ
သံကြိုး	θ à ɴ d͡ʑ ó
ဒိန်ချဉ်	d è ɪ ɴ d͡ʑ ɪ̀ ɴ
ဒီပါဝလီ	d ì p à w ə l ì
ချစ်တီး	t͡ɕʰ ɪ ʔ t í
အာကာသယာဉ်	ʔ à k à θ a̰ j ɪ̀ ɴ
ဆောင်းဦး	sʰ á ʊ ɴ ʔ ú
သစ်ဆိမ့်	θ ɪ ʔ sʰ ḛ ɪ ɴ
တောင်ကိုရီးယား	t à ʊ ɴ k ò ɹ í j á
ကောက်	k a ʊ ʔ
ဝက်ကြွပ်	w ɛ ʔ t͡ɕ ʊ ʔ
မူလီ	m ù l ì
သူလျှို	ð ə ʃ ò
ပတ္တမြား	b ə d ə m j á
အင်္ဂါ	ʔ ɪ̀ ɴ ɡ à
အမျိုးသားစိတ်	ʔ ə m j ó ð á s e ɪ ʔ
အား	ʔ á
စွပ်ပြုတ်	s ʊ ʔ p j o ʊ ʔ
ဇီဝ	z ì w a̰
ဘုရားလောင်း	pʰ ə j á l á ʊ ɴ
အိုင်ဗရီကို့စ်	ʔ à ɪ ɴ b ə ɹ ì k o̰ s
အခု	ʔ ə kʰ ṵ
အသံ	ʔ ə θ à ɴ
လတ်	l a ʔ
ရောမ	ɹ ɔ́ m a̰
အားလုံး	ʔ á l ó ʊ ɴ
မွတ်စလင်	m ʊ ʔ s ə l ɪ̀ ɴ
သားလောင်း	θ á l á ʊ ɴ
မိတ္တူ	m e ɪ ʔ t ù
ဂျော်နီ	d͡ʑ ɔ̀ n ì
တပို့တွဲ	d ə b o̰ d w ɛ́
ရောက်	j a ʊ ʔ
ကာတာ	k à t à
ပုပ်	p o ʊ ʔ
မြင်းကလေး	m j ɪ́ ɴ ɡ ə l é
အရေးတော်ပုံ	ʔ ə j é d ɔ̀ b ò ʊ ɴ
စောပြာ	s ɔ́ b j à
ကော်ပီစာအုပ်	k ɔ̀ p ì s à ʔ o ʊ ʔ
မော်လီကျူး	m ɔ̀ l ì t͡ɕ ú
ကာဇက်စတန်	k à z ɛ ʔ s ə t à ɴ
သဘောတူ	ð ə b ɔ́ t ù
မက်မွန်	m ɛ ʔ m ʊ̀ ɴ
ခုံရှည်	kʰ ò ʊ ɴ ʃ è
ဟထိုး	h a̰ tʰ ó
ပြီ	p j ì
မဏ္ဍပ်	m á ɴ d a ʔ
ရုပ်ရှင်	j o ʊ ʔ ʃ ɪ̀ ɴ
ထိုင်ပေ	tʰ à ɪ ɴ p è
ထိုမှာ	tʰ ò m̥ à
ဦးထုပ်	ʔ o ʊ ʔ tʰ o ʊ ʔ
ကုန်ကုန်	k ò ʊ ɴ ɡ ò ʊ ɴ
အင်ဂျင်နီယာ	ʔ ɪ̀ ɴ d͡ʑ ɪ̀ ɴ n ì j à
ပာရာဂ္ဝေး	p à ɹ à ɡ w é
အကျည်းတန်	ʔ ə t͡ɕ í t à ɴ
ကံကြမ္မာ	k à ɴ t͡ɕ ə m à
သံဃာ	θ à ɴ ɡ à
အီကွေတာဂီနီ	ʔ ì k w è t à ɡ ì n ì
ဂိုဏ်းချုပ်	ɡ á ɪ ɴ d͡ʑ o ʊ ʔ
အသွားအလာ	ʔ ə θ w á ʔ ə l à
ပိုးဟပ်	p ó h a ʔ
မုန့်ညက်	m o̰ ʊ ɴ ɲ ɛ ʔ
ဝိုင်	w à ɪ ɴ
လျှောက်	ʃ a ʊ ʔ
စတုတ္ထ	z ə d o ʊ ʔ tʰ a̰
နှောင်း	n̥ á ʊ ɴ
ရှင်ပြု	ʃ ɪ̀ ɴ p j ṵ
အားကစား	ʔ á ɡ ə z á
ဆက်ဆံ	sʰ ɛ ʔ sʰ à ɴ
ဘုရားအလောင်း	pʰ ə j á ʔ ə l á ʊ ɴ
တိုဂို	t ò ɡ ò
ဇေယျာပူရ	z è j à p ù ɹ a̰
မရဏ	m ə ɹ ə n a̰
အီသီယိုးပီးယား	ʔ ì θ ì j ó p í j á
ဂျက်	d͡ʑ ɛ ʔ
သိုးထီး	θ ó d í
ဟော်	h ɔ̀
ဘာလင်	b à l ɪ̀ ɴ
ပန်းခုနစ်မည်	p á ɴ kʰ ə n ə m j ì
ဘောပင်	b ɔ́ p ɪ̀ ɴ
အာဇာနည်နေ့	ʔ à z à n ì n ḛ
ပဇာ	b ə z à
လေသာပေါက်	l è ð à b a ʊ ʔ
ဖြားယောင်း	pʰ j á j á ʊ ɴ
ပျား	p j á
ချေးထုပ်	t͡ɕʰ é tʰ o ʊ ʔ
ဇီဝဗေဒ	z ì w a̰ b è d a̰
စောက်	s a ʊ ʔ
ပင်ဂွင်	p ɪ̀ ɴ ɡ w ɪ̀ ɴ
ပြည်သူပိုင်သိမ်း	p j ì ð ù b à ɪ ɴ ð é ɪ ɴ
ကျိုက်ထီးရိုး	t͡ɕ a ɪ ʔ tʰ í j ó
ဆို	sʰ ò
ဝသန္တ	w a̰ θ à ɴ t a̰
မရီး	m ə j í
အစီအလျဉ်	ʔ ə s ì ʔ ə l j ɪ̀ ɴ
ဗီယက်နမ်	b ì j ɛ ʔ n à ɴ
ပန်းနာ	p á ɴ n à
တညင်း	d ə ɲ ɪ́ ɴ
တိုဟူးသုပ်	t ò h ú θ o ʊ ʔ
သူမ	θ ù m a̰
အသင်	ʔ ə θ ɪ̀ ɴ
ရတနာပူရ	j ɛ̀ d ə n à p ù ɹ a̰
ညနေ	ɲ a̰ n è
နှာမောင်း	n̥ ə m á ʊ ɴ
အဆိပ်	ʔ ə sʰ e ɪ ʔ
စာစောင်	s à z à ʊ ɴ
မနုပ်တာနီ	m ə n o ʊ ʔ t à n ì
အစည်းအရုံး	ʔ ə s í ʔ ə j ó ʊ ɴ
အင်း	ʔ ɪ́ ɴ
ညို	ɲ ò
ရိတ်သိမ်း	j e ɪ ʔ θ é ɪ ɴ
နှုတ်သီး	n̥ o ʊ ʔ θ í
အကြော်	ʔ a̰ t͡ɕ ɔ̀
အရွက်	ʔ ə j w ɛ ʔ
ပါရှား	p à ʃ á
ယန္တရား	j à ɴ d ə j á
လိုင်း	l á ɪ ɴ
ဘိုင်စကယ်	b à ɪ ɴ s ə k ɛ̀
ပဝါ	p a̰ w à
ပဒေသရာဇ်	b ə d è θ ə ɹ ɪ ʔ
ဖား	pʰ á
မှတ်ဉာဏ်	m̥ a ʔ ɲ à n
ကိုလံဘီယာ	k ò l à ɴ b ì j à
သုက်	θ o ʊ ʔ
အီး	ʔ í
ဩစတြီးယား	ʔ ɔ́ s ə t ə ɹ ì j a̰
သမိန်	θ ə m è ɪ ɴ
မင်	m̥ ɪ̀ ɴ
အလင်း	ʔ ə l ɪ́ ɴ
နရား	n ə j á
ငါတို့	ŋ à t o̰
ဒေါင်း	d á ʊ ɴ
ငတ်	ŋ a ʔ
ငရဲမင်း	ŋ ə j ɛ́ m ɪ́ ɴ
တဆယ်	t ə z ɛ̀
နောက်ပြီး	n a ʊ ʔ p í
ပုံတူ	p ò ʊ ɴ d ù
အနန္တ	ʔ ə n à ɴ d a̰
ဘရိတ်	b ə ɹ e ɪ ʔ
ပြတင်းပေါက်	b ə d ɪ́ ɴ b a ʊ ʔ
ပေါင်	p à ʊ ɴ
ဒါပော့	d à p ɔ̰
ဦးကြီး	ʔ ú d͡ʑ í
ဆောရီး	sʰ ɔ́ ɹ í
စပျစ်	z ə b j ɪ ʔ
သင်္ဘောသီးသုပ်	θ ɪ̀ ɴ b ɔ́ θ í θ o ʊ ʔ
စီး	s í
ဟို	h ò
နှမ	n̥ ə m a̰
နာဂရီ	n à ɡ ə ɹ ì
မနက်	m ə n ɛ ʔ
ပြာဋိဟာ	p j à d ḭ h à
ပကတိ	b ə ɡ ə d ḭ
အာနုဘော်	ʔ à n ṵ b ɔ̀
မွှား	m̥ w á
ဘွဲ့	b w ɛ̰
ဘယ်	b ɛ̀
ခါးပတ်	ɡ ə b a ʔ
တိုဖူး	t ò pʰ ú
မီးတောင်	m í d à ʊ ɴ
အပြုအမူ	ʔ ə p j ṵ ʔ ə m ù
ကိတ်မုန့်	k e ɪ ʔ m o̰ ʊ ɴ
ဝေါဟာရဗေဒ	θ a ʔ d a̰ b è d a̰
ကျောပိုးအိတ်	t͡ɕ ɔ́ b ó ʔ e ɪ ʔ
ကင်ပွန်း	k ɪ̀ ɴ b ʊ́ ɴ
ဖော့လုံး	pʰ ɔ̰ l ó ʊ ɴ
အသည်း	ʔ ə θ ɛ́
ပန်းရွဲ	p á ɴ j w ɛ́
ငှါး	ŋ̊ á
မြက်ခုတ်ဓား	m j ɛ ʔ kʰ o ʊ ʔ d á
ကပ်ပါး	k a ʔ p á
စုန်း	s ó ʊ ɴ
ဖိတ်	pʰ e ɪ ʔ
လှိုင်း	l̥ á ɪ ɴ
ပေကျင်း	p è t͡ɕ ɪ́ ɴ
ဝေသာလီ	w è θ à l ì
သံပြိုင်	θ à ɴ b j à ɪ ɴ
လှံ	l̥ à ɴ
စပိန်	s ə p è ɪ ɴ
ဆိုင်	sʰ à ɪ ɴ
ဆလိုဗေးနီးယား	sʰ ə l ò b é n í j á
ဘရင်ဂျီ	b ə j ɪ̀ ɴ d͡ʑ ì
ဒုတိယ	d ṵ t ḭ j a̰
ပေါ်လစီ	p ɔ̀ l ə s ì
နာ	n à
ပင်လယ်ဆား	p ɪ̀ ɴ l ɛ̀ z á
ဥတ္တရခဏ္ဍ	ʔ o ʊ ʔ t ə ɹ a̰ kʰ à n d a̰
တခြား	t ə t͡ɕʰ á
ကူညီ	k ù ɲ ì
ငလျင်	ŋ ə l j ɪ̀ ɴ
ရွာ	j w à
ပုဏ္ဏားကျွန်း	p ò ʊ ɴ n á d͡ʑ ʊ́ ɴ
အိပ်မက်	ʔ e ɪ ʔ m ɛ ʔ
သင်တုန်းဓား	θ ɪ̀ ɴ d ó ʊ ɴ d á
ခရစ်	kʰ ə ɹ ɪ ʔ
ခရမ်းချဉ်	kʰ ə j á ɴ d͡ʑ ɪ̀ ɴ
ငါ့	ŋ a̰
အဆုတ်	ʔ ə sʰ o ʊ ʔ
လေ့လာ	l ḛ l à
ပြဒါး	b ə d á
မင်းကွတ်	m ɪ́ ɴ ɡ ʊ ʔ
လွယ်	l w ɛ̀
သန်လျင်	θ ə ɲ ɪ̀ ɴ
အချိန်စာရင်း	ʔ ə t͡ɕʰ è ɪ ɴ s ə j ɪ́ ɴ
တောင်ဖက်ဝန်း	t à ʊ ɴ pʰ ɛ ʔ w ʊ́ ɴ
အရိမဒ္ဒနာပူရ	ʔ a̰ ɹ ḭ m à d d ə n à p ù ɹ a̰
တံခါး	d ə ɡ á
လည်ချောင်း	l ɛ̀ d͡ʑ á ʊ ɴ
ဟူးဟူး	h ú h ú
အုတ်	ʔ o ʊ ʔ
အင်ဂျင်	ʔ ɪ̀ ɴ d͡ʑ ɪ̀ ɴ
သဇင်	ð ə z ɪ̀ ɴ
ဘယ်လို	b ɛ̀ l ò
ဂိုဒေါင်	ɡ ò d à ʊ ɴ
ဥမင်	ʔ ṵ m ɪ̀ ɴ
စခန်း	s ə kʰ á ɴ
ဗျစ်	b j ɪ ʔ
ကတ်သလိတ်	k a ʔ θ ə l e ɪ ʔ
ရွှေ	ʃ w è
အင်းသား	ʔ ɪ́ ɴ ð á
ကားဂိတ်	k á ɡ e ɪ ʔ
လှုပ်ရှား	l̥ o ʊ ʔ ʃ á
စစ်သား	s ɪ ʔ θ á
ကျင်ကြီး	t͡ɕ ɪ̀ ɴ d͡ʑ í
ဘော်လီဘော	b ɔ̀ l ì b ɔ́
ဗောဓိသတ်	b ɔ́ d ḭ θ a ʔ
တိုင်ကီ	t à ɪ ɴ k ì
ချည်လုံး	t͡ɕʰ ì l ó ʊ ɴ
ရက်ကန်းစင်	j ɛ ʔ k á ɴ z ɪ̀ ɴ
တစ်ခုလပ်	t ə kʰ ṵ l a ʔ
ကရိန်း	k ə ɹ é ɪ ɴ
ဆိုက်ပရပ်စ်	sʰ a ɪ ʔ p ə ɹ a ʔ s
နိုင်နိုင်	n à ɪ ɴ n à ɪ ɴ
အာလာပသလ္လာပ	ʔ à l à p a̰ θ ə l à p a̰
ကျောင်းသူ	t͡ɕ á ʊ ɴ ð ù
ဒေါ်ကြီး	d ɔ̀ d͡ʑ í
စေ့စပ်	s ḛ z a ʔ
အထက်	ʔ ə tʰ ɛ ʔ
ဗို့အား	b o̰ ʔ á
ဒဏ္ဍာရီ	d à n d à j ì
ကမာ	k ə m à
ကြေးအိုး	t͡ɕ é ʔ ó
ကလျာ	k a̰ j à
ရက်စွဲ	j ɛ ʔ s w ɛ́
လူ့ဘောင်	l ṵ b à ʊ ɴ
ပိန္နဲ	p è ɪ ɴ n ɛ́
ယှဉ်း	ʃ ɪ́ ɴ
အရောင်	ʔ ə j à ʊ ɴ
ဖုန်းနံပါတ်	pʰ ó ʊ ɴ n à ɴ b a ʔ
ဘေးဆီးရန်ကာ	b é z í j à ɴ ɡ à
လွန်	l ʊ̀ ɴ
ကျုပ်တို့	t͡ɕ o ʊ ʔ t o̰
ထူထဲ	tʰ ù d ɛ́
ဘဏ္ဍာ	b à n d à
ဩရိဿ	ʔ ɔ́ ɹ e ɪ ʔ θ a̰
သလုံး	θ ə l ó ʊ ɴ
ဂျုံမှုန့်	d͡ʑ ò ʊ ɴ m̥ o̰ ʊ ɴ
အနှီး	ʔ ə n̥ í
ပြား	p j á
လိုက်ဘေးရီးယား	l a ɪ ʔ b é ɹ í j á
ဥပါယ်	ʔ ṵ p ɛ̀
အဆုတ်ရောင်ရောဂါ	ʔ a̰ sʰ o ʊ ʔ j à ʊ ɴ j ɔ́ ɡ à
အာလူး	ʔ à l ú
ဂငယ်	ɡ a̰ ŋ ɛ̀
ခရီး	kʰ ə j í
ကျေးဇူးတင်ပါတယ်	t͡ɕ é z ú t ɪ̀ ɴ b à d ɛ̀
တိုကျို	t ò t͡ɕ ò
ရွှေတောင်ခေါက်ဆွဲ	ʃ w è d à ʊ ɴ kʰ a ʊ ʔ sʰ w ɛ́
ရုရှား	ɹ ṵ ʃ á
တွင်	t w ɪ̀ ɴ
တိုင်ဖွန်း	t à ɪ ɴ pʰ ʊ́ ɴ
ကြေးမုံ	t͡ɕ é m ò ʊ ɴ
အိုက်စလန်	ʔ a ɪ ʔ s ə l à ɴ
တောင်သူ	t à ʊ ɴ ð ù
ဆံပင်	z ə b ɪ̀ ɴ
ဦးလေး	ʔ ú l é
ရူမေးနီးယား	ɹ ù m é n í j á
သျှမ်း	ʃ á ɴ
ဘောလုံး	b ɔ́ l ó ʊ ɴ
အကာ	ʔ ə k à
ဘောင်းဘီ	b á ʊ ɴ b ì
လွန်ဆွဲ	l ʊ̀ ɴ sʰ w ɛ́
မြေအောက်မီးရထား	m j è ʔ a ʊ ʔ m í j ə tʰ á
နေကောင်းရဲ့လား	n è k á ʊ ɴ j ɛ̰ l á
စကတ်	s ə k a ʔ
တလွဲ	t ə l w ɛ́
သော	θ ɔ́
ရွာသူ	j w à ð ù
အလုပ်လုပ်	ʔ ə l o ʊ ʔ l o ʊ ʔ
ဆွာဇီလန်	sʰ w à z ì l à ɴ
ဘာသာပြန်	b à ð à p j à ɴ
သျှောင်	j à ʊ ɴ
ငချိတ်	ŋ ə t͡ɕʰ e ɪ ʔ
သွားရည်	θ ə j ì
ဝနာ	w ə n à
မရမာကြီး	m ə ɹ ə m à d͡ʑ í
မြိတ်	b e ɪ ʔ
ရွှေတောင်	ʃ w è d à ʊ ɴ
သမား	θ ə m á
သုံး	θ ó ʊ ɴ
နှစ်ဆယ့်တစ်	n̥ ɪ ʔ sʰ ɛ̰ t ɪ ʔ
ဆိုဖာ	sʰ ò pʰ à
ကင်းခြေများ	k ɪ́ ɴ t͡ɕ ì m j á
သံလမ်း	θ à ɴ l á ɴ
ဟိုဟာ	h ò h à
ဒိုင်ယာရီ	d à ɪ ɴ j ə ɹ ì
ရှေး	ʃ é
ဆုံး	sʰ ó ʊ ɴ
အစ္စလမ်	ʔ ɪ ʔ s ə l à ɴ
အီရန်	ʔ ì ɹ à ɴ
ခြင်းလုံး	t͡ɕʰ ɪ́ ɴ l ó ʊ ɴ
ငါးဥ	ŋ á ʔ ṵ
ကာရန်	k ə j à ɴ
ဗားနစ်	b á n ɪ ʔ
ဗိုလ်လောင်း	b ò l á ʊ ɴ
ခြတောင်ပို့	t͡ɕʰ a̰ t à ʊ ɴ b o̰
ဌာပနာ	tʰ à p ə n à
ကမ္ဘောဒီးယား	k à ɴ b ɔ́ d í j á
မြွေပါ	m w è b à
ကဒ်	k à d
ပဉ္စင်း	b ə z ɪ́ ɴ
ကာလ	k à l a̰
နယ်သာလန်	n ɛ̀ ð ə l à ɴ
ချားလ်	t͡ɕʰ á l
မုန့်တီ	m o̰ ʊ ɴ t ì
ယင်ကောင်	j ɪ̀ ɴ ɡ à ʊ ɴ
ဘိုးဘိုး	pʰ ó pʰ ó
အလင်းတန်း	ʔ ə l ɪ́ ɴ d á ɴ
ကျောက်မီးသွေး	t͡ɕ a ʊ ʔ m í ð w é
ခြေအိတ်	t͡ɕʰ è ʔ e ɪ ʔ
စရိုက်	z ə j a ɪ ʔ
ပုဆိန်	p ə sʰ è ɪ ɴ
နှမ်းဆီ	n̥ á ɴ z ì
ထဘီ	tʰ ə m ì
မြင်းဆေး	m j ɪ́ ɴ z é
ဘယ်သူ	b ə θ ù
လက်တင်အမေရိက	l ɛ ʔ t ɪ̀ ɴ ʔ ə m è ɹ ḭ k a̰
လူဇင်ဘတ်	l ù z ɪ̀ ɴ b a ʔ
မိထွေး	m ḭ d w é
စပါးလင်	z ə b ə l ɪ̀ ɴ
အလင်္ကာ	ʔ ə l ɪ̀ ɴ ɡ à
မာရ်	m à
ဌာန	tʰ à n a̰
အကျဉ်း	ʔ ə t͡ɕ ɪ́ ɴ
ပန်းသေး	p á ɴ ð é
စတုဂံ	s ə t ṵ ɡ à ɴ
ပြည်ထောင်စုနေ့	p j ì d à ʊ ɴ z ṵ n ḛ
အောင်လံ	ʔ à ʊ ɴ l à ɴ
လူမှုကွန်ရက်	l ù m̥ ṵ k ʊ̀ ɴ j ɛ ʔ
ချဲ့ချဲ့	t͡ɕʰ ɛ̰ d͡ʑ ɛ̰
ပြဒါးချိန်	b ə d á d͡ʑ è ɪ ɴ
ဘုရားရှိခိုးကျောင်း	pʰ ə j á ʃ ḭ kʰ ó d͡ʑ á ʊ ɴ
အင်္ကျီ	ʔ ɪ́ ɴ d͡ʑ ì
ကျွန်း	t͡ɕ ʊ́ ɴ
ဂီတ	ɡ ì t a̰
တချို့	t ə t͡ɕʰ o̰
အို	ʔ ò
ကြိယာဝိသေသန	k ə ɹ ḭ j à w ḭ θ è θ ə n a̰
ဓားစာခံ	d ə z à ɡ à ɴ
ကျွန်မတို့	t͡ɕ ʊ̀ ɴ m a̰ d o̰
ဖယောင်းတိုင်	pʰ ə j á ʊ ɴ d à ɪ ɴ
အနီ	ʔ ə n ì
တပ်မတော်နေ့	t a ʔ m ə d ɔ̀ n ḛ
ငါးဖယ်	ŋ ə pʰ ɛ̀
ဘိုလီးဗီးယား	b ò l í b í j á
ထား	tʰ á
မဉ္ဇူ	m ɪ̀ ɴ z ù
စောင်	s à ʊ ɴ
ပင်စိမ်းမွှေး	p ɪ̀ ɴ z é ɪ ɴ m̥ w é
မျှော်လင့်ချက်	m̥ j ɔ̀ l ɪ̰ ɴ d͡ʑ ɛ ʔ
သံကြွပ်	θ à ɴ d͡ʑ ʊ ʔ
စကားပြောကြေးနန်း	z ə ɡ á b j ɔ́ t͡ɕ é n á ɴ
ခင်ဗျားတို့	kʰ ɪ̀ ɴ b j á d o̰
လောက	l ɔ́ k a̰
မှန်ပြောင်း	m̥ à ɴ b j á ʊ ɴ
ခရိုင်	kʰ ə j à ɪ ɴ
ကြော်ငြာ	t͡ɕ ɔ̀ ɲ à
ပုလင်း	p ə l ɪ́ ɴ
တကယ်	d ə ɡ ɛ̀
သရက်သီးသနပ်	θ ə j ɛ ʔ θ í θ a̰ n a ʔ
ပင်စည်	p ɪ̀ ɴ z ì
သောက္ကတဲ	θ a ʊ ʔ k ə t ɛ́
အင်ပါယာ	ʔ ɪ̀ ɴ p à j à
ပန်းရန်	b ə j à ɴ
လူကြီး	l ù d͡ʑ í
တိုးတက်	t ó t ɛ ʔ
သံချပ်	θ ə d͡ʑ a ʔ
ရုပ်ပုံ	j o ʊ ʔ p ò ʊ ɴ
ဘိန်းမုန့်	b é ɪ ɴ m o̰ ʊ ɴ
မြင်း	m j ɪ́ ɴ
ကျောက်ပွင့်သုပ်	t͡ɕ a ʊ ʔ p w ɪ̰ ɴ θ o ʊ ʔ
ခန်း	kʰ á ɴ
နှင်းပွင့်	n̥ ɪ́ ɴ b w ɪ̰ ɴ
အသိ	ʔ ə θ ḭ
မသာ	m ə θ à
ပါကစ္စတန်	p à k ɪ ʔ s ə t à ɴ
ပူရ	p ù ɹ a̰
မနော	m ə n ɔ́
ဇိန	z ḭ n a̰
လှဲ	l̥ ɛ́
ပထမ	p a̰ tʰ a̰ m a̰
ဂေါ်ဖီပန်း	ɡ ɔ̀ b ì p á ɴ
ဘလောက်	b a̰ l a ʊ ʔ
ရဿ	ɹ a ʔ θ a̰
မန်း	m á ɴ
သဘာဝ	ð ə b à w a̰
တီဟီရန်	t ì h ì ɹ à ɴ
ဓာတ်ကြီးလေးပါး	d à t t͡ɕ í l é p á
တံ	t à ɴ
ကိမိလဗေဒ	k ḭ m ḭ l a̰ b è d a̰
သံလိုက်စက်ကွင်း	θ à ɴ l a ɪ ʔ s ɛ ʔ k w ɪ́ ɴ
ပြ	p j a̰
ကုန်တင်ကား	k ò ʊ ɴ d ɪ̀ ɴ ɡ á
ကွဲ	k w ɛ́
တို့	d o̰
ရတနာပုံ	j ɛ̀ d ə n à b ò ʊ ɴ
ဒူးရင်းယို	d ú j ɪ́ ɴ j ò
လိင်	l è ɪ ɴ
မြောက်‌ဦး	m j a ʊ ʔ ‌ ʔ ú
ပိုး	p ó
ရေကူး	j è k ú
ပြိုင်ပွဲ	p j à ɪ ɴ b w é
ပညာဗလ	p j ɪ̀ ɴ ɲ à b ə l a̰
ရေကာတာ	j è ɡ à d à
လီသီယမ်	l ì θ ì j à ɴ
ယမနေ	j ə m ə n è
သဲ	θ ɛ́
လိပ်ခေါင်းရောဂါ	l e ɪ ʔ ɡ á ʊ ɴ j ɔ́ ɡ à
ဖူး	b ú
ဓာတ်အိုး	d a ʔ ʔ ó
ညှပ်	ɲ̊ a ʔ
ခြေထောက်	t͡ɕʰ è d a ʊ ʔ
လုပ်	l o ʊ ʔ
ပင်မှည့်	p ɪ̀ ɴ m̥ ɛ̰
ဦးပဉ္စင်း	ʔ ú b ə z ɪ́ ɴ
ခက်ရင်း	kʰ ə j ɪ́ ɴ
ချောကလက်	t͡ɕʰ ɔ́ k ə l ɛ ʔ
ကွင်းထိုးဖိနပ်	ɡ w ɪ́ ɴ d ó pʰ ə n a ʔ
ဗီဇ	b ì z a̰
ကြံ့	t͡ɕ a̰ ɴ
ရင်	j ɪ̀ ɴ
ကုလားထိုင်	k ə l ə tʰ à ɪ ɴ
ဒုက္ခ	d o ʊ ʔ kʰ a̰
သက်သာ	θ ɛ ʔ θ à
ပုဂံ	b ə ɡ à ɴ
ဂေါ်မိတ်	ɡ ɔ̀ m e ɪ ʔ
ညှစ်	ɲ̊ ɪ ʔ
လိုဏ်	l̥ à ɪ ɴ
ကျပ်သား	t͡ɕ a ʔ θ á
သင်္ဘောဆိပ်	θ ɪ̀ ɴ b ɔ́ z e ɪ ʔ
ပြင်	p j ɪ̀ ɴ
မိန်းမလျာ	m é ɪ ɴ m ə ʃ à
စန်း	s á ɴ
နာရီဝက်	n à j ì w ɛ ʔ
မြေ	m j è
စန္ဒရား	s à ɴ d ə j á
ပအို့ဝ်	p ə ʔ o̰
အိပ်ရာလိပ်	ʔ e ɪ ʔ j à l e ɪ ʔ
လူဝင်မှုကြီးကြပ်ရေး	l ù w ɪ̀ ɴ m̥ ṵ t͡ɕ í t͡ɕ a ʔ j é
နဂါးမောက်သီး	n a̰ ɡ á m a ʊ ʔ θ í
စွမ်း	s w á ɴ
ရော်ဘာ	ɹ ɔ̀ b à
ရူပနက္ခတ္တဗေဒ	j ù p a̰ n ɛ ʔ kʰ a ʔ t a̰ b è d a̰
ဝါရှင်တန်	w à ʃ ɪ̀ ɴ t à ɴ
ကြည့်	t͡ɕ í
ကျူးဘား	k j ú b á
အဖိုးကြီး	ʔ ə pʰ ó t͡ɕ í
ပီစီ	p ì s ì
ဇာတ်ဆောင်	z a ʔ sʰ à ʊ ɴ
အစ္စရေး	ʔ ɪ ʔ z ə ɹ é
မယ်သီလ	m ɛ̀ ð ì l a̰
သာမဏေ	θ à m ə n è
စေတီ	z è d ì
ဝီရ	w ì j a̰
ဂင်းနီဗစ်ဆော	ɡ ɪ́ ɴ n ì b ɪ ʔ sʰ ɔ́
ဖုန်	pʰ ò ʊ ɴ
လွိုင်ကော်	l w à ɪ ɴ k ɔ̀
ဇီဝစက်	z ì w a̰ s ɛ ʔ
ရောင်ခြည်	j à ʊ ɴ d͡ʑ ì
ကတ်ကြေးကိုက်	k a ʔ t͡ɕ í k a ɪ ʔ
ဥဇဘက်ကစ္စတန်	ʔ ṵ z ə b ɛ ʔ k ɪ ʔ s ə t à ɴ
တရားလွှတ်တော်ချုပ်	t ə j á l̥ ʊ ʔ t ɔ̀ d͡ʑ o ʊ ʔ
တည်း	tʰ ɛ́
အလက်	ʔ ə l ɛ ʔ
သီရိလင်္ကာ	θ ì ɹ ḭ l ɪ̀ ɴ k à
လောင်း	l á ʊ ɴ
အသားညှပ်မုန့်	ʔ ə θ á ɲ̊ a ʔ m o̰ ʊ ɴ
အမိန့်ရှိပါ	ʔ ə m ḛ ɪ ɴ ʃ ḭ b à
ကိုယ်ဝန်ရှိ	k ò j w ʊ̀ ɴ ʃ ḭ
နှပ်	n̥ a ʔ
ဟိုင်းအီနာကောင်	h á ɪ ɴ ʔ ì n à k à ʊ ɴ
ဉာဏ်	ɲ à n
ကာဗွန်	k à b ʊ̀ ɴ
ဝိဇ္ဇာဘွဲ့	w e ɪ ʔ z à b w ɛ̰
ရှောက်	ʃ a ʊ ʔ
ဆီယူ	sʰ ì j ù
ဒီလို	d ì l ò
ရာ	j à
အကို	ʔ ə k ò
တံဆိပ်	d ə z e ɪ ʔ
အသက်	ʔ ə θ ɛ ʔ
ထောပတ်ထမင်း	tʰ ɔ́ b a ʔ tʰ ə m ɪ́ ɴ
ဘေး	b é
အားနည်း	ʔ á n ɛ́
အထပ်	ʔ ə tʰ a ʔ
စာရွက်စာတမ်း	s à j w ɛ ʔ s à d á ɴ
မုန့်ကျွဲသည်း	m o̰ ʊ ɴ t͡ɕ w ɛ́ ð í
ထီ	tʰ ì
ရာဝဏ	ɹ à w ə n a̰
ပြည့်	p j ḛ
နွေး	n w é
မြဝတီ	m j a̰ w ə d ì
ယူဂန်းဒါး	j ù ɡ á ɴ d á
အမျိုးအနွယ်	ʔ ə m j ó ʔ ə n w ɛ̀
သွေး	θ w é
လွှတ်တော်	l̥ ʊ ʔ t ɔ̀
နှံကောင်	n̥ à ɴ ɡ à ʊ ɴ
ပဉ္စလက်	p ɪ̀ ɴ s ə l ɛ ʔ
ဇင်္ဂမဥစ္စာ	z ɪ̀ ɴ ɡ ə m a̰ ʔ o ʊ ʔ s à
ခြေသည်း	t͡ɕʰ è ð é
ဝံပုလွေ	w ʊ̀ ɴ b ə l w è
အိပ်ခန်း	ʔ e ɪ ʔ kʰ á ɴ
စာအိတ်	s à ʔ e ɪ ʔ
ပန်းပဲ	b ə b ɛ́
သုတေသီ	θ ṵ t è θ ì
လိုက်ချီး	l a ɪ ʔ t͡ɕʰ í
ဥမ္မာ	ʔ ṵ m m à
ခေါက်ဆွဲ	kʰ a ʊ ʔ sʰ w ɛ́
ရဟတ်	j ə h a ʔ
ဖုံး	pʰ ó ʊ ɴ
ကိုက်	k a ɪ ʔ
လက်စွပ်	l ɛ ʔ s ʊ ʔ
ထန်း	tʰ á ɴ
ယောက်မ	j á ʊ ɴ m a̰
ဇေယျ	z è j a̰
ဂန်ဂျာ	ɡ à ɴ d͡ʑ à
ဗေဒ	b è d a̰
တံငါ	t ə ŋ à
ဖြေရှင်း	pʰ j è ʃ ɪ́ ɴ
ချည်	t͡ɕʰ ì
လူ	l ù
တရားခံ	t ə j ə kʰ à ɴ
ကေသ	k è θ a̰
ကျောက်စိမ်း	t͡ɕ a ʊ ʔ s é ɪ ɴ
လက်သုတ်ပဝါ	l ɛ ʔ θ o ʊ ʔ p a̰ w à
ဆလဗ	sʰ ə l a̰ b a̰
မကွေး	m ə ɡ w é
ရေမြင်း	j è m j ɪ́ ɴ
အတိုင်း	ʔ ə t á ɪ ɴ
လိုး	l ó
ကျက်သရေ	t͡ɕ ɛ ʔ θ ə j è
ဆန်ပြုတ်	sʰ à ɴ b j o ʊ ʔ
မဟာဝိဇ္ဇာဘွဲ့	m ə h à w e ɪ ʔ z à b w ɛ̰
ရင်းရဲ	j ɪ́ ɴ j ɛ́
ကောင်မငယ်	k à ʊ ɴ m a̰ ŋ ɛ̀
ဘထွေး	b a̰ tʰ w é
သန်ကောင်	θ à ɴ ɡ à ʊ ɴ
မက်	m ɛ ʔ
တာလုဇ	t à l ṵ z a̰
ဖေဖော်ဝါရီ	pʰ è pʰ ɔ̀ w à ɹ ì
ဒြပ်စင်	d ə ɹ a ʔ s ɪ̀ ɴ
ထာဝရ	tʰ à w ə j a̰
ရွေး	j w é
လား	l á
မွန်ဂိုးလီးယား	m ʊ̀ ɴ ɡ ó l í j á
ပြယုဂ်	p j a̰ j o ʊ ʔ
ကြောင်ကလေး	t͡ɕ à ʊ ɴ ɡ ə l é
သရက်	θ ə j ɛ ʔ
ပြောင်း	p j á ʊ ɴ
ပုရပိုက်	p ə ɹ ə b a ɪ ʔ
ယဲ့ယဲ့	j ɛ̰ j ɛ̰
ညီ	ɲ ì
မျောက်ချော	m j a ʊ ʔ t͡ɕʰ ɔ́
ပန်းအိ	p á ɴ ʔ ḭ
တိုဟူး	t ò h ú
အန်ကယ်	ʔ à ɴ k ɛ̀
ဖြူ	pʰ j ù
ဗာလ	b à l a̰
ရှင်တို့	ʃ ɪ̀ ɴ d o̰
သယ်	θ ɛ̀
အုန်းထမင်း	ʔ ó ʊ ɴ tʰ ə m ɪ́ ɴ
ရက်	j ɛ ʔ
ချက်	t͡ɕʰ ɛ ʔ
ရွေးကောက်ပွဲ	j w é k a ʊ ʔ p w ɛ́
ခွေး	kʰ w é
အနှိပ်	ʔ ə n̥ e ɪ ʔ
ဝမ်းကျ	w á ɴ d͡ʑ a̰
ခဲတံ	kʰ ɛ́ d à ɴ
ဖဝါး	pʰ ə w á
ပရဟိတ	p ə ɹ a̰ h ḭ t a̰
စက္ကန့်	s ɛ ʔ k a̰ ɴ
ပင့်	p ɪ̰ ɴ
အပေါ်	ʔ ə p ɔ̀
ဂလင်း	ɡ ə l ɪ́ ɴ
ဘော်ဒါကြေး	b ɔ̀ d à t͡ɕ é
အာဖရိက	ʔ à pʰ ə ɹ ḭ k a̰
တိရစ္ဆာန်ရုံ	t ə ɹ e ɪ ʔ sʰ à ɴ j ò ʊ ɴ
ဝိုင်ယာကြိုး	w à ɪ ɴ j à d͡ʑ ó
ထောင်	tʰ à ʊ ɴ
ဓနု	d ə n ṵ
ရေတွက်	j è t w ɛ ʔ
ခဏ	kʰ ə n a̰
ဂမ်ဘီယာ	ɡ à ɴ b ì j à
အခိုး	ʔ ə kʰ ó
ကူးတို့	ɡ ə d o̰
ကလျာဏမိတ္တ	k ə l ə j à n a̰ m e ɪ ʔ t a̰
အမိုး	ʔ ə m ó
စားပြီးပြီလား	s á p í b ì l á
နာနာ	n à n à
ကွာလာလမ်ပူ	k w à l à l à ɴ p ù
လင်း	l ɪ́ ɴ
နှမ်း	n̥ á ɴ
မွေးနေ့	m w é n ḛ
ဒွာရ	d w à j a̰
များ	m j á
ညံစာစာ	ɲ à ɴ s à z à
ပုစဉ်း	b ə z ɪ́ ɴ
ခုန်	kʰ ò ʊ ɴ
ဥက္ကာပျံ	ʔ o ʊ ʔ k à b j à ɴ
နှစ်ဆယ်	n̥ ɪ ʔ sʰ ɛ̀
ဆော့	sʰ ɔ̰
ခင်ဗျာ့	kʰ ɪ̀ ɴ b j a̰
တောင်	t à ʊ ɴ
ပန်ကာ	p à ɴ k à
ဇွန်	z ʊ̀ ɴ
သားပိုက်ကောင်	θ á b a ɪ ʔ k à ʊ ɴ
ကြောင်အိမ်	t͡ɕ à ʊ ɴ ʔ è ɪ ɴ
ဟင်္သာတ	h ɪ̀ ɴ θ ə t a̰
ဘူ	b ù
အစောင့်	ʔ ə s a̰ ʊ ɴ
တစပြင်	d ə z a̰ b j ɪ̀ ɴ
တပေါင်းလပြည့်နေ့	d ə b á ʊ ɴ l a̰ p j ḭ n ḛ
ခလုတ်ခုံ	kʰ ə l o ʊ ʔ kʰ ò ʊ ɴ
နတ်ပြည်ခြောက်ထပ်	n a ʔ p j ì t͡ɕʰ a ʊ ʔ tʰ a ʔ
ကြက်သွန်နီ	t͡ɕ ɛ ʔ θ ʊ̀ ɴ n ì
ကန်စွန်းဥ	ɡ ə z ʊ́ ɴ ʔ ṵ
ရွှေချည်ထိုး	ʃ w è d͡ʑ ì d ó
ဟိတ်	h e ɪ ʔ
ရေယုန်	j è j ò ʊ ɴ
ရယ်	j ì
ဒကာ	d ə ɡ à
နှုတ်	n̥ o ʊ ʔ
ထမင်းသုပ်	tʰ a̰ m ɪ́ ɴ θ o ʊ ʔ
မျော	m j ɔ́
မန်နေဂျာ	m à ɴ n è d͡ʑ à
နီကာရာဂွါ	n ì k à ɹ à ɡ w à
သွပ်	θ ʊ ʔ
သမိုင်း	θ ə m á ɪ ɴ
ပဌမ	p a̰ tʰ a̰ m a̰
ထယ်	tʰ ɛ̀
တောင်အာဖရိက	t à ʊ ɴ ʔ à pʰ ə ɹ ḭ k a̰
ရေခဲမုန့်	j è ɡ ɛ́ m o̰ ʊ ɴ
သတ္တုစပ်	θ a ʔ t ṵ z a ʔ
နံရိုး	n à ɴ j ó
နှလုံးရောဂါ	n̥ ə l ó ʊ ɴ j ɔ́ ɡ à
သိုးမွေး	θ ó m w é
ကနုတ်	k ə n o ʊ ʔ
ဘော	b ɔ́
သခွား	θ a̰ kʰ w á
ဆေးခြောက်	sʰ é d͡ʑ a ʊ ʔ
ခနုံထုပ်	kʰ a̰ n ò ʊ ɴ d o ʊ ʔ
လိုဏ်ခေါင်း	l̥ à ɪ ɴ ɡ á ʊ ɴ
ကြက်မောက်	t͡ɕ ɛ ʔ m a ʊ ʔ
ရန်ကုန်	j à ɴ ɡ ò ʊ ɴ
စွတ်စွတ်နာ	s ʊ ʔ s ʊ ʔ n à
ယောက္ခမ	j a ʊ ʔ kʰ ə m a̰
ဝေး	w é
လက်ကိုင်ပဝါ	l ɛ ʔ k à ɪ ɴ p a̰ w à
ဝိသေသလက္ခဏာ	w ḭ θ è θ a̰ l ɛ ʔ kʰ ə n à
ဂိရိမေခလာ	ɡ ḭ ɹ ḭ m è kʰ ə l à
စပွတ်နစ်	s ə p ʊ ʔ n ɪ ʔ
ဖြောဖြော	pʰ j ɔ́ b j ɔ́
ဘာကီးနားဖားဆို	b à k í n á pʰ á sʰ ò
ငှက်ဖျား	ŋ̊ ɛ ʔ pʰ j á
နာနာဘာဝ	n à n à b à w a̰
နာမ်စား	n à m z á
ဓား	d á
ဥပါကြယ်	ʔ ṵ p à t͡ɕ ɛ̀
ဖရုံ	pʰ ə j ò ʊ ɴ
ဆင်စွယ်	sʰ ɪ̀ ɴ z w ɛ̀
အဖ	ʔ ə pʰ a̰
ဥုံ	ʔ ò ʊ ɴ
အာကာသ	ʔ à k à θ a̰
မြေပုံ	m j è b ò ʊ ɴ
ကျိုင်းတုံ	t͡ɕ á ɪ ɴ t ò ʊ ɴ
ဂေါ်ဖီထုပ်	ɡ ɔ̀ b ì d o ʊ ʔ
တံတိုင်း	d ə d á ɪ ɴ
ကုန်းနှီး	k ó ʊ ɴ n̥ í
စင်္ကာပူ	s ɪ̀ ɴ ɡ ə p ù
ဘလိဇ်	b ə l ì z
ဥပေက္ခါ	ʔ ṵ p ɛ ʔ kʰ à
မေတ္တေယျ	m j ɪ ʔ t è j a̰
ထိ	tʰ ḭ
မယား	m ə j á
ပုဗ္ဗ	p o ʊ ʔ b a̰
ဝိဇ္ဇာပညာ	w e ɪ ʔ z à p j ɪ̀ ɴ ɲ à
ဓာတ်ဆီ	d a ʔ sʰ ì
အမေး	ʔ ə m é
ဈေး	z é
ယင်းမာ	j ɪ́ ɴ m à
ရွှေဖြူ	ʃ w è b j ù
ယောက်	j a ʊ ʔ
ဖားပြုပ်	pʰ ə b j o ʊ ʔ
အပြစ်	ʔ ə p j ɪ ʔ
မဟာဝင်	m ə h à w ɪ̀ ɴ
အကုန်	ʔ ə k ò ʊ ɴ
အရာ	ʔ ə j à
ပဲပိုးတီ	p ɛ́ p ó d ì
ငါးမျှားတံ	ŋ ə m̥ j á d à ɴ
ရေးရေး	j é j é
ပုရွက်ဆိတ်	p ə j w ɛ ʔ sʰ e ɪ ʔ
စီးကရက်	s í k ə ɹ ɛ ʔ
ဒသမ	d a̰ θ ə m a̰
ယမမင်း	j ə m a̰ m ɪ́ ɴ
စက်လှေကား	s ɛ ʔ l̥ è ɡ á
မီးသွေး	m í ð w é
ဒေသန္တရ	d è θ à ɴ t ə j a̰
ကတ္တား	k a ʔ t á
အစီရင်ခံ	ʔ ə s ì j ɪ̀ ɴ kʰ à ɴ
အနာကြီးရောဂါ	ʔ ə n à d͡ʑ í j ɔ́ ɡ à
အာလူးပူရီ	ʔ à l ú p ù j ì
မြစ်	m j ɪ ʔ
ကျောရိုး	t͡ɕ ɔ́ j ó
ဓမ္မတာလာ	d ə m ə d à l à
လယ်ထွန်မင်္ဂလာ	l ɛ̀ tʰ ʊ̀ ɴ m ɪ̀ ɴ ɡ ə l à
တယ်	t ɛ̀
လွတ်လပ်ရေးနေ့	l ʊ ʔ l a ʔ j é n ḛ
ဂျေရုဆလင်	d͡ʑ è ɹ ṵ sʰ a̰ l ɪ̀ ɴ
ဝါသနာ	w à ð a̰ n à
ဖော့ဖျက်	pʰ ɔ̰ b j ɛ ʔ
ကြောင်ထီး	t͡ɕ à ʊ ɴ d í
ဆွီဒင်	sʰ w ì d ɪ̀ ɴ
ထောပတ်	tʰ ɔ́ b a ʔ
တွေး	t w é
ဘိသိက်	b e ɪ ʔ θ e ɪ ʔ
ဗိသုကာ	b ḭ ð ə ɡ à
မြေခွေး	m j è ɡ w é
ပြပွဲ	p j a̰ b w ɛ́
ဆရာလေး	sʰ ə j à l é
အချင်းဝက်	ʔ ə t͡ɕʰ ɪ́ ɴ w ɛ ʔ
အစု	ʔ ə s ṵ
အထဲ	ʔ ə tʰ ɛ́
ဗလာစာအုပ်	b ə l à s à ʔ o ʊ ʔ
စိုင်း	s á ɪ ɴ
အစိမ်း	ʔ ə s é ɪ ɴ
မူလတန်း	m ù l a̰ t á ɴ
ဝေါဟာရ	w ɔ́ h à ɹ a̰
ရှလကာရည်	ʃ à l ə k à j è
ခရစ်ယာန်	kʰ ə ɹ ɪ ʔ j à n
လက်သည်း	l ɛ ʔ θ ɛ́
ဆိုက်ကား	sʰ a ɪ ʔ k á
ဗန်းမော်	b á ɴ m ɔ̀
ဇိမ်မယ်	z è ɪ ɴ m ɛ̀
မြေးမ	m j é m a̰
အယ်ဆာဗေဒို	ʔ ɛ̀ sʰ à b è d ò
စကားပြန်	z ə ɡ ə b j à ɴ
ထုတ်ကုန်	tʰ o ʊ ʔ k ò ʊ ɴ
ကလပ်	k ə l a ʔ
ကိုယ်	k ò
ဖွဲ့စည်းပုံ	pʰ w ɛ̰ z í b ò ʊ ɴ
ကြောင်မ	t͡ɕ à ʊ ɴ m a̰
အာလူးဖုတ်	ʔ à l ú pʰ o ʊ ʔ
သိုးဆောင်း	θ ó sʰ á ʊ ɴ
မန္တလေး	m à ɴ d ə l é
မဟာဘွဲ့	m ə h à b w ɛ̰
ဆူရာနမ်	sʰ ù ɹ à n à ɴ
ဖောက်သည်	pʰ a ʊ ʔ θ è
လေးထောင့်	l é d a̰ ʊ ɴ
ဗီယင်ကျန်း	b ì j ɪ̀ ɴ t͡ɕ á ɴ
ဆံပင်တု	z ə b ɪ̀ ɴ d ṵ
ပင်စင်	p ɪ̀ ɴ s ɪ̀ ɴ
ပြစ်မှု	p j ɪ ʔ m̥ ṵ
လှပ	l̥ a̰ p a̰
ဓာတုဗေဒ	d à t ṵ b è d a̰
လက်နှိပ်စက်	l ɛ ʔ n̥ e ɪ ʔ s ɛ ʔ
သလွဲ	θ ə l w ɛ́
နွယ်တာ	n w ɛ̀ t à
မြေဖြူခဲ	m j è b j ù ɡ ɛ́
ဘဏ်တိုက်	b à ɴ d a ɪ ʔ
ရုပ်တု	j o ʊ ʔ t ṵ
ထေရဝါဒ	tʰ è j a̰ w à d a̰
အပြာမယ်	ʔ ə p j à m ɛ̀
ဂေါ်ရခါး	ɡ ɔ̀ j ə kʰ á
အသိုက်	ʔ ə θ a ɪ ʔ
ဝါဒ	w à d a̰
ရပ်ကွက်	j a ʔ k w ɛ ʔ
မွန်တီနီဂရိုး	m ʊ̀ ɴ t ì n ì ɡ ə ɹ ó
ဒီပါ	d ì p à
ကုလား	k ə l á
ဝစီကံ	w ə z ì ɡ à ɴ
ကောင်းကင်	k á ʊ ɴ ɡ ɪ̀ ɴ
ရာဘ	j à b a̰
ကော်မတီ	k ɔ̀ m ə t ì
အော်ပရာ	ʔ ɔ̀ p ə ɹ à
ကုန်သည်	k ò ʊ ɴ ð è
နဂါးမောက်	n a̰ ɡ á m a ʊ ʔ
စက်တင်ဘာ	s ɛ ʔ t ɪ̀ ɴ b à
ယမ်းမှုန့်	j á ɴ m̥ o̰ ʊ ɴ
လက်တန်း	l ɛ ʔ t á ɴ
အပိုဒ်	ʔ ə p a ɪ ʔ
အဂ္ဂမဟာပဏ္ဍိတ	ʔ ɛ ʔ ɡ a̰ m ə h à p à ɴ d ḭ t a̰
ဝက်ဘ်ဆိုဒ်	w ɛ ʔ b sʰ a ɪ ʔ
ဂျုံ	d͡ʑ ò ʊ ɴ
ကောက်ညှင်းပေါင်း	k a ʊ ʔ ɲ̊ ɪ́ ɴ b á ʊ ɴ
ပရိယာယ်	p ə ɹ ḭ j è
ခဏခဏ	kʰ ə n a̰ ɡ ə n a̰
ပလတ်စတစ်	p ə l a ʔ s ə t ɪ ʔ
ပြွတ်	p j ʊ ʔ
ကယ်တင်ရှင်	k ɛ̀ t ɪ̀ ɴ ʃ ɪ̀ ɴ
အလုပ်သမား	ʔ ə l o ʊ ʔ θ ə m á
အမှုန်	ʔ ə m̥ ò ʊ ɴ
ဘူမိရူပဗေဒ	b ù m ḭ j ù p a̰ b è d a̰
သီးပင်	θ í b ɪ̀ ɴ
ငရဲသား	ŋ ə j ɛ́ ð á
လင်းဇင်း	l ɪ́ ɴ z ɪ́ ɴ
ဆေးလုံး	sʰ é l ó ʊ ɴ
ငန်း	ŋ á ɴ
ဝက်မှင်ဘီး	w ɛ ʔ m̥ ɪ̀ ɴ b í
နွား	n w á
မေ့	m ḛ
ပါပူအာနယူးဂီနီ	p à p ù ʔ à n ə j ú ɡ ì n ì
ယာယီ	j à j ì
သည်မှာ	ð ì m̥ à
မှာ	m̥ à
ငွေ	ŋ w è
အရှေ့	ʔ ə ʃ ḛ
ကြာ	t͡ɕ à
သရဏဂုံသုံးပါး	θ ə j ə n ə ɡ ò ʊ ɴ θ ó ʊ ɴ b á
ကွင်း	k w ɪ́ ɴ
အရီးလေး	ʔ ə j í l é
နေစကြဝဠာ	n è s ɛ ʔ t͡ɕ à w ə l à
တွန်း	t ʊ́ ɴ
ပသျှူးရာမ	p ə ʃ ú j à m a̰
တြိပူရ	t ə ɹ ḭ p ù j a̰
ကမ္ဘာ	ɡ ə b à
ဗိုလ်ကြီး	b ò d͡ʑ í
ဖွား	pʰ w á
ကိုရမ်ကျမ်း	k ò ɹ à ɴ t͡ɕ á ɴ
တိုဟူးနွေး	t ò h ú n w é
ဇင်ဘာဘွေ	z ɪ̀ ɴ b à b w è
လင်ပန်း	l ɪ̀ ɴ b á ɴ
ကျနော်	t͡ɕ ə n ɔ̀
အင်္ဂတေ	ʔ ɪ̀ ɴ ɡ ə d è
ကျိန်း	t͡ɕ é ɪ ɴ
အီကွေတာ	ʔ ì k w è t à
မြန်မာ	m j à ɴ m à
ဗိဿနိုး	b e ɪ ʔ θ ə n ó
ခွာနာလျှာနာ	kʰ w à n à ʃ à n à
ခမည်းတော်	kʰ ə m í d ɔ̀
မြင့်	m j ɪ̰ ɴ
အလား	ʔ ə l á
မင်းသား	m ɪ́ ɴ ð á
မိုးကြိုး	m ó d͡ʑ ó
ဒေသ	d è θ a̰
ဂငယ်ကွေ့	ɡ a̰ ŋ ɛ̀ ɡ w ḛ
သနပ်	θ ə n a ʔ
ရှေ့	ʃ ḛ
ရေး	j é
ဘက္ကဒီးအစ်	b ɛ ʔ k ə d í ʔ ɪ ʔ
သပ်	θ a ʔ
သတ်ဖြတ်	θ a ʔ pʰ j a ʔ
သွေးအုပ်စု	θ w é ʔ o ʊ ʔ s ṵ
ကိုယ်ဝန်ဆောင်	k ò j w ʊ̀ ɴ sʰ à ʊ ɴ
အဲဒါဘာလဲ	ʔ ɛ́ d à b à l ɛ́
ဟောင်ကောင်	h à ʊ ɴ k à ʊ ɴ
ကိုး	k ó
လယ်ယာ	l ɛ̀ j à
ဟုတ်တာပေါ့	h o ʊ ʔ t à p ɔ̰
သစ်တို	θ ɪ ʔ t ò
သီဟ	θ ì h a̰
ဟင်းခါး	h ɪ́ ɴ ɡ á
မျိုးစု	m j ó z ṵ
ရာဇဂုရု	j à z a̰ ɡ ṵ ɹ ṵ
ပျဉ်းကတိုး	p j ɪ́ ɴ ɡ ə d ó
ဖမ်း	pʰ á ɴ
ဇာတ်တော်	z à t
ကိုဘော့	k ò b ɔ̰
သူငယ်ချင်း	θ ə ŋ ɛ̀ d͡ʑ ɪ́ ɴ
ကောင်မလေး	k à ʊ ɴ m a̰ l é
ခရစ်တော်	kʰ ə ɹ ɪ ʔ t ɔ̀
သုဓမ္မသိင်္ဂီ	θ ṵ d à ɴ m a̰ θ è ɪ ɴ ɡ ì
ကောင်တာ	k à ʊ ɴ t à
မဲဆောက်	m ɛ́ sʰ a ʊ ʔ
သင်္ကြန်ထမင်း	ð ə d͡ʑ à ɴ tʰ ə m ɪ́ ɴ
ရေမွှေး	j è m̥ w é
စက်ရုံ	s ɛ ʔ j ò ʊ ɴ
သူခိုး	θ ə kʰ ó
ဒေဝဒတ်	d è w ə d a ʔ
ရက်ကန်း	j ɛ ʔ k á ɴ
မိခင်	m ḭ ɡ ɪ̀ ɴ
မုခ်	m o ʊ ʔ
မှု	m̥ ṵ
အော်ဒါ	ʔ ɔ̀ d à
လေထိုးတံ	l è tʰ ó d à ɴ
ဗီဒီယို	b ì d ì j ò
သာယာဝတီ	θ à j à w ə d ì
ပင်စိမ်း	p ɪ̀ ɴ z é ɪ ɴ
ပညာရေး	p j ɪ̀ ɴ ɲ à j é
ဗိုလ်မှူးချုပ်	b ò m̥ ú d͡ʑ o ʊ ʔ
ပေါက်စီ	p a ʊ ʔ s ì
ရာဟုလာ	j à h ṵ l à
မျက်ခွံ	m j ɛ ʔ kʰ ʊ̀ ɴ
ဒုံမင်း	d ò ʊ ɴ m ɪ́ ɴ
တတိယ	t a̰ t ḭ j a̰
မှန်	m̥ à ɴ
ပြည်နယ်	p j ì n ɛ̀
ဒန့်သလွန်	d a̰ ɴ ð ə l ʊ̀ ɴ
ဘုန်းကြီး	pʰ ó ʊ ɴ d͡ʑ í
စက္ကူ	s ɛ ʔ k ù
ဗြဟ္မာ	b j ə m à
နား	n á
နန်းပြားသုပ်	n á ɴ b j á θ o ʊ ʔ
ဘုန်း	pʰ ó ʊ ɴ
ထို	tʰ ò
မျည်းတံ	m j í d à ɴ
လုံခြုံရေး	l ò ʊ ɴ d͡ʑ ò ʊ ɴ j é
ငှက်ပျော	ŋ ə p j ɔ́
အာနီ	ʔ à n ì
ပြင်ပြင်	p j ɪ̀ ɴ b j ɪ̀ ɴ
ပဲပင်ပေါက်	p ɛ́ b ɪ̀ ɴ b a ʊ ʔ
ပါတီ	p à t ì
ကချင်	k ə t͡ɕʰ ɪ̀ ɴ
မျက်နှာကြက်	m j ɛ ʔ n̥ à d͡ʑ ɛ ʔ
မွှေး	m̥ w é
ရေခဲသေတ္တာ	j è ɡ ɛ́ θ ɪ ʔ t à
ကောလိသိန်	k ɔ́ l ḭ θ è ɪ ɴ
ဒဂုံ	d ə ɡ ò ʊ ɴ
ကိစ္စ	k e ɪ ʔ s a̰
ဆွဲ	sʰ w ɛ́
ပုထိုး	p ə tʰ ó
ဖွဲ့စည်းပုံအခြေခံဥပဒေ	pʰ w ɛ̰ z í b ò ʊ ɴ ʔ ə t͡ɕʰ è ɡ à ɴ ʔ ṵ b ə d è
လှေး	l̥ é
လက်ချောင်း	l ɛ ʔ t͡ɕʰ á ʊ ɴ
မဟာပညာဗလ	m ə h à p j ɪ̀ ɴ ɲ à b ə l a̰
ခန္ဓာ	kʰ à ɴ d à
လူစုလူဝေး	l ù z ṵ l ù w é
အကွ	ʔ ə k w a̰
မိသားစု	m ḭ ð á z ṵ
အက်စတိုးနီးယား	ʔ ɛ ʔ s ə t ó n í j á
တူရကီ	t ù ɹ ə k ì
တိုရှေ	t ò ʃ è
လိပ်စာ	l e ɪ ʔ s à
ကတ်	k a ʔ
စတိုး	s ə t ó
လို့	l o̰
လေဖြတ်ရောဂါ	l è pʰ j a ʔ j ɔ́ ɡ à
တွပ်	t ʊ ʔ
ဈေးကြီး	z é t͡ɕ í
ရောင်	j à ʊ ɴ
ပါး	p á
ဓမ္မတာကာလ	d ə m ə d à k à l a̰
အမှာ	ʔ ə m̥ à
နရန်း	n ə j á ɴ
လေယာဉ်	l è j ɪ̀ ɴ
သရ	θ ə ɹ a̰
သွေးတိုးရောဂါ	θ w é t ó j ɔ́ ɡ à
တောင်သူလယ်သမား	t à ʊ ɴ ð ù l ɛ̀ ð ə m á
ရရစ်	j a̰ j ɪ ʔ
ထွန်း	tʰ ʊ́ ɴ
ဂိုဏ်း	ɡ ó n
မှား	m̥ á
သတ္တုတွင်း	θ a ʔ t ṵ d w ɪ́ ɴ
ဥပါလိ	ʔ ṵ p à l ḭ
မိုင်း	m á ɪ ɴ
ပန်းတဉ်း	b ə d ɪ́ ɴ
ဝက်ခြံ	w ɛ ʔ t͡ɕʰ à ɴ
ထောင်ကဲ	tʰ à ʊ ɴ k ɛ́
ဝိုက်ချ	w a ɪ ʔ t͡ɕʰ a̰
ရေဒီယို	ɹ è d ì j ò
စာမရီ	s à m a̰ j ì
ဆိတ်ထီး	sʰ e ɪ ʔ tʰ í
ရိတ်	j e ɪ ʔ
နို့လိမ်	n o̰ l è ɪ ɴ
မိဘမဲ့	m ḭ b a̰ m ɛ̰
အညီ	ʔ ə ɲ ì
စပ်	s a ʔ
ကြွပ်	t͡ɕ ʊ ʔ
တရုတ်နံနံ	t a̰ j o ʊ ʔ n à ɴ n à ɴ
မဲဆန္ဒနယ်	m ɛ́ sʰ à ɴ d a̰ n ɛ̀
ပန်	p à ɴ
ကာကွယ်ရေး	k à ɡ w ɛ̀ j é
သံလိုက်	θ à ɴ l a ɪ ʔ
ယုတ္တိ	j o ʊ ʔ t ḭ
ပတ်တီး	p a ʔ t í
သန္ဓေသား	ð ə d è ð á
ဒုတိယတပ်ကြပ်	d ṵ t ḭ j a̰ t a ʔ t͡ɕ a ʔ
မျက်လွှာ	m j ɛ ʔ l̥ w à
မဲ	m ɛ́
ကပွဲရုံ	k a̰ b w ɛ́ j ò ʊ ɴ
သဘက်ခါ	θ ə b ɛ ʔ kʰ à
သမုဒ္ဒရာ	θ ə m o ʊ ʔ d ə j à
ရုက္ခဗေဒ	j o ʊ ʔ kʰ a̰ b è d a̰
မြန်	m j à ɴ
ထီးတင်	tʰ í t ɪ̀ ɴ
ဝိနည်း	w ḭ n í
ထိုင်း	tʰ á ɪ ɴ
ဖဲကြိုး	pʰ ɛ́ d͡ʑ ó
မှ	m̥ a̰
ပရိဒေဝ	p ə ɹ ḭ d è w a̰
ကြေးကြီး	t͡ɕ é t͡ɕ í
ရေညှိ	j è ɲ̊ ḭ
ကရင်	k ə j ɪ̀ ɴ
ဒိုင်ယာနာ	d à ɪ ɴ j à n à
ရင်ဘတ်	j ɪ̀ ɴ b a ʔ
ဆေးဘဲဥ	sʰ é b ɛ́ ʔ ṵ
လိပ်ပြာ	l e ɪ ʔ p j à
သစ္စာလေးပါး	θ ɪ ʔ s à l é p á
ဝါသနာရှင်	w à ð ə n à ʃ ɪ̀ ɴ
သီချင်း	θ ə t͡ɕʰ ɪ́ ɴ
အသီး	ʔ ə θ í
ရှမ်းခေါက်ဆွဲ	ʃ á ɴ kʰ a ʊ ʔ sʰ w ɛ́
မုသား	m ṵ ð á
မုန့်ဦးနှောက်	m o̰ ʊ ɴ ʔ ó ʊ ɴ ð í
မဏ္ဍိုင်	m à ɴ d à ɪ ɴ
ယောက်ဖ	j a ʊ ʔ pʰ a̰
သင်္ကြန်မိုး	θ ɪ̀ ɴ d͡ʑ à ɴ m ó
ဒေတာဘေ့စ်	d è t à b ḛ s
ကောင်စစ်ဝန်ရုံး	k à ʊ ɴ s ɪ ʔ w ʊ̀ ɴ j ó ʊ ɴ
ချမ်း	t͡ɕʰ á ɴ
သက္ကတ	θ ɛ ʔ k ə t a̰
တစ္ဆေ	t ə sʰ è
သရုပ်ဖော်	θ ə j o ʊ ʔ pʰ ɔ̀
ဖွင့်	pʰ w ɪ̰ ɴ
ဦးခွံ	ʔ ú ɡ ʊ̀ ɴ
အသုဘ	ʔ a̰ θ ṵ b a̰
ကျောက်မီး	t͡ɕ a ʊ ʔ m í
မြန်မြန်	m j à ɴ m j à ɴ
ဗြိတိသျှ	b ə ɹ ḭ t ḭ ʃ a̰
အာဝါဟဝိဝါဟ	ʔ à w à h a̰ w ḭ w à h a̰
ငံ	ŋ à ɴ
မိုက်	m a ɪ ʔ
ဘိက္ခု	b e ɪ ʔ kʰ ṵ
စိုက်ပျိုးရေး	s a ɪ ʔ p j ó j é
မဟာမောဂ္ဂလာန်	m ə h à m a ʊ ʔ ɡ ə l à ɴ
နော်	n ɔ̀
ဟော်ကီ	h ɔ̀ k ì
ပစ်	p j ɪ ʔ
လက်ဖက်ရည်	l ə pʰ ɛ ʔ j è
ဇေ	z è
မွတ်	m ʊ ʔ
သိုးမ	θ ó m a̰
သမာသမတ်	θ ə m à θ ə m a ʔ
လိုင်စင်	l à ɪ ɴ s ɪ̀ ɴ
ယာဉ်	j ɪ̀ ɴ
ဆေးခန်း	sʰ é kʰ á ɴ
အင်ဂိုလာ	ʔ ɪ̀ ɴ ɡ ò l à
ငရုတ်	ŋ ə j o ʊ ʔ
တညင်းသီး	d ə ɲ ɪ́ ɴ ð í
လက်သမား	l ɛ ʔ θ a̰ m á
ဝိုင်း	w á ɪ ɴ
မြို့တော်	m j o̰ d ɔ̀
ကန့်	k a̰ ɴ
ပုံနှိပ်စက်	p ò ʊ ɴ n̥ e ɪ ʔ s ɛ ʔ
ဆု	sʰ ṵ
ဝါး	w á
ယာမာ	j à m à
ပြီးပြီ	p í b ì
ဆိုက်ဘေးရီးယား	sʰ a ɪ ʔ b é ɹ í j á
အလ္လာဟ်	ʔ à l l à h
ဘယ်နှ	b ɛ̀ n̥ a̰
ဂဠုန်	ɡ ə l ò ʊ ɴ
မီနူး	m ì n ú
ဘုံပိုင်	b ò ʊ ɴ b à ɪ ɴ
အိုင်အိုင်	ʔ à ɪ ɴ ʔ à ɪ ɴ
တူ	t ù
သွားတိုက်ဆေး	θ w á d a ɪ ʔ sʰ é
သားမြီးယပ်	θ á m j í j a ʔ
ရုပ်	j o ʊ ʔ
ဝဇီရာ	w ə z ì j à
ဘုရင်	b a̰ j ɪ̀ ɴ
အာဏာသိမ်း	ʔ à n à θ é ɪ ɴ
ဟီလီယမ်	h ì l ì j à ɴ
ကာကွယ်	k à ɡ w ɛ̀
စဉ်းစား	s ɪ́ ɴ z á
အရမ်း	ʔ ə j á ɴ
ဘယ်လောက်	b ɛ̀ l a ʊ ʔ
ကူ	k ù
အဆွေး	ʔ ə sʰ w é
မြေပြန့်	m j è b j a̰ ɴ
မဟာပိန္နဲ	m ə h à p è ɪ ɴ n ɛ́
အနို့	ʔ ə n o̰
ဆက်သွယ်ရေး	sʰ ɛ ʔ θ w ɛ̀ j é
ညကြီး	ɲ a̰ t͡ɕ í
မိုးခေါ်	m ó kʰ ɔ̀
ကိတ်ဗာဒီ	k e ɪ ʔ b ə d ì
အရွတ်	ʔ ə j ʊ ʔ
ပရုတ်	p ə j o ʊ ʔ
စိန်	s è ɪ ɴ
ကြိုဆိုပါ၏	t͡ɕ ò z ò b à ʔ ɛ̰
အထိမ်းအမှတ်	ʔ ə tʰ é ɪ ɴ ʔ ə m̥ a ʔ
တာရာ	t à j à
စက်သေနတ်	s ɛ ʔ θ ə n a ʔ
လူသတ်မှု	l ù ð a ʔ m̥ ṵ
ဥဿဖရား	ʔ o ʊ ʔ θ ə pʰ ə j á
နွေဦးပေါက်	n w è ʔ ú b a ʊ ʔ
မြို့	m j o̰
ရူပကအလင်္ကာ	j ù p ə k a̰ ʔ ə l ì ɡ à
သည်	θ è
ဇော်ဂျီ	z ɔ̀ d͡ʑ ì
လီဆိုသို	l ì sʰ ò θ ò
ဂိတ်	ɡ e ɪ ʔ
ခြေစွပ်	t͡ɕʰ è z ʊ ʔ
ဝိဟာရ	w ḭ h à j a̰
စာဖတ်	s à pʰ a ʔ
ပွဲတော်	p w ɛ́ d ɔ̀
လှည်း	l̥ ɛ́
တရုတ်စံကား	t a̰ j o ʊ ʔ s à ɴ k á
သံ့သံ့	θ a̰ ɴ ð a̰ ɴ
ရွှံ့	ʃ ʊ̰ ɴ
ရဝမ်ဒါ	ɹ ə w à ɴ d à
ပု	p ṵ
ဝမ်းနည်း	w á ɴ n é
နတ်ရွာစံ	n a ʔ j w à s à ɴ
အနိစ္စ	ʔ ə n è s s a̰
ရဲသား	j ɛ́ ð á
စုံဖက်	s ò ʊ ɴ pʰ ɛ ʔ
ပိရမစ်	p ḭ ɹ ə m ɪ ʔ
သူဇာ	θ ù z à
ပြာခွက်	p j à ɡ w ɛ ʔ
ထွက်	tʰ w ɛ ʔ
သီးစုံချဉ်ရည်	θ í z ò ʊ ɴ t͡ɕʰ ɪ̀ ɴ j ì
သိမ်	θ è ɪ ɴ
နယ်စပ်	n ɛ̀ z a ʔ
ခွန်	kʰ ʊ̀ ɴ
ပန်းဆယ်မျိုး	p á ɴ sʰ ɛ̀ m j ó
တီဗီ	t ì b ì
နန်းမြင့်	n á ɴ m j ɪ̰ ɴ
ကြည်းတပ်	t͡ɕ í d a ʔ
ရိုးရိုး	j ó j ó
ချစ်	t͡ɕʰ ɪ ʔ
ဗုဒ္ဓ	b o ʊ ʔ d a̰
အချင်း	ʔ ə t͡ɕʰ ɪ́ ɴ
နှင်းသီး	n̥ ɪ́ ɴ ð í
အမြှုပ်	ʔ ə m̥ j o ʊ ʔ
သန္တာ	θ à ɴ d à
မုန်လာဥ	m ò ʊ ɴ l à ʔ ṵ
စာလုံးပေါင်းသတ်ပုံ	s ə l ó ʊ ɴ b á ʊ ɴ θ a ʔ p ò ʊ ɴ
အဋ္ဌမ	ʔ a ʔ tʰ ə m a̰
အာရှ	ʔ à ʃ a̰
အိန္ဒြာ	ʔ è ɪ ɴ d ɹ à
သာဝက	θ à w ə k a̰
သာသနာ	θ à ð ə n à
ရှမ်း	ʃ á ɴ
ဝါ	w à
အကြမ်းဖက်ဝါဒ	ʔ ə t͡ɕ á ɴ pʰ ɛ ʔ w à d a̰
ရန်သူ	j à ɴ ð ù
မော်လတာ	m ɔ̀ l ə t à
လေ့ကျင့်ခန်း	l ḛ t͡ɕ ɪ̰ ɴ ɡ á ɴ
ဗီရို	b ì j ò
ဆပ်ပြာ	sʰ a ʔ p j à
ဧကာဒသမ	ʔ è k à d a̰ θ ə m a̰
ဇာဂနာ	z à ɡ ə n à
ရွှေဖရုံသီး	ʃ w è pʰ ə j ò ʊ ɴ ð í
အမရပူရ	ʔ ə m ə j a̰ p ù j a̰
အနုပညာ	ʔ ə n ṵ p j ɪ̀ ɴ ɲ à
ဖီဂျီ	pʰ ì d͡ʑ ì
ဗိုလ်ချုပ်ကြီး	b ò d͡ʑ o ʊ ʔ d͡ʑ í
ကချေသည်	k a̰ d͡ʑ è ð è
ဓာတ်ခွက်	d à t kʰ w ɛ ʔ
စမူဆာသုပ်	s ə m ù z à θ o ʊ ʔ
နက်ဖြန်	n ɛ ʔ pʰ j à ɴ
မောက်ချ	m a ʊ ʔ t͡ɕʰ a̰
လူပျို	l ù b j ò
ရုက္ခစိုး	j o ʊ ʔ ɡ ə z ó
ဇာ	z à
ကရဝိက်	k ə ɹ a̰ w e ɪ ʔ
သာဂူ	θ à ɡ ù
သဏ္ဍာန်	θ ə d à ɴ
ဧပြီ	ʔ è b j ì
အဘိဓာန်	ʔ ə b ḭ d à ɴ
ကော်ဇော	k ɔ̀ z ɔ́
ဖောင်	pʰ à ʊ ɴ
အကျော်	ʔ ə t͡ɕ ɔ̀
နှိပ်ကြယ်သီး	n̥ e ɪ ʔ t͡ɕ ɛ̀ ð í
မိဖုရား	m ḭ b ə j á
စားသောက်ဆိုင်	s á θ a ʊ ʔ sʰ à ɪ ɴ
ဖေါ်ပြချက်	pʰ ɔ̀ p j a̰ t͡ɕʰ ɛ ʔ
ကောင်ငယ်	k à ʊ ɴ ŋ ɛ̀
မေ	m è
ကြက်ဖ	t͡ɕ ɛ ʔ pʰ a̰
သူရိန်	θ ù j è ɪ ɴ
ရိပ်ရိပ်	j e ɪ ʔ j e ɪ ʔ
သိပ်	θ e ɪ ʔ
စီးပွားရေးသမား	s í b w á j é ð ə m á
ကွမ်ရင်မယ်တော်	k w à ɴ j ɪ̀ ɴ m ɛ̀ d ɔ̀
မှန်ဘီလူး	m̥ à ɴ b ə l ú
သီဟိုဠ်	θ ì h ò
အလုပ်	ʔ ə l o ʊ ʔ
ဆင်း	sʰ ɪ́ ɴ
လက်ဖက်သုပ်	l ə pʰ ɛ ʔ θ o ʊ ʔ
ထဲ	tʰ ɛ́
လာ	l à
ဗန်တို	b à ɴ d ò
ဇာတ်ကြီးဆယ်ဘွဲ့	z à t d͡ʑ í sʰ ɛ̀ b w ɛ̰
ပဉ္စင်တူရိယာ	p j ɪ ʔ s ɪ̀ ɴ t ù ɹ ḭ j à
တရုတ်နှင်းသီး	t a̰ j o ʊ ʔ n̥ ɪ́ ɴ θ í
ဇာတ်ညွှန်း	z à t ɲ̊ ʊ́ ɴ
ဆူးပုပ်	sʰ ú b o ʊ ʔ
ဆော်ဒီအာရေဗ္ယ	sʰ ɔ̀ d ì ʔ à ɹ è b j a̰
မြို့စား	m j o̰ z á
အလှဆီ	ʔ ə l̥ a̰ z ì
ယဝဒီပ	j a̰ w a̰ d ì p a̰
ပျော်ပျော်	p j ɔ̀ b j ɔ̀
ရေနဂါး	j è n ə ɡ á
ကတော့	ɡ ə d ɔ̰
ကား	k á
ငွေ့ငွေ့	ŋ w ḛ ŋ w ḛ
ပုသိမ်	p ə θ è ɪ ɴ
ခေါင်းပေါင်း	ɡ á ʊ ɴ b á ʊ ɴ
နန်းတော်	n á ɴ d ɔ̀
မုနိ	m ṵ n ḭ
ဂျော့ခ်ျ	d͡ʑ ɔ̰ kʰ ျ
ထောပတ်သီး	tʰ ɔ́ p a ʔ θ í
ပလိပ်	p ə l e ɪ ʔ
အလုပ်သမားနေ့	ʔ ə l o ʊ ʔ θ ə m á n ḛ
နေ့စွဲ	n ḛ z w ɛ́
စင်း	s ɪ́ ɴ
အသုပ်	ʔ ə θ o ʊ ʔ
ခရုပက်ကျိ	kʰ ə j ṵ p ɛ ʔ t͡ɕ ḭ
ပြသ	p j a̰ θ a̰
ရွှေဘို	ʃ w è b ò
သီတဂူ	θ ì d ə ɡ ù
အဖော်	ʔ ə pʰ ɔ̀
ပူဒီနာ	p ù s ì n à
ထင်	tʰ ɪ̀ ɴ
ပလူတိုနီယမ်	p ə l ù t ò n ì j à ɴ
ပန်းကန်	b ə ɡ à ɴ
ရိက္ခါ	j e ɪ ʔ kʰ à
ဒေဝါလီခံ	d è w à l ì kʰ à ɴ
တောသား	t ɔ́ ð á
လင်းဆွဲ	l ɪ́ ɴ z w ɛ́
သီအိုရီ	θ ì ʔ ò ɹ ì
ငန်	ŋ à ɴ
ပဏ္ဏာ	p ə n à
အမြီး	ʔ ə m̥ í
ကီးမား	k í m á
နိုင်ငံတော်သီချင်း	n à ɪ ɴ ŋ à ɴ d ɔ̀ θ ə t͡ɕʰ ɪ́ ɴ
တပ်	t a ʔ
ထူ	tʰ ù
အသိပညာရှင်	ʔ ə θ ḭ p j ɪ̀ ɴ ɲ à ʃ ɪ̀ ɴ
သိ	θ ḭ
စားပွဲထိုး	z á b w ɛ́ d ó
အပြုံး	ʔ ə p j ó ʊ ɴ
နိုင်ငံတော်	n à ɪ ɴ ŋ à ɴ d ɔ̀
ဖလား	pʰ ə l á
ဟားခါး	h á kʰ á
အကြွေး	ʔ ə t͡ɕ w é
ဆွမ်းမွှေး	sʰ ʊ́ ɴ m̥ w é
ပါဝါ	p à w à
လျှင်	l̥ j ɪ̀ ɴ
တောခွေး	t ɔ́ ɡ w é
ညီမျှခြင်း	ɲ ì m̥ j a̰ d͡ʑ ɪ́ ɴ
အစား	ʔ ə s á
လေထီး	l è d í
ငါးပိ	ŋ ə p ḭ
ဟိန္ဒီ	h è ɪ ɴ d ì
ဝက်	w ɛ ʔ
မင်းဘူး	m ɪ́ ɴ b ú
လိုက်ပြေး	l a ɪ ʔ p j é
အဲဒီဟာ	ʔ ɛ́ d ì h à
ထပ်တစ်ရာ	tʰ a ʔ t ə j à
ဆာရီ	sʰ à ɹ ì
ပုလိပ်	p ə l e ɪ ʔ
နို့	n o̰
ဝက်သားတုတ်ထိုး	w ɛ ʔ θ á d o ʊ ʔ tʰ ó
တီကောင်	t ì ɡ à ʊ ɴ
ကွမ်းတောင်	k ʊ́ ɴ d à ʊ ɴ
ရခိုင်	j ə kʰ à ɪ ɴ
အကျယ်	ʔ ə t͡ɕ ɛ̀
ကြက်မ	t͡ɕ ɛ ʔ m a̰
လေရဟတ်	l è j ə h a ʔ
မန္တန်	m à ɴ d à ɴ
လင်မယား	l ɪ̀ ɴ m ə j á
ဇစ်	z ɪ ʔ
ကန်	k à ɴ
မကန်း	m ə ɡ á ɴ
စော်ဘွား	s ɔ̀ b w á
လူဝံ	l ù w ʊ̀ ɴ
တနင်္လာ	t ə n ɪ́ ɴ l à
အမည်း	ʔ ə m ɛ́
ပျံတော်မူ	p j à ɴ t ɔ̀ m ù
ဂွါတီမာလာ	ɡ w à t ì m à l à
ရန်သူမျိုးငါးပါး	j à ɴ ð ù m j ó ŋ á b á
ထီးဖြူ	tʰ í b j ù
ကြိယာ	k ə ɹ ḭ j à
ပြန်ကြားရေး	p j à ɴ t͡ɕ á j é
တက္ကစီ	t ɛ ʔ k ə s ì
ဆိုင်းထိုး	sʰ á ɪ ɴ tʰ ó
ခြားနားချက်	t͡ɕʰ á n á d͡ʑ ɛ ʔ
ဘူဂေးရီးယား	b ù ɡ é ɹ í j á
ပါလီမန်	p à l ì m à ɴ
ဂျော်ဒန်	d͡ʑ ɔ̀ d à ɴ
အူ	ʔ ù
သာမိုမီတာ	θ à m ò m ì t à
ပထွေး	p ə tʰ w é
သာရိပုတ္တရာ	θ à j ḭ p o ʊ ʔ t ə j à
လူငယ်	l ù ŋ ɛ̀
မြန်မာ့	m j à ɴ m a̰
သားရေ	θ ə j è
မြွက်	m j w ɛ ʔ
ဥယျာဉ်	ʔ ṵ j ɪ̀ ɴ
အမြှောက်လက္ခဏာ	ʔ ə m̥ j a ʊ ʔ l ɛ ʔ kʰ ə n à
သင်္ဘောသီး	θ ɪ́ ɴ b ɔ́ ð í
မြှောက်ရကိန်း	m̥ j a ʊ ʔ j a̰ k é ɪ ɴ
ပြည်သူ့လွှတ်တော်	p j ì ð ṵ l̥ ʊ ʔ t ɔ̀
ယဉ်ကျေးမှု	j ɪ̀ ɴ t͡ɕ é m̥ ṵ
မျိုး	m j ó
တိုင်ပင်	t à ɪ ɴ b ɪ̀ ɴ
ဖော်ပြ	pʰ ɔ̀ p j a̰
ဓာတ်မီးပူ	d a ʔ m í b ù
ဆွစ်ဇာလန်	sʰ w ɪ ʔ z ə l à ɴ
အက	ʔ ə k a̰
အော်	ʔ ɔ̀
ယောက္ခထီး	j a ʊ ʔ kʰ ə tʰ í
ခ္ယီလီ	t͡ɕʰ ì l ì
သံကြိုးစာ	θ à ɴ d͡ʑ ó z à
ခါ	kʰ à
ဒီဇင်ဘာ	d ì z ɪ̀ ɴ b à
အနန္တောအနန္တငါးပါး	ʔ ə n à ɴ d ɔ́ ʔ ə n d a̰ ŋ á p á
ဝတ္ထု	w ʊ ʔ tʰ ṵ
မြေဩဇာ	m j è ʔ ɔ́ z à
အန်	ʔ à ɴ
ရှည်မျော	ʃ è m j ɔ́
လေးလံ	l é l à ɴ
သုဒ္ဒ	θ o ʊ ʔ d a̰
အိုလံပစ်	ʔ ò l à ɴ p ɪ ʔ
ဝိတိုရိယ	w ḭ t ò j ḭ j a̰
သစ်တော	θ ɪ ʔ t ɔ́
ရေလုပ်သား	j è l o ʊ ʔ θ á
ကျောက်	t͡ɕ a ʊ ʔ
အစ်ကို	ʔ ə k ò
ဂျာမနီ	d͡ʑ à m a̰ n ì
အပ်	ʔ a ʔ
ရွပ်ရွပ်	j ʊ ʔ j ʊ ʔ
ပလ္လင်	p ə l ɪ̀ ɴ
အနောက်	ʔ ə n a ʊ ʔ
သိင်္ဂီ	θ è ɪ ɴ ɡ ì
ခရမ်း	kʰ ə j á ɴ
သိပ္ပံဘွဲ့	θ e ɪ ʔ p à ɴ b w ɛ̰
အဆိုတော်	ʔ ə sʰ ò d ɔ̀
အာမခံ	ʔ à m a̰ ɡ à ɴ
ရောဂါ	j ɔ́ ɡ à
အခန်း	ʔ ə kʰ á ɴ
ပြန်	p j à ɴ
ဇာတ်ရုံ	z a ʔ j ò ʊ ɴ
ခြင်္သေ့မ	t͡ɕʰ ɪ̀ ɴ ð ḛ m a̰
ဧည့်	ʔ ḛ
အိုမန်	ʔ ò m à ɴ
ဆန်	sʰ à ɴ
ကမ္ဘာလုံးခြမ်း	ɡ ə b à l ó ʊ ɴ d͡ʑ à ɴ
ပန်းသေရောဂါ	p á ɴ θ è j ɔ́ ɡ à
ကိရိယာ	k ə ɹ ḭ j à
ပယ်ရှား	p ɛ̀ ʃ á
ပိုင်ရှင်	p à ɪ ɴ ʃ ɪ̀ ɴ
ရှိုး	ʃ ó
ဟုတ်	h o ʊ ʔ
လက်ဆောင်	l ɛ ʔ sʰ à ʊ ɴ
လောကနတ်	l ɔ́ k a̰ n a ʔ
ဆီပြန်	sʰ ì b j à ɴ
နို့သီး	n o̰ ð í
ရေကြီးခြင်း	j è t͡ɕ í d͡ʑ ɪ́ ɴ
စာတိုက်	s à d a ɪ ʔ
ကိလေသာ	k ḭ l è θ à
ဆူရှီ	sʰ ù ʃ ì
ညီနောင်	ɲ ì n à ʊ ɴ
အောက်တိုဘာ	ʔ a ʊ ʔ t ò b à
ကိုယ်စားလှယ်	k ò j z ə l̥ ɛ̀
ထမင်းချဉ်	tʰ ə m ɪ́ ɴ d͡ʑ ɪ̀ ɴ
ဘယာ	b ə j à
ပထဝီဝင်	p ə tʰ ə w ì w ɪ̀ ɴ
မီးသုံးပါး	m í θ ó ʊ ɴ b á
ဣရိယာပုတ်	ʔ ḭ ɹ ḭ j à b o ʊ ʔ
အဖတ်	ʔ ə pʰ a ʔ
နောက်	n a ʊ ʔ
ဆင့်	sʰ ɪ̰ ɴ
မီးဖိုချောင်	m í b ò d͡ʑ à ʊ ɴ
လူဦးရေ	l ù ʔ ú j è
ခံ	kʰ à ɴ
စောင့်	s a̰ ʊ ɴ
ရေနံ	j è n à ɴ
ကြာကြာ	t͡ɕ à d͡ʑ à
လက်အိတ်	l ɛ ʔ ʔ e ɪ ʔ
ကဝိ	k ə w ḭ
လမ်းလျှောက်	l á ɴ ʃ a ʊ ʔ
သူငယ်	θ ə ŋ ɛ̀
သစ္စာဖောက်	θ ɪ ʔ s à pʰ a ʊ ʔ
နာနတ်	n ə n a ʔ
ပန်းချီ	b ə d͡ʑ ì
ကောင်စစ်ဝန်	k à ʊ ɴ s ɪ ʔ w ʊ̀ ɴ
ရဲ	j ɛ́
လှ	l̥ a̰
စာကြည့်တိုက်	s à t͡ɕ ḭ d a ɪ ʔ
အရီး	ʔ ə j í
ဝေးကွာ	w é k w à
တောင်ပံ	t à ʊ ɴ b à ɴ
အဖေ့	ʔ ə pʰ ḛ
ဆိုမာလီယာ	sʰ ò m à l ì j à
အောက်ဆီဂျင်	ʔ a ʊ ʔ sʰ ì d͡ʑ ɪ̀ ɴ
တပည့်တော်	d ə b ḭ d ɔ̀
အသုပ်စုံ	ʔ ə θ o ʊ ʔ s ò ʊ ɴ
မော်လ်ဒိုဗာ	m ɔ̀ l d ò b à
ထိုင်ဝမ်	tʰ à ɪ ɴ w à ɴ
ဦးချို	ʔ ú d͡ʑ ò
ကွန်ကရစ်	k ʊ̀ ɴ ɡ ə ɹ ɪ ʔ
မုန့်လုံးရေပေါ်	m o̰ ʊ ɴ l ó ʊ ɴ j è b ɔ̀
ဖျောက်ဆိပ်	pʰ j a ʊ ʔ sʰ e ɪ ʔ
မယ်သီတာ	m ɛ̀ θ ì d à
ပိဋကတ်	b ḭ t ə ɡ a ʔ
ကဏန်း	ɡ ə n á ɴ
ခြေဖနောင့်	t͡ɕʰ è b ə n a̰ ʊ ɴ
ပန်းတော့	p á ɴ d ɔ̰
အဖို	ʔ ə pʰ ò
ဗလီ	b ə l ì
ခင်ပွန်း	kʰ ɪ̀ ɴ b ʊ́ ɴ
လင်းနို့	l ɪ́ ɴ n o̰
ဘာရိန်း	b à ɹ é ɪ ɴ
ဆောင်	sʰ à ʊ ɴ
သံတွဲ	θ à ɴ d w ɛ́
လည်စည်း	l è z í
ပမာဏ	p ə m à n a̰
သဲကျောက်	θ ɛ́ d͡ʑ a ʊ ʔ
ပဒေသာပင်	b ə d è ð à b ɪ̀ ɴ
ဝိညာဉ်	w è ɪ ɴ ɲ ɪ̀ ɴ
ဘုတ်	b o ʊ ʔ
ဆီရာလီယွန်	sʰ ì ɹ à l ì j ʊ̀ ɴ
ဟိမဝန္တာ	h ḭ m a̰ w ʊ̀ ɴ t à
အဝတ်အစား	ʔ ə w ʊ ʔ ʔ ə s á
ပျံ	p j à ɴ
ယုံ	j ò ʊ ɴ
အဆောက်အဦ	ʔ ə sʰ a ʊ ʔ ʔ a̰ ʔ ù
ဘရူနိုင်း	b ə ɹ ù n á ɪ ɴ
ခေါပျဉ်	kʰ ɔ́ b j ɪ̀ ɴ
သမ္မတ	θ ə m ə d a̰
သားလှောင်	θ á l̥ à ʊ ɴ
ဆပ်ကပ်	sʰ a ʔ k a ʔ
အစုရှင်	ʔ ə s ṵ ʃ ɪ̀ ɴ
မီးပြတိုက်	m í b j a̰ d a ɪ ʔ
ကောင်စီ	k à ʊ ɴ s ì
ဒီဟာ	d ì h à
ဇမ်ဘီယာ	z à ɴ b ì j à
သဘာပတိ	θ ə b à p ə t ḭ
အေး	ʔ é
မြှောက်	m̥ j a ʊ ʔ
အညစ်အထည်း	ʔ ə ɲ ɪ ʔ ʔ ə tʰ í
မီးအိမ်	m í ʔ è ɪ ɴ
တက္ကဗေဒ	t ɛ ʔ k a̰ b è d a̰
အမွှေး	ʔ ə m̥ w é
ဘာသာဗေဒ	b à θ à b è d a̰
ကြေးငွေ	t͡ɕ é ŋ w è
ဟင်္သာ	h ɪ́ ɴ θ à
ဒူးရင်းသီး	d ú j ɪ́ ɴ θ í
ကြေးနီ	t͡ɕ é n ì
လစ်တန်စတိန်း	l ɪ ʔ t à ɴ s ə t é ɪ ɴ
ကောင်းကောင်း	k á ʊ ɴ ɡ á ʊ ɴ
ထိပ်ခေါင်တင်	tʰ e ɪ ʔ kʰ à ʊ ɴ t ɪ̀ ɴ
သီတင်းသီလ	ð ə d ɪ́ ɴ θ ì l a̰
ဆွဆွ	sʰ w a̰ z w a̰
မနေ့က	m ə n ḛ ɡ a̰
ကြွင်း	t͡ɕ w ɪ́ ɴ
ဆင်ဝင်	sʰ ɪ̀ ɴ w ɪ̀ ɴ
ဟူးရား	h ú j á
ဘုရား	pʰ ə j á
မာကျောက်	m à t͡ɕ a ʊ ʔ
အိန္ဒိယ	ʔ è ɪ ɴ d ḭ j a̰
ကင်းမြီးကောက်	k ɪ́ ɴ m j í ɡ a ʊ ʔ
ထိုးမုန့်	tʰ ó m o̰ ʊ ɴ
တင်ကူး	t ɪ̀ ɴ ɡ ú
ဝမ်းရောဂါ	w ʊ́ ɴ j ɔ́ ɡ à
ရဝိန်	j ə w è ɪ ɴ
သဒ္ဓါကြေး	θ ə d à t͡ɕ é
နေ	n è
မှဲ့	m̥ ɛ̰
ဥပဒေ	ʔ ṵ b a̰ d è
ကံ့ကူတံ	k a̰ ɴ ɡ ù d à ɴ
ဥပရာဇာ	ʔ ṵ p ə ɹ à z à
ကျောက်ကပ်	t͡ɕ a ʊ ʔ k a ʔ
သုတေသန	θ ṵ t è θ ə n a̰
ကင်ဆာရောဂါ	k ɪ̀ ɴ sʰ à j ɔ́ ɡ à
သဘာဝတ္ထဗေဒ	θ ə b à w ʊ ʔ tʰ a̰ b è d a̰
အိုင်ယာလန်	ʔ à ɪ ɴ j ə l à ɴ
မာန်	m à ɴ
ဘုန်းဘုန်း	pʰ ó ʊ ɴ pʰ ó ʊ ɴ
မဟာဘာရတ	m ə h à b à ɹ ə t a̰
မကြာမတင်	m ə t͡ɕ à m ə t ɪ̀ ɴ
နှောက်	n̥ a ʊ ʔ
ကုတ်	k o ʊ ʔ
စိုက်	s a ɪ ʔ
ဘယ်တော့	b ɛ̀ d ɔ̰
နှင့်တကွ	n̥ ɪ̰ ɴ d ə ɡ w a̰
မီတာ	m ì t à
ဗိုက်	b a ɪ ʔ
ဒြပ်ထု	d ə ɹ a ʔ tʰ ù
မြောင်း	m j á ʊ ɴ
အခမဲ့	ʔ ə kʰ a̰ m ɛ̰
အသုံးပြု	ʔ ə θ ó ʊ ɴ p j ṵ
ဒီ	d ì
အပေါင်	ʔ ə p à ʊ ɴ
မှတ်စု	m̥ a ʔ s ṵ
ဆဋ္ဌမ	sʰ a ʔ tʰ ə m a̰
ဘယ်လ်ဂျီယမ်	b ɛ̀ l d͡ʑ ì j à ɴ
စွပ်	s ʊ ʔ
ကာယ	k ə j a̰
ပြည်သူပိုင်	p j ì ð ù b à ɪ ɴ
သီဂိရိယ	θ ì ɡ ḭ ɹ ḭ j a̰
ပေါ်ဆန်းမွှေး	p ɔ̀ sʰ á ɴ m̥ w é
အဓိပ္ပါယ်	ʔ ə d e ɪ ʔ b ɛ̀
ကန်စွန်း	ɡ ə z ʊ́ ɴ
ဘက်ထရီ	b ɛ ʔ tʰ a̰ ɹ ì
အမေရိက	ʔ ə m è ɹ ḭ k a̰
လက်ဝှေ့	l ɛ ʔ ʍ ḛ
ဒုယင်တော်	d ə j ɪ̀ ɴ d ɔ̀
ထက်	tʰ ɛ ʔ
ဆောက်	sʰ a ʊ ʔ
ပီလောပီနံ	p ì l ɔ́ p ì n à ɴ
ရေနံဆီ	j è n à ɴ z ì
ခဲအို	kʰ ɛ́ ʔ ò
စိမ်းစားဥ	s é ɪ ɴ z á ʔ ṵ
ဆေးပေါ့လိပ်	sʰ é b ɔ̰ l e ɪ ʔ
ရုပ်ရှင်ရုံ	j o ʊ ʔ ʃ ɪ̀ ɴ j ò ʊ ɴ
ဘီလူး	b ə l ú
စာသား	s à ð á
သော်တာ	θ ɔ̀ d à
နေ့လည်	n ḛ l ɛ̀
မော်လမြိုင်	m ɔ̀ l ə m j à ɪ ɴ
ဘူတန်	b ù t à ɴ
အာဂျင်တီးနား	ʔ à d͡ʑ ɪ̀ ɴ t í n á
ကွယ်လွန်	k w ɛ̀ l ʊ̀ ɴ
တောင်ဆူဒန်	t à ʊ ɴ sʰ ù d à ɴ
မေး	m é
ဆာယာ	sʰ à j à
မိတ်ဆွေ	m e ɪ ʔ sʰ w è
မဒါဂတ်စကား	m a̰ d à ɡ a ʔ s ə k á
ပစ္စက္ခ	p ɪ ʔ s ɛ ʔ kʰ a̰
ကြာညို့	t͡ɕ à ɲ o̰
နှုတ်ဆက်	n̥ o ʊ ʔ sʰ ɛ ʔ
ယာဘ	j à b a̰
အဝတ်လျှောက်စက်	ʔ ə w ʊ ʔ ʃ a ʊ ʔ s ɛ ʔ
မျိုးချစ်စိတ်	m j ó t͡ɕʰ ɪ ʔ s e ɪ ʔ
လက်ခံ	l ɛ ʔ kʰ à ɴ
ဧည့်သည်	ʔ ḛ ð è
အမြန်	ʔ ə m j à ɴ
ကတည်းက	ɡ ə d ɛ́ ɡ a̰
လှောက်	l̥ a ʊ ʔ
ပျိုး	p j ó
သွားပွတ်တံ	ð ə b ʊ ʔ d à ɴ
ဘီနင်	b ì n ɪ̀ ɴ
ယောက်ျားလျာ	j a ʊ ʔ k ə ʃ à
ကဏ္ဍ	k à n d a̰
စက်	s ɛ ʔ
ဘယ်နှစ်	b ɛ̀ n̥ ə
ညီအစ်ကို	ɲ ì ʔ ə k ò
သဒ္ဓါ	θ à d d à
ကနေဒါ	k a̰ n è d à
နားကပ်	n á ɡ a ʔ
မဟာသိပ္ပံဘွဲ့	m ə h à θ e ɪ ʔ p à ɴ b w ɛ̰
ဆီး	sʰ í
ဒေဝနာဂရီ	d è w a̰ n à ɡ ə ɹ ì
ဝစီ	w ə z ì
ထူး	tʰ ú
လောလော	l ɔ́ l ɔ́
ထမင်းကြော်	tʰ ə m ɪ́ ɴ d͡ʑ ɔ̀
ထန်းလျက်	tʰ ə ɲ ɛ ʔ
ကုသိုလ်ကံ	k ṵ ð ò ɡ à ɴ
ကွမ်ရင်	k w à ɴ j ɪ̀ ɴ
စကား	z ə ɡ á
ဆူဒန်	sʰ ù d à ɴ
အိန္ဒြေ	ʔ è ɪ ɴ d ɹ è
ထိုင်	tʰ à ɪ ɴ
တံဆိပ်ခေါင်း	d ə z e ɪ ʔ ɡ á ʊ ɴ
ကျည်	t͡ɕ ì
သားသတ်ရုံ	θ á ð a ʔ j ò ʊ ɴ
အထင်	ʔ ə tʰ ɪ̀ ɴ
မရမာ	m ə ɹ ə m à
နာတာလူးပွဲ	n à t à l ú b w ɛ́
ဈမျဉ်းဆွဲ	z a̰ m j ɪ́ ɴ z w ɛ́
အင်ဒိုချိုင်းနား	ʔ ɪ̀ ɴ d ò t͡ɕʰ á ɪ ɴ n á
ကျင်စွယ်	t͡ɕ ɪ̀ ɴ z w ɛ̀
ပညာကျော်	p j ɪ̀ ɴ ɲ à d͡ʑ ɔ̀
သုဒ္ဒကြိယာ	θ o ʊ ʔ d a̰ k ə j ḭ j à
ဗိုလ်ကျ	b ò t͡ɕ a̰
ကြွက်	t͡ɕ w ɛ ʔ
ပျားထီး	p j á d í
အတန်း	ʔ ə t á ɴ
ကတိ	ɡ ə d ḭ
မျက်လှည့်	m j ɛ ʔ l̥ ɛ̰
ပူတင်း	p ù t ɪ́ ɴ
ဇာတ်ကား	z a ʔ k á
မြက်ခင်း	m j ɛ ʔ kʰ ɪ́ ɴ
အီဂျစ်	ʔ ì d͡ʑ ɪ ʔ
မြ	m j a̰
ခြင်္သေ့	t͡ɕʰ ɪ̀ ɴ ð ḛ
ကျောက်နီ	t͡ɕ a ʊ ʔ n ì
ဖင်လျက်	pʰ ɪ̀ ɴ j ɛ ʔ
ပိုက်ဆံ	p a ɪ ʔ sʰ à ɴ
အလုပ်ပိတ်ရက်	ʔ ə l o ʊ ʔ p e ɪ ʔ j ɛ ʔ
အိပ်	ʔ e ɪ ʔ
ဝါဏိဇ္ဇဗေဒ	w à n e ɪ ʔ z a̰ b è d a̰
ရာဇဝင်	j à z ə w ɪ̀ ɴ
ကျိုက္ခမီ	t͡ɕ a ɪ ʔ kʰ ə m ì
ဟီနယာန	h ì n a̰ j à n a̰
ဒီည	d ì ɲ a̰
ဟနူမာန်	h ə n ù m à n
လေယာဉ်ပျံ	l è j ɪ̀ ɴ b j à ɴ
ပန်း	p á ɴ
စား	s á
အားလပ်ရက်	ʔ á l a ʔ j ɛ ʔ
စိန်ဖြူ	s è ɪ ɴ pʰ j ù
လယ်သမား	l ɛ̀ ð ə m á
အာရုံကြော	ʔ à j ò ʊ ɴ d͡ʑ ɔ́
ခန္ဓာငါးပါး	kʰ à ɴ d à ŋ á b á
ကျဲ	t͡ɕ ɛ́
ကာလီဖိုးနီးယား	k à l ì pʰ ó n í j á
ခမာ	kʰ ə m à
ဖြည်းဖြည်း	pʰ j é b j é
ပဒေသာ	b ə d è ð à
ဖြူး	pʰ j ú
ကြို့	t͡ɕ o̰
လက်ပတ်နာရီ	l ɛ ʔ p a ʔ n à j ì
တေးသံရှင်	t é θ à ɴ ʃ ɪ̀ ɴ
ရှင်ရှင်	ʃ ɪ̀ ɴ ʃ ɪ̀ ɴ
ခွဲ	kʰ w ɛ́
ထီး	tʰ í
နကျယ်ကောင်	n ə d͡ʑ ɛ̀ ɡ à ʊ ɴ
အရံဂြိုဟ်	ʔ ə j à ɴ d͡ʑ ò
အီတလီ	ʔ ì t a̰ l ì
အလှူရှင်	ʔ ə l̥ ù ʃ ɪ̀ ɴ
ကာလသား	k à l ə ð á
မီးပွား	m í b w á
သတင်း	ð a̰ d ɪ́ ɴ
ရိုဟင်ဂျာ	ɹ ò h ɪ̀ ɴ d͡ʑ à
မြက်	m j ɛ ʔ
နို့ဆီ	n o̰ z ì
နီလာ	n ì l à
မည်း	m ɛ́
ဒုတိယအရာခံဗိုလ်	d ṵ t ḭ j a̰ ʔ ə j à ɡ à ɴ b ò
အဖြူ	ʔ ə pʰ j ù
နိုင်ငံရေး	n à ɪ ɴ ŋ à ɴ j é
ကင်းမွန်	k ɪ́ ɴ m ʊ̀ ɴ
ဗက်တီးရီးယား	b ɛ ʔ t í ɹ í j á
ဝန်ကြီးချုပ်	w ʊ̀ ɴ d͡ʑ í d͡ʑ o ʊ ʔ
ထမင်း	tʰ ə m ɪ́ ɴ
ပြာတာ	p j à t à
ဘီလာရုဇ်	b ì l à ɹ ù z
မွေး	m w é
သင်္သကရိုက်	θ ɪ̀ ɴ θ ə k ə ɹ a ɪ ʔ
ကက်သလစ်	k ɛ ʔ θ ə l ɪ ʔ
ဘိုင်စကုတ်	b à ɪ ɴ s ə k o ʊ ʔ
ဥရောပ	ʔ ṵ ɹ ɔ́ p a̰
လျှပ်စီး	l̥ j a ʔ s í
မုဒ္ဓဇ	m ù d d ə z a̰
ပျော်	p j ɔ̀
အဓိက	ʔ a̰ d ḭ ɡ a̰
ဂူ	ɡ ù
စာရေးဆရာ	s à j é sʰ ə j à
စိမ့်	s ḛ ɪ ɴ
ဆီးချို	sʰ í d͡ʑ ò
ဥပါဒါန်	ʔ ṵ p à d à n
ရိုက်	j a ɪ ʔ
ကန်တော့	ɡ ə d ɔ̰
ကျွန်းဆွယ်	t͡ɕ ʊ́ ɴ z w ɛ̀
စစ်ကိုင်း	z ə ɡ á ɪ ɴ
တောင်း	t á ʊ ɴ
သဲ့သဲ့	θ ɛ̰ ð ɛ̰
ရင်ထိုးတံဆိပ်	j ɪ̀ ɴ d ó d ə z e ɪ ʔ
တကာ	d ə ɡ à
နန္ဒာ	n à ɴ d à
ရေသူ	j è ð ù
လေချဉ်တက်	l è d͡ʑ ɪ̀ ɴ t ɛ ʔ
နည်း	n ɛ́
မျှစ်	m̥ j ɪ ʔ
ညီမ	ɲ ì m a̰
မြူ	m j ù
ဝန်ခံ	w ʊ̀ ɴ kʰ à ɴ
ဟာနွိုင်း	h à n w á ɪ ɴ
မင်္ဂလာဆောင်	m ɪ̀ ɴ ɡ ə l à sʰ à ʊ ɴ
တိတ်	t e ɪ ʔ
ယူနီယန်	j ù n ì j à ɴ
နန်းကြီးသုပ်	n á ɴ t͡ɕ í θ o ʊ ʔ
မှုတ်	m̥ o ʊ ʔ
သစ်ကတိုး	θ ɪ ʔ ɡ ə d ó
ထောင့်	d a̰ ʊ ɴ
တော	t ɔ́
အနားယူ	ʔ ə n á j ù
တရားစွဲ	t ə j á s w ɛ́
အစီအစဉ်	ʔ ə s ì ʔ ə s ɪ̀ ɴ
ကုလားဖြူ	k ə l ə pʰ j ù
မီးရထားတွဲ	m í j ə tʰ á d w ɛ́
အခွင့်	ʔ ə kʰ w ɪ̰ ɴ
ဘေးဆိုး	b é z ó
ရေခဲ	j è ɡ ɛ́
ကလေး	kʰ ə l é
ချွေးမ	t͡ɕʰ w é m a̰
ကြိုး	t͡ɕ ó
အဖိုး	ʔ ə pʰ ó
ဓာတ်မီးခြစ်	d a ʔ m í d͡ʑ ɪ ʔ
