φιλολογίεσ	f i l o l o ʝ i e s
αγαπημένε	a ɣ a p i m e n e
ἀνιδρύομαι	a n i ð r i o m e
υδραυλικόσ	i ð r a v l i k o s
λύετε	l i e t e
εκφύομαι	e k f i o m e
λιόψωμου	ʎ o p s o m u
ευσεβών	e f s e v o n
πάμμαυροι	p a m a v ɾ i
κοινόλεκτε	c i n o l e k t e
ζάκυνθε	z a c i n θ e
απολύθηκα	a p o l i θ i k a
ήμουν	i m u n
εμπνευσμένησ	e m b n e v z m e n i s
βαθμολογημένα	v a θ m o l o ʝ i m e n a
απερρίφθην	a p e ɾ i f θ i n
θαυμαστικά	θ a v m a s t i k a
υπολογισμένοσ	i p o l o ʝ i z m e n o s
συντρίβομαι	s i n d r i v o m e
παραμύθι	p a ɾ a m i θ i
στενοχωρημένη	s t e n o x o r i m e n i
αναγνωρισμένων	a n a ɣ n o r i z m e n o n
αποφασίζω	a p o f a s i z o
κοκορέτσι	k o k o ɾ e t s i
μαθημένουσ	m a θ i m e n u s
τέταρτοσ	t e t a ɾ t o s
νεκροφόρα	n e k ɾ o f o ɾ a
αρχικώσ	a r ç i k o s
μαζικότατεσ	m a z i k o t a t e s
αγκυλίου	a ŋ ɟ i l i u
μουνότριχα	m u n o t ɾ i x a
αληθήσ	a l i θ i s
αντικλεπτικά	a n d i k l e p t i k a
αριστοκλήσ	a ɾ i s t o k l i s
αναμαλλιασμένησ	a n a m a ʎ a z m e n i s
άσεβησ	a s e v i s
λυμένε	l i m e n e
ελκύστηκα	e l c i s t i k a
τριμμένοι	t r i m e n i
στεναχωρημένοι	s t e n a x o r i m e n i
ακαταδεξία	a k a t a ð e k s i a
ξαράχνιασα	k s a ɾ a x ɲ a s a
υποκλέπτω	i p o k l e p t o
λυμένεσ	l i m e n e s
νεκροφυλακείο	n e k ɾ o f i l a c i o
ύφεση	i f e s i
άρτοσ	a r t o s
αβούλιαχτοσ	a v u ʎ a x t o s
μελισσοκόμοσ	m e l i s o k o m o s
εορτάσθηκα	e o ɾ t a s θ i k a
κνήμη	k n i m i
αγκύλι	a ŋ ɟ i l i
ψημένοι	p s i m e n i
ενδιαφερούσησ	e n ð i a f e r u s i s
κλεισμένοσ	k l i z m e n o s
χίοσ	ç i o s
πηγαινέλα	p i ʝ e n e l a
λυθώ	l i θ o
ζουλάω	z u l a o
απολύομαι	a p o l i o m e
μόναχο	m o n a x o
δηλώσεισ	ð i l o s i s
επιτράπηκε	e p i t ɾ a p i c e
πειραματίζομαι	p i ɾ a m a t i z o m e
σαλτάρισε	s a l t a ɾ i s e
διαλελυμένουσ	ð i a l e l i m e n u s
καλημέρα	k a l i m e r a
κρεμασμένουσ	k r e m a z m e n u s
αποτράπηκαν	a p o t ɾ a p i k a n
αναστρέφω	a n a s t ɾ e f o
πορδίτσα	p o ɾ ð i t s a
αεροφωτογραφίστηκα	a e r o f o t o ɣ r a f i s t i k a
τριμμένο	t r i m e n o
ενημέρωσησ	e n i m e r o s i s
πειθαναγκάστηκα	p i θ a n a ŋ ɡ a s t i k a
τάχατε	t a x a t e
συνηθισμένε	s i n i θ i z m e n e
κανόνασ	k a n o n a s
δρέπω	ð ɾ e p o
μαυρισμένε	m a v r i z m e n e
ενρινότητεσ	e n r i n o t i t e s
μαρκαδόροσ	m a ɾ k a ð o ɾ o s
κορόιδεψα	k o ɾ o i̯ ð e p s a
ακοντίζομαι	a k o n d i z o m e
γεωγραφικόσ	ʝ e o ɣ ɾ a f i k o s
ενρίνωσ	e n r i n o s
κλαδεύτηκα	k l a ð e f t i k a
ψυχιατρική	p s i ç a t r i c i
καλοφάγωτοσ	k a l o f a ɣ o t o s
αναπαρασταίνω	a n a p a r a s t e n o
πουδράρισε	p u ð ɾ a ɾ i s e
ευθυμία	e f θ i m i a
αγγέλου	a ŋ ɟ e l u
αβανγκαρντισμοί	a v a ŋ ɡ a ɾ d i z m i
φίλιπποσ	f i l i p o s
αραχνιασμένοσ	a ɾ a x ɲ a z m e n o s
τετριμμένα	t e t r i m e n a
υποβλέπω	i p o v l e p o
γκαστρωμένησ	ɡ a s t r o m e n i s
πρησμένοσ	p ɾ i z m e n o s
παραπλέω	p a r a p l e o
βηρυτόσ	v i r i t o s
κατισχύω	k a t i s ç i o
βομβαρδίζω	v ɔ ɱ v a r ð i z o
στρατόπεδα	s t ɾ a t o p e ð a
αλληλεπίδραση	a l l i l e p i ð ɾ a s i
γκάρισα	ɡ a r i s a
κωνσταντή	k o s t a n d i
φράγκοσ	f ɾ a ŋ ɡ o s
σφιχταγκαλιάζω	s f i x t a ŋ ɡ a ʎ a z o
αίρομαι	e r o m e
ανασκάφτω	a n a s k a f t o
αποκρούομε	a p o k r u o m e
καλομοίρικο	k a l o m i r i k o
πρωταγωνιστέσ	p ɾ o t a ɣ o n i s t e s
τριπολιτσά	t ɾ i p o l i t s a
εκπαραθύρωση	e k p a ɾ a θ i ɾ o s i
πεθαμένε	p e θ a m e n e
ανακατεύτηκα	a n a k a t e f t i k a
ανάβαθοσ	a n a v a θ o s
γράδο	ɣ ɾ a ð o
υπέροχοσ	i p e ɾ o x o s
ασεβώσ	a s e v o s
ντροπιασμένοι	d ɾ o p ç a z m e n i
φετινόσ	f e t i n o s
κλείομαι	k l i o m e
εννοώ	e n o o
ψωλάρα	p s o l a ɾ a
θερμοδυναμικοί	θ e r m o ð i n a m i c i
υπογράφομαι	i p o ɣ r a f o m e
επιγράφω	e p i ɣ r a f o
σφυρίζω	s f i r i z o
αποστάζω	a p o s t a z o
ευσεβέσ	e f s e v e s
αλυσοδεμένο	a l i s o ð e m e n o
σκατάσ	s k a t a s
αποστολέασ	a p o s t o l e a s
κορίνθου	k o ɾ i n θ u
αγκίδι	a ŋ ɟ i ð i
γαργαλάω	ɣ a ɾ ɣ a l a o
ανήλθα	a n i l θ a
αγναντεύω	a ɣ n a n d e v o
χαζοκούτι	x a z o k u t i
παγωμένοσ	p a ɣ o m e n o s
εγερθήτω	e ʝ e ɾ θ i t o
αξιοσημείωτη	a k s i o s i m i o t i
χαμηλόσ	x a m i l o s
επάρκεια	e p a ɾ c i a
χαζόσ	x a z o s
γαμημένοι	ɣ a m i m e n i
αναγεννησιακόσ	a n a ʝ e n i s i a k o s
απολίθωμα	a p o l i θ o m a
νατο	n a t o
ανέτρεψα	a n e t ɾ e p s a
σκατό	s k a t o
αποδειχτήκανε	a p o ð i x t i k a n e
πρωκτόσ	p r o k t o s
συνέπλευσα	s i n e p l e f s a
ντελιβεράδεσ	d e l i v e r a ð e s
παγωμένουσ	p a ɣ o m e n u s
αγκαλιάζω	a ŋ ɡ a ʎ a z o
στερήσεισ	s t e ɾ i s i s
αγνάντευε	a ɣ n a n d e v e
ενέγραψα	e n e ɣ r a p s a
πρησμένο	p ɾ i z m e n o
μυρωμένη	m i r o m e n i
γαβ	ɣ a v
αναγεννησιακό	a n a ʝ e n i s i a k o
κερδίζω	c e r ð i z o
ψυχολογική	p s i x o l o ʝ i c i
θριαμβεύω	θ ɾ i a ɱ v e v o
τάχατεσ	t a x a t e s
σταφιδόψωμου	s t a f i ð o p s o m u
γκόμενοσ	ɡ o m e n o s
ένδεκα	e n ð e k a
αποτράπηκε	a p o t ɾ a p i c e
προμηνύθηκα	p r o m i n i θ i k a
ερχομένησ	e r x o m e n i s
ελιά	ɛ ʎ a
συγκρουόμενη	s i ŋ ɡ r u o m e n i
όλυμποσ	o l i m b o s
εβραίοσ	e v ɾ e o s
εξαλείφουμε	e k s a l i f u m e
αποκρούομαι	a p o k r u o m e
αβανγκαρντισμό	a v a ŋ ɡ a ɾ d i z m o
τρεισ	t ɾ i s
ολόφωτων	o l o f o t o n
γήπεδο	ʝ i p e ð o
χόρεψε	x o ɾ e p s e
βαρκελώνη	v a ɾ c e l o n i
λυνόταν	l i n o t a n
βιόσφαιρεσ	v i o s f e ɾ e s
σαντορίνη	s a n d o ɾ i n i
ρέθυμνο	ɾ e θ i m n o
επομένωσ	e p o m e n o s
δαγκώθηκα	ð a ŋ ɡ o θ i k a
εισιτήριο	i s i t i ɾ i o
ανεπαίσθητα	a n e p e s θ i t a
ελκύω	e l c i o
κόκκινη	k o c i n i
φιλιά	f i ʎ a
γελωτοποιόσ	ʝ e l o t o p i o s
θεαματικότητα	θ e a m a t i k o t i t a
απάλειψα	a p a l i p s a
ξαπλώνω	k s a p l o n o
χαλνώ	x a l n o
αγορών	a ɣ o r o n
ἀττικίζον	a t i c i z o n
γαϊδουροκαλόκαιρο	ɣ a i ð u ɾ o k a l o c e ɾ o
κωλοφωτιά	k o l o f o t ç a
επέγραψα	e p e ɣ ɾ a p s a
βουτυρωμένε	v u t i r o m e n e
άγω	a ɣ o
δισεκατομμύριο	ð i s e k a t o m i r i o
ασέβειεσ	a s e v i e s
γένεσησ	ʝ e n e s i s
αλάβαστροσ	a a l v a s t r o s
στειμμένου	s t i m e n u
περιπλέω	p e r i p l e o
φυτικάσ	f i t i k a s
απέσεισα	a p e s i s a
ανακοινώνω	a n a c i n o n o
πρεζάρω	p ɾ e z a ɾ o
μάρκαρε	m a ɾ k a ɾ e
θαυμάζομαι	θ a v m a z o m e
αλυσοδεμένε	a l i s o ð e m e n e
παντρεμένο	p a n d ɾ e m e n o
πύργου	p i r ɣ u
εξαναγκάζουμε	e k s a n a ŋ ɡ a z u m e
ασκήθηκα	a s c i θ i k a
μιάμιση	m ɲ a m i s i
αγανακτισμένο	a ɣ a n a k t i z m e n o
καλομοίρηδεσ	k a l o m i r i ð e s
έφραξα	e f r a k s a
όνοσ	o n o s
αεροφωτογραφίζω	a e r o f o t o ɣ r a f i z o
ξέκωλη	k s e k o l i
κατασκόπευσα	k a t a s k o p e f s a
τσακωνική	t s a k o n i c i
λύουμε	l i u m e
έχει	e ç i
καταγράφομε	k a t a ɣ r a f o m e
αριστοκρατία	a ɾ i s t o k ɾ a t i a
βλαμμένων	v l a m e n o n
ντροπιάζω	d ɾ o p ç a z o
αναβράζω	a n a v r a z o
γοήτευσα	ɣ o i t e f s a
κατελύθην	k a t e l i θ i n
περιθάλπομαι	p e ɾ i θ a l p o m e
καρεκλάκι	k a ɾ e k l a c i
εγκλείομαι	e ŋ ɡ l i o m e
παρακείμενων	p a ɾ a c i m e n o n
αερίζομαι	a e ɾ i z o m e
αγοράσ	a ɣ o r a s
αφορμή	a f o ɾ m i
συνέχεια	s i n e ç i a
μουνί	m u n i
εισάκουσα	i s a k u s a
αναστάλθηκα	a n a s t a l θ i k a
πιλοτάριζε	p i l o t a ɾ i z e
βάζο	v a z o
απήλθα	a p i l θ a
κοτόπουλο	k ɔ t ɔ p u l ɔ
αξιοσημείωτησ	a k s i o s i m i o t i s
ταρό	t a ɾ o
ἐπιστρέφομαι	e p i s t ɾ e f o m e
λυθούμε	l i θ u m e
στάζει	s t a z i
νεοελληνική	n e o e l i n i c i
κώδικασ	k ɔ ð i k a s
αλατισμένοι	a l a t i z m e n i
ανακαλύφτηκα	a n a k a l i f t i k a
αμοργό	a m o ɾ ɣ o
πενήντα	p e n i n d a
ντροπιασμένο	d ɾ o p ç a z m e n o
αλγεινόσ	a l ʝ i n o s
αρρωστημένων	a r o s t i m e n o n
θλιμμένο	θ l i m e n o
πασάλειψα	p a s a l i p s a
φρενάρω	f r e n a r o
κριθαρόψωμα	k r i θ a r o p s o m a
αναγορεύω	a n a ɣ o r e v o
ποδόσφαιρο	p o ð o s f e r o
δημοκρατιῶν	ð i m o k r a t i o n
στέλλω	s t e l o
εγκαθιδρύουμε	e ŋ ɡ a θ i ð r i u m e
βυθισμένουσ	v i θ i z m e n u s
αίσχοσ	e s x o s
μπιζάρισα	b i z a ɾ i s a
ναδίρ	n a ð i ɾ
συνεχάρησαν	s i n e x a ɾ i s a n
μετρονόμοσ	m e t ɾ o n o m o s
κουρασμένα	k u r a z m e n a
κουραστικοί	k u r a s t i c i
αντικλεπτικέ	a n d i k l e p t i ç e
γελιέμαι	ʝ e l ʝ e m e
πειθόμενοσ	p i θ o m e n o s
εκκολάφθηκα	e k o l a f θ i k a
χρονολογούμαι	x r o n o l o ɣ u m e
κραγμένε	k r a ɣ m e n e
κινδύνεψα	c i n ð i n e p s a
ντροπιασμένα	d ɾ o p ç a z m e n a
φέρετρο	f e ɾ e t ɾ o
χαρτομάντισσα	x a ɾ t o m a n d i s a
ενετοκρατία	e n e t o k ɾ a t i a
ἀποκυήματα	a p o c i i m a t a
σχολίων	s x o l i o n
γλειφομούνι	ɣ l i f o m u n i
απευχήθηκα	a p e f ç i θ i k a
αλευρωμένη	a l e v r o m e n i
συγκόπτομε	s i ŋ ɡ o p t o m e
κεκλεισμένου	c e k l i z m e n u
τάραξα	t a r a k s a
στερούμε	s t e ɾ u m e
χλιοσ	x ʎ o s
βυθισμένου	v i θ i z m e n u
στέρηση	s t e ɾ i s i
πατάω	p a t a o
έξεισ	e k s i s
αναμαλλιασμένουσ	a n a m a ʎ a z m e n u s
γρηγόρηδεσ	ɣ ɾ i ɣ o ɾ i ð e s
υπολογισμένη	i p o l o ʝ i z m e n i
προπονήσεων	p r o p o n i s e o n
πρησμένεσ	p ɾ i z m e n e s
δαμασκόσ	ð a m a s k o s
φρεσκάρισα	f r e s k a r i s a
δανία	ð a n i a
κουτσουλιά	k u t s u ʎ a
αγυιόπαιδεσ	a ʝ i o p e ð e s
αδιευκρίνιστοσ	a ð i e f k ɾ i n i s t o s
ανεκτίμητοσ	a n e k t i m i t o s
πραματευτήσ	p ɾ a m a t ɛ f t i s
κατέστρεψα	k a t e s t ɾ e p s a
εισακούομαι	i s a k u o m e
ανένηψα	a n e n i p s a
μαστόσ	m a s t o s
σιχτίρ	s i x t i ɾ
λόγο	l o ɣ o
καταλύομεν	k a t a l i o m e n
αλκαλιμέταλλο	a l k a l i m e t a l o
αβανγκαρντισμέ	a v a ŋ ɡ a ɾ d i z m e
υποσκάπτουμε	i p o s k a p t u m e
κωλόγρια	k o l o ɣ ɾ i a
λούζομαι	l u z o m e
αγγισμένησ	a ŋ ɟ i z m e n i s
κοτσαδόροσ	k o t s a ð o ɾ o s
αλείφτηκα	a l i f t i k a
φλιπάρω	f l i p a ɾ o
υποκλέπτομε	i p o k l e p t o m e
αποκλείεται	a p o k l i e t e
άδενδροσ	a ð e n ð ɾ o s
λυθήκαν	l i θ i k a n
αργοσάλευε	a ɾ ɣ o s a l e v e
χαστουκιά	x a s t u c a
μαζέψτε	m a z e p s t e
ανθρωπεύω	a n θ ɾ o p e v o
νεράιδα	n e ɾ a i ð a
κραγιόν	k ɾ a ʝ ɔ n
ορθόδοξοι	o ɾ θ o ð o k s i
ήβησ	i v i s
ισχίο	i s ç i o
ακούσθηκα	a k u s θ i k a
ανακρούουμε	a n a k r u u m e
στεναχωρημένων	s t e n a x o r i m e n o n
καλομαθημένεσ	k a l o m a θ i m e n e s
εισροή	i z r o i
πορτοκαλιά	p o ɾ t o k a ʎ a
κρούουμε	k r u u m e
καθελκύομε	k a θ e l c i o m e
προείδα	p ɾ o i ð a
αγωνίζομαι	a ɣ o n i z o m e
χαρτορίχτρα	x a ɾ t o ɾ i x t ɾ a
αλεξανδρούπολη	a l e k s a n ð ɾ u p o l i
αγγιγμένοσ	a ŋ ɟ i ɣ m e n o s
ψηφιακού	p s i f i a k u
καθισμένοι	k a θ i z m e n i
γαργαλώ	ɣ a ɾ ɣ a l o
ευσεβώσ	e f s e v o s
περιγράφομαι	p e ɾ i ɣ r a f o m e
ἐτάφην	e t a f i n
συγκρουόμενουσ	s i ŋ ɡ r u o m e n u s
καπνόσ	k a p n o̞ s
λαθραίοσ	l a θ ɾ ɛ ɔ s
ανακρούσθηκα	a n a k r u s θ i k a
έσχισα	e s ç i s a
μυρωμένοσ	m i r o m e n o s
δενδροχρονολόγηση	ð e n d r o x r o n o l o ʝ i s i
πασαλείβω	p a s a l i v o
πούστικοσ	p u s t i k o s
απέρχομαι	a p e ɾ x o m e
ρεφρέν	r e̞ f r e̞ n
απαραίτητοσ	a p a r e t i t o s
βυθισμένοσ	v i θ i z m e n o s
αναστροφή	a n a s t ɾ o f i
στριμμένο	s t ɾ i m e n o
κομπιναδόροσ	k o m b i n a ð o ɾ o s
συγγράφεισ	s i ŋ ɣ r a f i s
οριστική	o ɾ i s t i c i
κόκκινεσ	k o c i n e s
κατίσχυσα	k a t i s ç i s a
υπολογίστηκα	i p o l o ʝ i s t i k a
αγγονιού	a ŋ ɡ o ɲ u
τρέπομαι	t r e p o m e
είχαμε	i x a m e
αρχηγόσ	a ɾ ç i ɣ ɔ s
επιτρέπομαι	e p i t ɾ e p o m e
πεντακόσια	p e n d a k o s ç a
παρακωλύομε	p a r a k o l i o m e
αγαπημένεσ	a ɣ a p i m e n e s
έτερψα	e t e ɾ p s a
αποδεικνύουμε	a p o ð i k n i u m e
βουβάλια	v u v a ʎ a
αγιασματάριο	a ʝ a z m a t a r i o
άρον	a r o n
αβγατισμένα	a v ɣ a t i z m e n a
κυνηγημένε	c i n i ʝ i m e n e
σπιτάκι	s p i t a c i
σοφίαν	s o f i a n
ορμούζ	o r m u z
σαγηνεύομαι	s a ʝ i n e v o m e
πεντήκοντα	p e n d i k o n d a
τσακωνιάσ	t s a k o ɲ a s
νήσο	n i s o
σχίζομαι	s ç i z o m e
παραλύω	p a r a l i o
αγελάδα	a ʝ e l a ð a
αγαπημένοι	a ɣ a p i m e n i
υπέροχη	i p e ɾ o ç i
ρίχνω	ɾ i x n o
πρότρεψα	p ɾ o t ɾ e p s a
κουραστικά	k u r a s t i k a
ρεζιλεύομαι	ɾ e z i l e v o m e
αμφιλεγόμενο	a ɱ f i l e ɣ o m e n o
παπάρι	p a p a ɾ i
γκεσέμι	ɟ e s e m i
σιάτιστα	s ç a t i s t a
πιλόταρα	p i l o t a ɾ a
ταξιτζού	t a k s i n d z u
κηροπήγιο	c i ɾ o p i ʝ i o
γονυπετέσ	ɣ o n i p e t e s
σουτάρισε	s u t a ɾ i s e
κεσέμι	c e s e m i
αίγινα	e ʝ i n a
δημοτική	ð i m o t i c i
ματοβαμμένη	m a t o v a m e n i
πρωταγωνιστήσ	p ɾ o t a ɣ o n i s t i s
κύπριοσ	c i p r i o s
ηθικότητα	i θ i k o t i t a
γραικόσ	ɣ r e k o s
αγαπώ	a ɣ a p o
κουράζομαι	k u ɾ a z o m e
πειράζει	p i ɾ a z i
χτικιό	x t i c o
μωρή	m o ɾ i
πέτροσ	p e t ɾ o s
εγγραφτήκανε	e ŋ ɣ r a f t i k a n e
αίσθημα	ɛ s θ i m a
βασιλιάσ	v a s i ʎ a s
ψηφιακόσ	p s i f i a k o s
κυνηγημένουσ	c i n i ʝ i m e n u s
επιχειρώ	e p i ç i r o
αγγισμένε	a ŋ ɟ i z m e n e
υπογράφει	i p o ɣ r a f i
κουρεύω	k u ɾ e v o
αγάνταρα	a ɣ a n d a r a
βιόσφαιρα	v i o s f e ɾ a
πειθόμενε	p i θ o m e n e
αποκλείομε	a p o k l i o m e
αλληλοσυγκρουόμενοι	a l i l o s i ŋ ɡ r u o m e n i
άνδρο	a n ð ɾ o
αναλογία	a n a l o ʝ i a
ποικιλότερε	p i c i l o t e r e
κύπρε	c i p ɾ e
βρισίδι	v ɾ i s i ð i
φάληρο	f a l i ɾ o
καταξόδεψα	k a t a k s o ð e p s a
πεπεισμένων	p e p i z m e n o n
κουτσό	k u t s o
αποκερματισμών	a p o c e ɾ m a t i z m o n
χρώμα	x ɾ ɔ m a
στο	s t o
γιεν	ʝ e n
αναβαλλόμενοι	a n a v a l o m e n i
γεροντοκρατία	ʝ e ɾ o n d o k ɾ a t i a
επωμίζομαι	e p o m i z o m e
μαθημένεσ	m a θ i m e n e s
σκυλί	s c i l i
ελλάδα	e l a ð a
βρετανία	v r e t a n i a
καταφθάνω	k a t a f θ a n o
σταγόνα	s t a ɣ o n a
συνηθισμένο	s i n i θ i z m e n o
αγυιόπαιδασ	a ʝ i o p e ð a s
ψηφιακοί	p s i f i a c i
ξεκωλιάρησ	k s e k o ʎ a ɾ i s
παραβλέπομε	p a ɾ a v l e p o m e
ρουθούνι	ɾ u θ u n i
ξαναμοιράστηκα	k s a n a m i ɾ a s t i k a
διαστροφή	ð ʝ a s t ɾ o f i
υπολήπτομαι	i p o l i p t o m e
επιγράφουμε	e p i ɣ r a f u m e
συνέρχομαι	s i n e r x o m e
μαϊντανόσ	m a i d a n o s
συνεχάρη	s i n e x a r i
ανθρωπεύτηκα	a n θ ɾ o p e f t i k a
ακούστηκα	a k u s t i k a
σκανδάλη	s k a n ð a l i
υπολογισμένων	i p o l o ʝ i z m e n o n
πολωνικούσ	p o l o n i k u s
κοινόσ	c i n o s
συσκέφθηκα	s i s c e f θ i k a
μισθόσ	m i s θ o s
φοροκλέπτω	f o ɾ o k l e p t o
αποκόπτομαι	a p o k o p t o m e
ρόμπερτ	ɾ o b e ɾ t
ακοομετρίεσ	a k o o m e t r i e s
ύβρισ	i v ɾ i s
παρελθών	p a r e l θ o n
χορέψαν	x o ɾ e p s a n
κραγμένη	k r a ɣ m e n i
αβγοκομμένε	a v ɣ o k o m e n e
επανίδρυσα	e p a n i ð r i s a
σφύριξα	s f i r i k s a
τήνο	t i n o
ωρίμωσ	o ɾ i m o s
σωροί	s o ɾ i
μυρωδιά	m i ɾ o ð ʝ a
αμπαλάρομαι	a m b a l a ɾ o m e
μπάρκαρα	b a ɾ k a ɾ a
παϊδάκι	p a i ð a c i
επίδαυροσ	e p i ð a v ɾ o s
μοιρασμένων	m i ɾ a z m e n o n
αεροφωτογράφησα	a e ɾ o f o t o ɣ ɾ a f i s a
μίμησ	m i m i s
θλιμμένεσ	θ l i m e n e s
τετριμμένο	t e t r i m e n o
σπίθισα	s p i θ i s a
σοφιῶν	s o f i o n
υγειά	i ʝ a
πατρίδα	p a t r i ð a
χεσμένοσ	ç e z m e n o s
αγνάντιο	a ɣ n a n d ʝ o
καρδιά	k a r ð ʝ a
βάρβαροσ	v a r v a r o s
στριμμένεσ	s t ɾ i m e n e s
συνδέω	s i n ð e o
διέπω	ð i e p o
άνθρωποσ	a n θ ɾ o p o s
υδροπτέρυγο	i ð r o p t e ɾ i ɣ o
πατέρων	p a t e r o n
παραπέμφθηκα	p a ɾ a p e m f θ i k a
χεσμένεσ	ç e z m e n e s
κωδωνοκρούστησ	k o ð o n o k r u s t i s
τηλεθεάτρια	t i l e θ e a t ɾ i a
ἀπασχολοῦμαι	a p a s x o l u m e
καινοφανήσ	c e n o f a n i s
πρωτεύον	p ɾ ɔ t ɛ v o n
οπτιμιστήσ	o p t i m i s t i s
πληθυσμόσ	p l i θ i z m o s
λυνόμουνα	l i n o m u n a
κοριτσιού	k o ɾ i t s ç u
λέσβοσ	l e z v o s
προφθάνω	p ɾ ɔ f θ a n o
ναύπακτοσ	n a f p a k t o s
ζεύγοσ	z e v ɣ o s
αναπόδεικτοσ	a n a p o ð i k t o s
σύντριψε	s i n d r i p s e
παρκάρισε	p a ɾ k a ɾ i s e
μουνάκι	m u n a c i
μισθώνομαι	m i s θ o n o m e
γενεάσ	ʝ e n e a s
πάγκοσ	p a ŋ ɡ o s
βάφηκα	v a f i k a
φουμάριζε	f u m a ɾ i z e
αλλαξοπίστισα	a l a k s o p i s t i s a
σταμάτιοσ	s t a m a t i o s
ξελύθηκα	k s e l i θ i k a
ντελαπάρισα	d e l a p a ɾ i s a
αδικήθηκα	a ð i c i θ i k a
αγνώμονασ	a ɣ n o m o n a s
μεσαιωνικόσ	m e s e o n i k o s
αιματοκυλίζομαι	e m a t o c i l i z o m e
συμπρωταγωνιστέσ	s i m b ɾ o t a ɣ o n i s t e s
γογγύλι	ɣ o ŋ ɟ i l i
ντεραπάρισα	d e ɾ a p a ɾ i s a
φιλοσοφικά	f i l o s o f i k a
ἀδικοῦμαι	a ð i k u m e
ἑορτάζομαι	e o ɾ t a z o m e
πέμπω	p e m b o
κουρασμένο	k u r a z m e n o
αγκύλιο	a ŋ ɟ i l i o
πορδή	p o ɾ ð i
ζητῶ	z i t o
γίγαντασ	ʝ i ɣ a d a s
ευνοιοκρατία	e v n i o k ɾ a t i a
τσάκωνασ	t s a k o n a s
αναγεννησιακοί	a n a ʝ e n i s i a c i
στενοχωρημένουσ	s t e n o x o r i m e n u s
εσπεράντο	ɛ s p ɛ ɾ a n d ɔ
ισχνόσ	i s x n ɔ s
περιοδικού	p e r i o ð i k u
πλησίον	p l i s i o n
γνώριμοσ	ɣ n o ɾ i m o s
ξαναγράφομαι	k s a n a ɣ ɾ a f o m e
ασεβέστερα	a s e v e s t e r a
ανέπαλλα	a n e p a l a
σκύλα	s c i l a
χέζομαι	ç e z o m e
ευκαιρία	e f k e r i a
παροιμία	p a ɾ i m i a
καθιδρύθηκα	k a θ i ð r i θ i k a
κουτόσ	k u t o s
βουτυρωμένων	v u t i r o m e n o n
σημειώνουμε	s i m i o n u m e
ανασκάφτομαι	a n a s k a f t o m e
διαλυτικά	ð ʝ a l i t i k a
ανέκραξα	a n e k r a k s a
δημήτριοσ	ð i m i t ɾ i o s
εμπνευσμένων	e m b n e v z m e n o n
ώριμοσ	o ɾ i m o s
μπαρκάρω	b a ɾ k a ɾ o
αθροίζω	a θ ɾ i z o
ντροπιασμένη	d ɾ o p ç a z m e n i
κελαηδώ	c e l a i ð o
ανασκαφείσ	a n a s k a f i s
γαμημένα	ɣ a m i m e n a
εντύπωση	e n d i p o s i
επιτρέπουμε	e p i t ɾ e p u m e
ανθρωπεύομαι	a n θ ɾ o p e v o m e
κοντόσ	k o n d o s
ρέπω	ɾ e p o
οινόπνευμα	i n o p n e v m a
υπέκυψα	i p e c i p s a
λύθηκεσ	l i θ i c e s
σταυρόσ	s t a v r o s
διαδέχομαι	ð ʝ a ð e x o m e
δώδεκα	ð o ð e k a
αερόσακοσ	a ɛ ɾ ɔ s a k ɔ s
ερίτιμοσ	e ɾ i t i m o s
πότε	p o t e
άλειψα	a l i p s a
αγκαζάρομαι	a ŋ ɡ a z a ɾ o m e
ψωμιέρα	p s o m ɲ e r a
παραπέμπομε	p a ɾ a p e m b o m e
αμερική	a m e r i c i
αιδοιολειξία	e ð i o l i k s i a
ξέλυσα	k s e l i s a
υδράργυροσ	i ð ɾ a ɾ ʝ i ɾ o s
κυρούλα	c i r u l a
λιγότερη	l i ɣ o t e r i
αποδείχθηκε	a p o ð i x θ i c e
τσακώνικα	t s a k o n i k a
γκρίνια	ɡ ɾ i ɲ a
ανετράπη	a n e t ɾ a p i
στέφθηκα	s t e f θ i k a
ξαναμοιράζομαι	k s a n a m i ɾ a z o m e
τσακωνικού	t s a k o n i k u
ένρινα	e n r i n a
γαργάρα	ɣ a ɾ ɣ a ɾ a
ερρινότητοσ	e r i n o t i t o s
ηλικιωμένου	i l i c i o m e n u
πομφόσ	p o ɱ f o s
πατεράδων	p a t e r a ð o n
σαγήνεψα	s a ʝ i n e p s a
ανθελληνίδα	a n θ e l i n i ð a
επιστράφηκα	e p i s t ɾ a f i k a
βγαίνω	v ʝ e n o
ζωηρόσ	z o i r o s
κλαρίνο	k l a ɾ i n o
μαλακισμένε	m a l a c i z m e n e
ἀρχαΐζουσα	a r x a i z u s a
εμπνευσμένουσ	e m b n e v z m e n u s
κάνσασ	k a n z a s
πολιτιστικόσ	p o l i t i s t i k o s
εκείνη	e c i n i
εθνάρχησ	e θ n a r ç i s
έξοδοσ	ɛ k s ɔ ð ɔ s
ναζού	n a z u
σημαδιού	s i m a ð ʝ u
ενθύμιο	ɛ n θ i m i ɔ
πρεσάρομαι	p ɾ e s a ɾ o m e
αηδιαστική	a i ð ʝ a s t i c i
στιγματισμένοσ	s t i ɣ m a t i z m e n o s
καλοκαιρινόσ	k a l o c e ɾ i n o s
ξαναγράφω	k s a n a ɣ ɾ a f o
σερβιέτα	s e ɾ v i e t a
εγγράφτηκα	e ŋ ɣ ɾ a f t i k a
απέτρεψα	a p e t ɾ e p s a
πλατεῖα	p l a t i a
μπούρδα	b u ɾ ð a
καταγράφομαι	k a t a ɣ r a f o m e
αγιοποιημένοσ	a ʝ i o p i i m e n o s
άγγελου	a ŋ ɟ e l u
πεισμένου	p i z m e n u
στριμμένων	s t ɾ i m e n o n
ευσεβειών	a s e v i o n
μπόλικοσ	b o l i k o s
ώριμοι	o ɾ i m i
ανελκύομε	a n e l c i o m e
γκρίζου	ɡ ɾ i z u
συμφυρμό	s i ɱ f i r m o
αλάκεροσ	a l a c e r o s
κοινολέκτουσ	c i n o l e k t u s
καλικαντζαρούδι	k a l i k a n d z a ɾ u ð i
κερατώνω	c e ɾ a t o n o
αγέλη	a ʝ ɛ l i
σόι	s o i
τσόντα	t s o n d a
στριμμένα	s t ɾ i m e n a
αναγεννήθηκα	a n a ʝ e n i θ i k a
αναθεματισμένων	a n a θ e m a t i z m e n o n
έγλειψα	e ɣ l i p s a
πύον	p i o n
αντίνοοσ	a n d i n o o s
σοκάκι	s o k a c i
απορώ	a p o ɾ o
αγοράστηκα	a ɣ o ɾ a s t i k a
αντίγκουα	a n t i ɡ w a
μπούφοσ	b u f o s
αϋπνία	a i p n i a
σφαλιάρισμα	s f a ʎ a ɾ i z m a
απελπισμένο	a p e l p i z m e n o
υπολογιστικόσ	i p o l o ʝ i s t i k o s
ευθανασία	e f θ a n a s i a
ιουδαϊσμόσ	i u ð a i z m o s
ανεγνωρισμένοσ	a n e ɣ n o ɾ i z m e n o s
πατέρα	p a t e r a
συνεχίζουμε	s i n e ç i z u m e
ένζυμο	e n z i m o
ακολασία	a k ɔ l a s i a
ἐξέπλευσα	e k s e p l e f s a
πρωτοανακαλύφθηκα	p ɾ o t o a n a k a l i f θ i k a
έριδεσ	e r i ð e s
ζηλευτόσ	z i l e f t o s
γητεύω	ʝ i t e v o
πιλοτάρομαι	p i l o t a ɾ o m e
σουίτα	s u i t a
θερμοκοιτίδασ	θ e r m o c i t i ð a s
γρινιάζω	ɣ ɾ i ɲ a z o
δεμάτι	ð e m a t i
τσούχτρα	t͡s u x t r a
πάμμαυρησ	p a m a v ɾ i s
δράκοσ	ð ɾ a k o s
εκπέμπομαι	e k p e m b o m e
σουτάρω	s u t a ɾ o
ικανοποιημένε	i k a n o p i i m e n e
περιήγηση	p ɛ ɾ i i ʝ i s i
αναδημιουργημένο	a n a ð i m i u r ʝ i m e n o
υδρόφιλοσ	i ð r o f i l o s
χεσμένων	ç e z m e n o n
αντικλεπτικό	a n d i k l e p t i k o
ταχυδρομείο	t a ç i ð ɾ o m i o
ρόδο	ɾ o ð o
φλόκι	f l o c i
επετράπη	e p e t ɾ a p i
κεκλεισμένε	c e k l i z m e n e
αλείφουμε	a l i f u m e
ψηφίσατε	p s i f i s a t e
αυτοκινούμενοσ	a f t o c i n u m e n o s
στρέφουμε	s t ɾ e f u m e
καλομοίρασ	k a l o m i r a s
λονδίνο	l o n ð i n o
στράφηκα	s t ɾ a f i k a
μπουγαζιού	b u ɣ a z ʝ u
συλλέγω	s i l e ɣ o
χείλια	ç i ʎ a
χαίτη	ç e t i
συγκρούστηκα	s i ŋ ɡ r u s t i k a
ρόζοσ	r o z o s
φέτοσ	f e t o s
ἐφάπτομαι	e f a p t o m e
αντέχω	a n d e x o
στιμμένα	s t i m e n a
ανελκύομαι	a n e l c i o m e
ξένα	k s e n a
γκεσέμια	ɟ e s e m ɲ a
γεωγραφικόν	ʝ e o ɣ ɾ a f i k o n
θάφτηκα	θ a f t i k a
πιπώνω	p i p o n o
επικαλύπτομαι	e p i k a l i p t o m e
κουράδα	k u ɾ a ð a
ευθυμίεσ	e f θ i m i e s
ταιριάζω	t e r ʝ a z o
υπερκαινοφανείσ	i p e ɾ c e n o f a n i s
ένρινων	e n r i n o n
προσγράφω	p ɾ o z ɣ r a f o
πολύ	p o l i
αποκρούσθηκα	a p o k r u s θ i k a
μυρωμένε	m i r o m e n e
ιρλανδικόσ	i ɾ l a n ð i k o s
ξεσπίτωμα	k s e s p i t o m a
παρελθούσεσ	p a ɾ e l θ u s e s
ἀνεσκάφην	a n e s k a f i n
γαμημένεσ	ɣ a m i m e n e s
διπλανοί	ð i p l a n i
κατσαπλιάσ	k a t s a p ʎ a s
πολωνέζασ	p o l o n e z a s
γέννα	ʝ e n a
φραντζόλα	f r a n d z o l a
ελεημοσύνη	e l e i m o s i n i
κυρογενιά	c i r o ʝ e ɲ a
χαστουκάκι	x a s t u k a c i
σημαδεύτηκα	s i m a ð e f t i k a
γιορτάζουμε	ʝ o ɾ t a z u m e
μυγίτσα	m i ʝ i t s a
αμνηστεύω	a m n i s t e v o
εξαλείφω	e k s a l i f o
διαβεβαιώνω	ð ʝ a v e v e o n o
σοφούσ	s o f u s
γάμοσ	ɣ a m o s
αναβαλλόμενο	a n a v a l o m e n o
παρκάριζα	p a ɾ k a ɾ i z a
παραγράφτηκα	p a ɾ a ɣ ɾ a f t i k a
θρόμβωση	θ ɾ o ɱ v o s i
στειμμένη	s t i m e n i
γονυπετείσ	ɣ o n i p e t i s
διηθώ	ð i i θ o
κοινοβίτησ	c i n o v i t i s
κινδυνεύσει	c i n ð i n e f s i
ροχαλίζω	ɾ o x a l i z o
δεσπόζω	ð e s p o z o
ζεύγη	z e v ʝ i
τελευταίωσ	t e l e f t e o s
αναβαλλόμενησ	a n a v a l o m e n i s
ανάργυροσ	a n a ɾ ʝ i ɾ o s
απατώ	a p a t o
αυτοκινητάκια	a f t o c i n i t a c a
ενέσκηψα	e n e s c i p s a
πωλήσεισ	p o l i s i s
ανακόπτουμε	a n a k o p t u m e
βαυαρία	v a v a r i a
αλλαγή	a l a ʝ i
έδιωξα	e ð ʝ o k s a
κλέβομαι	k l e v o m e
ισχύων	i s ç i o n
μπονατσάριζε	b o n a t s a ɾ i z e
ροδιά	ɾ o ð ʝ a
παρεκτράπηκαν	p a ɾ e k t ɾ a p i k a n
έγκυοσ	ɛ ŋ ɟ i ɔ s
κραγμένοι	k r a ɣ m e n i
εγχέω	e ŋ ç e o
αποκρύπτομαι	a p o k ɾ i p t o m e
σπουργιτιών	s p u ɾ ʝ i t ç o n
λεπτό	l e p t o
αράδα	a ɾ a ð a
κωλύθηκα	k o l i θ i k a
δευτεραγωνιστέσ	ð e f t e r a ɣ o n i s t e s
ενάντια	e n a n d i a
ερχόμενε	e r x o m e n e
ανέδειξα	a n e ð i k s a
ψωμάκι	p s o m a c i
αμειψισπορά	a m i p s i s p o ɾ a
βρικόλακασ	v ɾ i k o l a k a s
σκατόγρια	s k a t o ɣ ɾ i a
ευγενικότεροσ	e v ʝ e n i k o t e r o s
κατασκευάζω	k a t a s c e v a z o
ασέβειασ	a s e v i a s
ακρεοφαγία	a k ɾ e o f a ʝ i a
επείγων	e p i ɣ o n
ένρινοι	e n r i n i
διαπληκτίζομαι	ð i a p l i k t i z o m e
κουτσομπολεύομαι	k u t s o b o l e v o m e
αγύρτησ	a ʝ i ɾ t i s
κομμένου	k o m e n u
επικαλύπτομε	e p i k a l i p t o m e
λιμπίστηκα	l i m b i s t i k a
εξέρρευσα	e k s e r e f s a
απαράδεκτα	a p a ɾ a ð e k t a
σκορδόψωμου	s k o ɾ ð o p s o m u
αναγνωρισμένο	a n a ɣ n o r i z m e n o
κίτρο	c i t ɾ o
ποδάρια	p o ð a ɾ ʝ a
μαλακισμένουσ	m a l a c i z m e n u s
προσπαθώντασ	p ɾ o s p a θ o n d a s
αναζωογόνηση	a n a z o o ɣ o n i s i
ακοομετρίασ	a k o o m e t r i a s
ροδακίνων	r o ð a c i n o n
πεθαμένο	p e θ a m e n o
εκχέομαι	e k ç e o m e
αναλυτικά	a n a l i t i k a
υπερηφάνεια	i p e r i f a n i a
υστέρησα	i s t e ɾ i s a
αλάσκα	a l a s k a
κοινολεξία	c i n o l e k s i a
ανεσκάφην	a n e s k a f i n
απαλείφουμε	a p a l i f u m e
νόσε	n o s e
συγκινητικά	s i ŋ ɟ i n i t i k a
εαυτόσ	e a f t o s
θυελλώδησ	θ i e l o ð i s
νομίζω	n o m i z o
φασαρία	f a s a ɾ i a
ντετερμινισμό	d e t e r m i n i z m o
εξαλείφομε	e k s a l i f o m e
αξιογέλαστοσ	a k s i o z i l e f t o s
αλαφιασμένου	a l a f ç a z m e n u
κένταυροσ	c e n d a v ɾ o s
προηγούμενεσ	p r o i ɣ u m e n e s
άλγοσ	a l ɣ o s
απαρχαιωμένο	a p a r ç e o m e n o
μνήμησ	m n i m i s
αποκλεισμένησ	a p o k l i z m e n i s
σερβίρισα	s e ɾ v i ɾ i s a
λίγοσ	l i ɣ o s
γκαστρωμένουσ	ɡ a s t r o m e n u s
άμπωτη	a m b o t i
καλομαθημένοσ	k a l o m a θ i m e n o s
μάισνερ	m a i z n e r
παοκ	p a o k
κελαϊδάω	c e l a i ð a o
τσιτσίδι	t s i t s i ð i
άγρωστη	a ɣ ɾ o s t i
απελπισμένων	a p e l p i z m e n o n
άλιμοσ	a l i m o s
μπογάζι	b o ɣ a z i
αγιοποιημένη	a ʝ i o p i i m e n i
προφητεύω	p ɾ ɔ f i t e v o
αποκλείω	a p o k l i o
παραπαίω	p a r a p e o
αλείβουμε	a l i v u m e
σκύλοσ	s c i l o s
εψέσ	e p s e s
ανησυχία	a n i s i ç i a
αγγιγμένη	a ŋ ɟ i ɣ m e n i
θέματα	θ e m a t a
όρεξη	o ɾ e k s i
πέσαχ	p e s a x
αναγκών	a n a ŋ ɡ o n
ακρεωφαγία	a k ɾ e o f a ʝ i a
βυζάρα	v i z a ɾ a
κωνσταντίνε	k o n s t a n d i n e
καστοριά	k a s t o ɾ ʝ a
σύνθλιψε	s i n θ l i p s e
απασχολημένου	a p a s x o l i m e n u
αμοιβαίοσ	a m i v e o s
δάφνη	ð a f n i
σερβιρίστηκα	s e ɾ v i ɾ i s t i k a
κάθομαι	k a θ o m e
συλλέχτηκα	s i l e x t i k a
πάμμαυρο	p a m a v ɾ o
συγκρούομαι	s i ŋ ɡ r u o m e
απολογητικέσ	a p o l o ʝ i t i c e s
κατασκόπεψα	k a t a s k o p e p s a
εγκαταλείπω	e ŋ ɡ a t a l i p o
γούσταρε	ɣ u s t a ɾ e
ευφροσύνη	e f ɾ o s i n i
δάγκωσα	ð a ŋ ɡ o s a
αναγράφομαι	a n a ɣ r a f o m e
κούκλοσ	k u k l o s
καυλώνω	k a v l o n o
φραγκοσταφυλιά	f ɾ a ŋ ɡ o s t a f i ʎ a
αντίο	a d i o
ποικιλότατεσ	p i c i l o t a t e s
ιδρύομαι	i ð r i o m e
ερχομένων	e r x o m e n o n
εφοδιάζομαι	e f o ð i a z o
ενρινότητασ	e n r i n o t i t a s
ιεράρχεσ	i e r a r ç e s
ευθεία	e f θ i a
κουράδασ	k u ɾ a ð a s
φθινοπωριάτικοσ	f θ i n o p o ɾ ʝ a t i k o s
κωνσταντινούπολησ	k o n s t a n d i n u p o l i s
άκαμπτοσ	a k a m p t o s
ανγκουίλα	a ŋ ɡ u i l a
εξοπλισμένου	e k s o p l i z m e n u
γίγνεσθαι	ʝ i ɣ n e s θ e
περικόβουμε	p e ɾ i k o v u m e
γενοκτονία	ʝ e n o k t o n i a
λύσαν	l i s a n
ανασκάφτηκα	a n a s k a f t i k a
ηρόδοτοσ	i r o ð o t o s
αποβλέπω	a p o v l e p o
αποκαλύπτω	a p o k a l i p t o
ανεπανόρθωτοσ	a n e p a n o r θ o t o s
ποίησισ	p i i s i s
ώριμη	o ɾ i m i
συγκινώ	s i ŋ ɟ i n o
μνήμεσ	m n i m e s
έγγραφο	e ŋ ɣ r a f o
λαιστρυγόνασ	l e s t r i ɣ o n a s
ελεύθεροσ	e l e f θ e r o s
μαζικήσ	m a z i c i s
ενδεχομένωσ	e n ð e x o m e n o s
σοφήσ	s o f i s
αβαράρισα	a v a ɾ a ɾ i s a
στάζομαι	s t a z o m e
γαμημένε	ɣ a m i m e n e
παρέπλευσα	p a r e p l e f s a
κεράτωμα	c e ɾ a t o m a
αεροδρόμιο	a e ɾ o ð ɾ o m i o
αρχιμαλάκασ	a ɾ ç i m a l a k a s
νέμεσισ	n ɛ m ɛ s i s
μαζικότατη	m a z i k o t a t i
αλατισμένοσ	a l a t i z m e n o s
κανάκευα	k a n a c e v a
απασχολήθηκα	a p a s x o l i θ i k a
κούπα	k u p a
κουτσοί	k u t s i
τετριμμένασ	t e t r i m e n a s
ποδοσφαίρου	p o ð o s f e r u
σύδεντρο	s i ð e n d r o
πιλοτάρισα	p i l o t a ɾ i s a
τιτάνοσ	t i t a n o s
βλέποντασ	v l e p o n d a s
χεσμένη	ç e z m e n i
ντούμπλαρα	d u b l a ɾ a
ποδοσφαιρίστρια	p o ð o s f e ɾ i s t ɾ i a
χορεύομαι	x o ɾ e v o m e
ονειρεύτηκα	o n i ɾ e f t i k a
προσελκύουμε	p r o s e l c i u m e
ειλημμένα	i l i m e n a
φυτικῶν	f i t i k o n
σώγαμπροσ	s o ɣ a m b ɾ o s
ντετερμινισμού	d e t e r m i n i z m u
φιλοσοφία	f i l o s o f i a
καλμάριζε	k a l m a ɾ i z e
κρεμασμένου	k r e m a z m e n u
πατέρασ	p a t e r a s
αναμαλλιασμένεσ	a n a m a ʎ a z m e n e s
κλεφτρόνι	k l e f t ɾ o n i
διαχειρίσθηκα	ð i a ç i ɾ i s θ i k a
αραχνιασμένησ	a ɾ a x ɲ a z m e n i s
πέδιλο	p e ð i l o
μουσκεμένοι	m u s c e m e n i
συνήρθα	s i n i r θ a
κωσταντίνασ	k o s t a n d i n a s
ιδρύομε	i ð r i o m e
αναφύομαι	a n a f i o m e
πιόνιο	p i o n i o
εισπνεύστηκα	i s p n e f s t i k a
πλακώνω	p l a k o n o
γοήτεψα	ɣ o i t e p s a
απασχολημένη	a p a s x o l i m e n i
μαρκάριζα	m a ɾ k a ɾ i z a
εγχύνομαι	e ŋ ç i n o m e
βαθμολογημένοσ	v a θ m o l o ʝ i m e n o s
ιεροσόλυμα	i e ɾ o s o l i m a
ανακάλυψη	a n a k a l i p s i
αμφιλεγόμενεσ	a ɱ f i l e ɣ o m e n e s
λυθήκαμε	l i θ i k a m e
τίνεσ	t i n e s
οσάκα	o s a k a
κρύσταλλοσ	k r i s t a l o s
αποκρύπτω	a p o k ɾ i p t o
μισό	m i s o
έγνοια	e ɣ ɲ a
γογγύζω	ɣ o ŋ ɟ i z o
αναμμένο	a n a m e n o
αλεξάνδρεια	a l e k s a n ð ɾ i a
πωλήσιμοσ	p o l i s i m ɔ s
εκχέω	e k ç e o
σχόλιο	s x o l i o
απορρίφθηκα	a p o ɾ i f θ i k a
τριμμένου	t r i m e n u
καταγράφουμε	k a t a ɣ r a f u m e
ανατινάζομαι	a n a t i n a z o m e
στιμμένοσ	s t i m e n o s
αγιατολάχ	a ʝ a t o l a x
σταυροφορία	s t a v ɾ ɔ f ɔ ɾ i a
εκλέρ	e k l e ɾ
εξαίρω	e k s e r o
πόλη	p o l i
λυθήκατε	l i θ i k a t e
συγγράφει	s i ŋ ɣ r a f i
μπουγιαμπέσα	b u ʝ a m b e s a
ογδοήκοντα	o ɣ ð o i k o n d a
αηδιασμένο	a i ð i a z m e n o
ποντάρισα	p o n d a ɾ i s a
θύελλα	θ i e l a
πολωνικέσ	p o l o n i c e s
αναμιγνύω	a n a m i ɣ n i o
αποδείχτηκαν	a p o ð i x t i k a n
στριμμένη	s t ɾ i m e n i
πουλάρι	p u l a ɾ i
περσέα	p e ɾ s e a
γιόρτασα	ʝ o ɾ t a s a
πλησιάστηκα	p l i s i a s t i k a
σπουργιτιού	s p u ɾ ʝ i t ç u
σπάρτο	s p a ɾ t o
άργοσ	a ɾ ɣ o s
πάμμαυρεσ	p a m a v ɾ e s
γιασεμί	ʝ a s e m i
αναθεματισμένου	a n a θ e m a t i z m e n u
γαργαλεύομαι	ɣ a ɾ ɣ a l e v o m e
ανεπίγραφοσ	a n e p i ɣ r a f o s
σαχλαμάρα	s a x l a m a ɾ a
ανεπαίσθητοσ	a n e p e s θ i t o s
αίσθηση	ɛ s θ i s i
ντίνοσ	d i n o s
στειμμένε	s t i m e n e
αντικλεπτική	a n d i k l e p t i c i
έφθασα	e f θ a s a
λύνε	l i n e
ζωντανόσ	z o n d a n o s
αγγίζομαι	a ŋ ɟ i z o m e
μανάβησ	m a n a v i s
βραχυκυκλώνω	v ɾ a ç i c i k l o n o
κορόιδευε	k o ɾ o i̯ ð e v e
μαθεύτηκε	m a θ e f t i c e
επιτρέπω	e p i t ɾ e p o
ημερεύω	i m e ɾ e v o
πουδράρομαι	p u ð ɾ a ɾ o m e
στυμμένων	s t i m e n o n
τρανσ	t ɾ a n s
ηλικιωμένεσ	i l i c i o m e n e s
μουσκεύω	m u s c e v o
αγίων	a ʝ i o n
βρίζομαι	v ɾ i z o m e
αναγνωρίζω	a n a ɣ n o ɾ i z o
πρόβλημα	p r ɔ v l i m a
αβγοκομμένη	a v ɣ o k o m e n i
έρρινοι	e r i n i
παίδεψα	p e ð e p s a
εμπνευσμένοι	e m b n e v z m e n i
διαμείβομαι	ð i a m i v o m e
τάλιρο	t a l i ɾ o
ψημένεσ	p s i m e n e s
κυνηγήθηκα	c i n i ɣ i θ i k a
αγανακτισμένε	a ɣ a n a k t i z m e n e
πορτοκαλόπιτα	p o ɾ t o k a l o p i t a
ξεχειλίζω	k s e ç i l i z o
γένεσισ	ʝ e n e s i s
αξιοσημείωτεσ	a k s i o s i m i o t e s
περιθάλπω	p e ɾ i θ a l p o
λύσουν	l i s u n
θλίβω	θ l i v o
ανιδρύω	a n i ð r i o
σιχαίνομαι	s i ç e n o m e
γενέσεισ	ʝ e n e s i s
βελόνα	v ɛ l ɔ n a
κάδρο	k a ð ɾ o
σιταποθήκη	s i t a p o θ i c i
τζερτζελέσ	d z e ɾ d z e l e s
σέρβιρα	s e ɾ v i ɾ a
γεωγραφίασ	ʝ e o ɣ r a f i a s
αλληλοσυγκρουόμενη	a l i l o s i ŋ ɡ r u o m e n i
προφητεύτηκα	p ɾ ɔ f i t e f t i k a
λευκούσ	l e f k u s
δαγκάνω	ð a ŋ ɡ a n o
βραδάκι	v ɾ a ð a c i
βουτυρωμένεσ	v u t i r o m e n e s
πειθόμενη	p i θ o m e n i
απόγονοσ	a p o ɣ o n o s
μασαχουσέτη	m a s a x u s e t i
έδεσσα	e ð e s a
απεκόπην	a p e k o p i n
λυμένησ	l i m e n i s
ληστεύω	l i s t e v o
χρονολογήσεων	x r o n o l o ʝ i s e o n
αλίμενοσ	a l i m e n o s
συνδέομαι	s i n ð e o m e
δέλτα	ð e l t a
σκάνταλο	s k a n d a l o
ολόφωτε	o l o f o t e
αγίασ	a ʝ i a s
φάντασμα	f a n d a z m a
συνεχίζομαι	s i n e ç i z o m e
ζέμπρα	z e b ɾ a
ανασκάπτω	a n a s k a p t o
πεθαμένα	p e θ a m e n a
ψήφο	p s i f o
μαγιονέζα	m a ʝ o n e z a
πορτοκαλόπιτεσ	p o ɾ t o k a l o p i t e s
σάπων	s a p o̞ n
κόπτομαι	k o p t o m e
ολόφωτοι	o l o f o t i
κοκκίνου	k o c i n u
άρτα	a ɾ t a
παρεκτρέπουμε	p a ɾ e k t ɾ e p u m e
αλγέρι	a l ʝ e r i
απολογητικέ	a p o l o ʝ i t i c e
λυνόμασταν	l i n o m a s t a n
υποδήματοσ	i p o ð i m a t o s
συλλέγομαι	s i l e ɣ o m e
αηδιασμένου	a i ð i a z m e n u
ἐξετέλεσα	e k s e t e l e s a
έρπω	e r p o
γκομενάρα	ɡ o m e n a ɾ a
τιμή	t i m i
κόκκινουσ	k o c i n u s
μοιρασμένο	m i ɾ a z m e n o
μα	m a
καργαδούρησ	k a r ɣ a ð u r i s
επιχαίρω	e p i ç e r o
γνοιάζομαι	ɣ ɲ a z o m e
ναύπακτο	n a f p a k t o
ήσαν	i s a n
μπαρκάριζε	b a ɾ k a ɾ i z e
δασμόσ	ð a z m o s
γέφυρα	ʝ e f i r a
δευτεραγωνιστών	ð e f t e r a ɣ o n i s t o n
ανακατεύομαι	a n a k a t e v o m e
φύτεψα	f i t e p s a
ενεγράφησαν	e n e ɣ r a f i s a n
χιμπαντζήσ	ç i m b a n d z i s
βλαμμένοι	v l a m e n i
περιοδικόσ	p e r i o ð i k o s
απεύχομαι	a p e f x o m e
οδών	o ð o n
συγκινημένα	s i ŋ ɟ i n i m e n a
κακοκεφιών	k a k o c e f ç o n
ενέπνευσα	e n e p n e f s a
υπολογίζομαι	i p o l o ʝ i z o m e
παρέβλεψα	p a ɾ e v l e p s a
πίτα	p i t a
αγένειοσ	a ʝ e n i o s
περιμένω	p e r i m e n o
αδειάζομαι	a ð ʝ a z o m e
συμπλέω	s i m b l e o
βραχώδησ	v ɾ a x o ð i s
ειλημμένοι	i l i m e n i
βασιλομήτωρ	v a s i l o m i t o ɾ
εξαπολύομαι	e k s a p o l i o m e
αφηγήτρια	a f i ʝ i t ɾ i a
κόρινθο	k o ɾ i n θ o
κρυμμένοσ	k r i m e n o s
κινδύνευσε	c i n ð i n e f s e
αναβαθμολόγησα	a n a v a θ m o l o ʝ i s a
τρώω	t ɾ o o
απολογητικούσ	a p o l o ʝ i t i k u s
πειθόμενουσ	p i θ o m e n u s
κουραστικήσ	k u r a s t i c i s
λυθεί	l i θ i
αβγατισμένο	a v ɣ a t i z m e n o
βασιλεύω	v a s i l e v o
άσεβων	a s e v o n
λιγότερησ	l i ɣ o t e r i s
απεχθάνομαι	a p e x θ a n o m e
αραχνιασμένεσ	a ɾ a x ɲ a z m e n e s
ψημένησ	p s i m e n i s
ξερογλείφτηκα	k s e ɾ o ɣ l i f t i k a
στεναχωρούμαι	s t e n a x o r u m e
καθίζοντασ	k a θ i z o n d a s
οπλή	o p l i
προσήρθα	p ɾ o s i ɾ θ a
πληροφορική	p l i r o f o r i c i
συνεννοήθηκα	s i n e n o i θ i k a
απαράδεκτοσ	a p a ɾ a ð e k t o s
αγκωνάρι	a ŋ ɡ o n a r i
διαμήνυσα	ð i a m i n i s a
συνηθισμένοι	s i n i θ i z m e n i
απολογητικού	a p o l o ʝ i t i k u
γκομενάκοσ	ɡ o m e n a k o s
κουταλιά	k u t a ʎ a
απόπλων	a p o p l o n
πουδράρω	p u ð ɾ a ɾ o
θαυμάστηκα	θ a v m a s t i k a
κοροϊδεύομαι	k o ɾ o i̯ ð e v o m e
απετράπην	a p e t ɾ a p i n
πολωνέζικοσ	p o l o n e z i k o s
μονάρχη	m o n a r ç i
χαρτί	x a ɾ t i
αγγάρεψα	a ŋ ɡ a ɾ e p s a
πειθαναγκάζομε	p i θ a n a ŋ ɡ a z o m e
αβγοθήκη	a v ɣ o θ i c i
ατμόσ	a t m o s
ούτωσ	u t o s
επέσεισα	e p e s i s a
σκατόγεροσ	s k a t o ʝ e ɾ o s
επιτράπηκαν	e p i t ɾ a p i k a n
σύννεφο	s i n ɛ f ɔ
χαλασμένο	x a l a z m e n o
κωλοφυλλάδα	k o l o f i l a ð a
ποικίλησ	p i c i l i s
μαλακίζομαι	m a l a c i z o m e
αμοργού	a m o ɾ ɣ u
δεκανέασ	ð e k a n e a s
αναθεματισμένη	a n a θ e m a t i z m e n i
πείσθηκα	p i s θ i k a
φώσφοροσ	f o s f o ɾ o s
φρέσκαρε	f ɾ e s k a ɾ e
προστατευόμενοσ	p ɾ o s t a t e v o m e n o s
νοστιμεύομαι	n o s t i m e v o m e
θερμοδυναμικόσ	θ e r m o ð i n a m i k o s
ποικιλότερησ	p i c i l o t e r i s
έλυσα	e l i s a
πειθανάγκασα	p i θ a n a ŋ ɡ a s a
αμέτε	a m e t e
αποκόβω	a p o k o v o
εξαπολύω	e k s a p o l i o
παραδεκτοί	p a ɾ a ð e k t i
εκλείψεισ	e k l i p s i s
καδράρισα	k a ð ɾ a ɾ i s a
μπερδεμένη	b e ɾ ð e m e n i
νεκροτομείο	n e k ɾ o t o m i o
εύχεται	e f ç e t e
σύντριψα	s i n d ɾ i p s a
παρατράγουδο	p a ɾ a t ɾ a ɣ u ð o
σοφόσ	s o f o s
αλαμπουρνέζικων	a l a b u r n e z i k o n
στριμμένησ	s t ɾ i m e n i s
πάνσοφοσ	p a n s o f o s
απαράδεχτοσ	a p a ɾ a ð e x t o s
λέγει	l e ʝ i
σκατόπαιδο	s k a t o p e ð o
σαγήνευσα	s a ʝ i n e f s a
ιδρωτίλα	i ð ɾ o t i l a
απαραδέκτωσ	a p a ɾ a ð e k t o s
σκυλάρα	s c i l a ɾ a
εισακούουμε	i s a k u u m e
αποκάλυψα	a p o k a l i p s a
πεπεισμένοι	p e p i z m e n i
κεριών	c e r ʝ o n
αποκερματισμοί	a p o c e ɾ m a t i z m i
εννιά	e ɲ a
κλεισμένε	k l i z m e n e
καλομαθημένου	k a l o m a θ i m e n u
αβγατίζομαι	a v ɣ a t i z o m e
ροπή	ɾ o p i
αυτόλυκοσ	a f t o l i k o s
παραξενιά	p a ɾ a k s e ɲ a
χρονολογήσεωσ	x r o n o l o ʝ i s e o s
συγκινημένοσ	s i ŋ ɟ i n i m e n o s
αλαφιασμένεσ	a l a f ç a z m e n e s
ανάκρουση	a n a k ɾ u s i
νυχτερίδα	n i x t ɛ ɾ i ð a
θεοκρατία	θ e o k r a t i a
ευκολότατοσ	e f k o l o t a t o s
μαζικότατουσ	m a z i k o t a t u s
ενικόσ	ɛ n i k ɔ s
άε	a e
εμπερικλείομαι	e m b e r i k l i o m e
ψωλή	p s o l i
είρων	i r o n
στιγματίστηκα	s t i ɣ m a t i s t i k a
αλκοολούχοσ	a l k o o l u x o s
αλληλοσυγκρουόμενο	a l i l o s i ŋ ɡ r u o m e n o
ξοδιάζομαι	k s o ð ʝ a z o m e
άσεβη	a s e v i
αναρμοδιότητα	a n a ɾ m o ð i o t i t a
αποπέμφθηκα	a p o p e m f θ i k a
αλλαξιέρα	a l a k s ç e ɾ a
παγωμένα	p a ɣ o m e n a
χείλουσ	ç i l u s
κινδυνεύω	c i n ð i n e v o
στενοχωρώ	s t e n o x o r o
αιδώσ	ɛ ð ɔ s
σπρώχτηκα	s p ɾ o x t i k a
ξερόψωμου	k s e r o p s o m u
ανακόπτομε	a n a k o p t o m e
συγγράφουμε	s i ŋ ɣ r a f u m e
επικαρπία	e p i k a ɾ p i a
κεφάτοσ	c e f a t o s
έλειψα	e l i p s a
πασαλείφομαι	p a s a l i f o m e
συρράπτομαι	s i ɾ a p t o m e
εξαλείφτηκα	e k s a l i f t i k a
ανατρέπουμε	a n a t ɾ e p u m e
δέκατοσ	ð e k a t o s
πρησμένησ	p ɾ i z m e n i s
αναλώ	a n a l o
εσωκλείομε	e s o k l i o m e
υπερίσχυσα	i p e r i s ç i s a
υιοθετούμε	i o θ e t u m e
ακριβοπληρώθηκα	a k r i v o p l i ɾ o θ i k a
αποδειχτήκαν	a p o ð i x t i k a n
μία	m i a
πόνταρε	p o n d a ɾ e
κετσέδων	k e t s e ð o n
πολωνέζοσ	p o l o n e z o s
ανοίγω	a n i ɣ o
πιστεύτε	p i s t e f t e
ἐκλάπην	e k l a p i n
ανατίναξα	a n a t i n a k s a
εκτέλεσα	e k t e l e s a
παραγράφηκαν	p a ɾ a ɣ ɾ a f i k a n
πρέζα	p ɾ e z a
κουτσομπολεύτηκα	k u t s o b o l e f t i k a
βαφλιέρα	v a f ʎ e ɾ a
τιμονιέρησ	t i m o ɲ e ɾ i s
δεκατέσσερα	ð e k a t e s e ɾ a
ολόφωτουσ	o l o f o t u s
συγκινημένησ	s i ŋ ɟ i n i m e n i s
χόρεψεσ	x o ɾ e p s e s
αναβαθμίδα	a n a v a θ m i ð a
μισισίπι	m i s i s i p i
λειβαδιά	l i v a ð ʝ a
μπαμπάσ	b a b a s
παρεξήγηση	p a ɾ e k s i ʝ i s i
γενέσθαι	ʝ e n e s θ e
ντετερμινισμοί	d e t e r m i n i z m i
ξένη	k s e n i
ψηφιακών	p s i f i a k o n
αεροφωτογραφώ	a e r o f o t o ɣ r a f o
συνεχίζομε	s i n e ç i z o m e
σοφίαισ	s o f i e s
καφετζού	k a f e n d z u
μαζεύομαι	m a z e v o m e
πιόνι	p ç o n i
διαμείφθηκα	ð i a m i f θ i k a
αμοργόσ	a m o ɾ ɣ o s
επαρκέστερη	e p a ɾ c e s t e ɾ i
αρχιδούκισσα	a ɾ ç i ð u c i s a
απελπισμένεσ	a p e l p i z m e n e s
παρεξετράπην	p a ɾ e k s e t ɾ a p i n
πίθο	p i θ o
φυτικῆσ	f i t i c i s
πίθοσ	p i θ o s
πηδώ	p i ð o
ανθεστηρίων	a n θ e s t i ɾ i o n
τεμπέλιασα	t e m b e ʎ a s a
κουρασμένε	k u r a z m e n e
είχεσ	i ç e s
κομμένεσ	k o m e n e s
βασιλεύσ	v a s i l e f s
παραβλέπομαι	p a ɾ a v l e p o m e
αναδημιουργημένου	a n a ð i m i u r ʝ i m e n u
συντρίφθηκε	s i n d r i f θ i c e
λυθείσ	l i θ i s
αλευρωμένουσ	a l e v r o m e n u s
ληστήσ	l i s t i s
ζεσταμένοι	z e s t a m e n i
ευσεβάστωσ	e f s e v a s t o s
κλαδεύω	k l a ð e v o
στέψεισ	s t e p s i s
ἀναστρέφομαι	a n a s t r e f o m e
θαλαμηγόσ	θ a l a m i ɣ o s
τσίρλα	t s i ɾ l a
χάοσ	x a o s
αρμοδίωσ	a ɾ m o ð i o s
μέσο	m e s o
σκέφτηκα	s c e f t i k a
νιάτα	ɲ a t a
υπολογισμένουσ	i p o l o ʝ i z m e n u s
ἤπια	i p i a
εκτελώ	e k t e l o
δαγκώνω	ð a ŋ ɡ o n o
επαρχία	e p a ɾ ç i a
κολόβωμα	k o l o v o m a
αλατισμένου	a l a t i z m e n u
ψωμάδικων	p s o m a ð i k o n
ποικίλοσ	p i c i l o s
συγκρουόμενα	s i ŋ ɡ r u o m e n a
αδικούμαι	a ð i k u m e
γλυτώνω	ɣ l i t o n o
δηλαδή	ð i l a ð i
λύνετε	l i n e t e
οπερατικόσ	o p e ɾ a t i k o s
τάμα	t a m a
υποσκάπτω	i p o s k a p t o
λιάζω	ʎ a z o
τίνα	t i n a
βιοσφαιρών	v i o s f e ɾ o n
πασαλείβομαι	p a s a l i v o m e
δεκατρείσ	ð e k a t ɾ i s
αβανγκαρντισμόσ	a v a ŋ ɡ a ɾ d i z m o s
στερήσεωσ	s t e ɾ i s e o s
στάζω	s t a z o
άκεφοσ	a c e f o s
εγκαταλείπομαι	e ŋ ɡ a t a l i p o m e
στολή	s t o l i
χαχανίζω	x a x a n i z o
τσακωνικόσ	t s a k o n i k o s
αποπλέω	a p o p l e o
καταλύομαι	k a t a l i o m e
εκτρέπομαι	e k t ɾ e p o m e
γαϊδούρι	ɣ a i ð u ɾ i
μαζεύτε	m a z e f t e
πολωνικά	p o l o n i k a
γκαστρωμένοσ	ɡ a s t ɾ o m e n o s
μηνύομαι	m i n i o m e
επανειλημμένε	e p a n i l i m e n e
εγκλείομε	e ŋ ɡ l i o m e
παντρεμένουσ	p a n d ɾ e m e n u s
είναι	i n ɛ
εγγράφτηκε	e ŋ ɣ r a f t i c e
γάντζοσ	ɣ a n d z o s
καριόλησ	k a ɾ ʝ o l i s
κουτσομπόλευ'	k u t s o b o l e f
παντρεμένη	p a n d ɾ e m e n i
ναυτολόγια	n a f t o l o ʝ i a
υπογραφτείσ	i p o ɣ r a f t i s
αναγεννώμαι	a n a ʝ e n o m e
αγωνιστέσ	a ɣ o n i s t e s
παμψυχισμόσ	p a m p s i ç i s m o s
λύγκασ	l i ŋ ɡ a s
φλιτζανάκι	f l i d z a n a c i
άλλοθι	a l o θ i
σωρόσ	s o ɾ o s
ξερόλασ	k s e ɾ o l a s
εφέτοσ	e f e t o s
τούτοσ	t u t o s
κατερίνη	k a t e ɾ i n i
αγγίζομε	a ŋ ɟ i z o m e
πουτανάρα	p u t a n a ɾ a
αεροφωτογραφήθηκα	a e r o f o t o ɣ r a f i θ i k a
φυτικού	f i t i k u
κατουρλιό	k a t u ɾ ʎ o
ανεκαλύφθην	a n e k a l i f θ i n
προμηθεύθηκα	p ɾ ɔ m i θ e f θ i k a
εκλέγομαι	e k l e ɣ o m e
παρακωλύω	p a r a k o l i o
τέρπουμε	t e ɾ p u m e
κοσμάκη	k o z m a c i
εκπομπή	e k p o m b i
ασεβήσ	a s e v i s
μαζικότερου	m a z i k o t e r u
χάφτεται	x a f t e t e
λέει	l e i
γύρεψα	ʝ i ɾ e p s a
ανεπιθύμητοσ	a n e p i θ i m i t o s
θοδωρήσ	θ o ð o ɾ i s
αποκόπτω	a p o k o p t o
αισχύνη	ɛ s ç i n i
παρακοιμάμαι	p a ɾ a c i m a m e
ασελγώ	a s e l ɣ o
ποικιλότερων	p i c i l o t e r o n
πλέκομαι	p l e k o m e
πουστεύω	p u s t e v o
καημένοσ	k a i m e n o s
ελάττωμα	e l a t o m a
τσάμπα	t s a m b a
χαράζομαι	x a ɾ a z o m e
τεχνολόγοι	t e x n o l o ʝ i
παραχαϊδεύομαι	p a ɾ a x a i̯ ð e v o m e
αγυιά	a ʝ i a
πιστεύομε	p i s t e v o m e
ωσαννά	o s a n a
κωνσταντίνου	k o n s t a n d i n u
ψηφιακά	p s i f i a k a
προφήτεψα	p ɾ ɔ f i t e p s a
πέρασ	p e ɾ a s
απαλλαγή	a p a l a ʝ i
όμικρον	o m i k r o n
τρελή	t r e l i
λέγουμε	l e ɣ u m e
ομόλογο	o m o l o ɣ o
αβασκαμένοσ	a v a s k a m e n o s
αναγνωρισμένε	a n a ɣ n o r i z m e n e
υπολογισμένου	i p o l o ʝ i z m e n u
ρεζίλι	ɾ e z i l e
αναστρέφουμε	a n a s t ɾ e f u m e
μάγκασ	m a ŋ ɡ a s
ανατρέπομαι	a n a t ɾ e p o m e
παρακαλάω	p a r a k a l a o
παραλίγο	p a ɾ a l i ɣ o
ποντάριζα	p o n d a ɾ i z a
στιμμένου	s t i m e n u
άγιασα	a ʝ a s a
καθομιλούμενεσ	k a θ o m i l u m e n e s
αξιοσημείωτων	a k s i o s i m i o t o n
απαγόρευση	a p a ɣ o r e f s i
αλληλοσυγκρουόμενουσ	a l i l o s i ŋ ɡ r u o m e n u s
θεότρελοσ	θ e o t ɾ e l o s
σπίτι	s p i t i
λεσβιάζω	l e z v i a z o
ψηφιακήσ	p s i f i a c i s
πλίνθουσ	p l i n θ u s
καλόγρια	k a l o ɣ ɾ i a
εγγόνια	e ŋ ɡ o ɲ a
αναγκάζομαι	a n a ŋ ɡ a z o m e
μοίρασα	m i ɾ a s a
διά	ð i͜a
αβγοκομμένο	a v ɣ o k o m e n o
δεκατριών	ð e k a t ɾ i o n
παρακάμπτω	p a ɾ a k a m p t o
ανάπνευσα	a n a p n e f s a
πέμφθηκα	p e m f θ i k a
περισπωμένων	p e r i s p o m e n o n
αβγατισμένησ	a v ɣ a t i z m e n i s
κλαψομούνα	k l a p s o m u n a
δικαιολογία	ð i c e o l o ʝ i a
αιματοβαμμένεσ	e m a t o v a m e n e s
μουσκεύτηκα	m u s c e f t i k a
συνέτριψα	s i n e t ɾ i p s a
στεναχωριέμαι	s t e n a x o r ʝ e m e
στιμμένη	s t i m e n i
έχουνε	e x u n e
λυνόμαστε	l i n o m a s t e
επέρχομαι	e p e ɾ x o m e
σουτάρισα	s u t a ɾ i s a
καλοφάγωτε	k a l o f a ɣ o t e
δήμητρασ	ð i m i t r a s
αστυνόμοσ	a s t i n o m o s
εισπλέω	i s p l e o
γάμα	ɣ a m a
φιλοξενούμενοσ	f i l o k s e n u m e n o s
βάλθηκα	v a l θ i k a
ρεζίλεψα	ɾ e z i l e p s a
μοχλόσ	m ɔ x l ɔ s
συνεθλίβη	s i n e θ l i v i
παντελήσ	p a n d e l i s
μαθεύομαι	m a θ e v o m e
μιαίνομαι	m i e n o m e
τσακωνικέσ	t s a k o n i c e s
στειμμένεσ	s t i m e n e s
αμείβω	a m i v o
αμάθεια	a m a θ i a
οστεοφυλάκιο	o s t e o f i l a c i o
στεναχωρημένεσ	s t e n a x o r i m e n e s
αμνηστεύτηκα	a m n i s t e f t i k a
μουνάρα	m u n a ɾ a
λευκή	l e f c i
διαλελυμένεσ	ð i a l e l i m e n e s
επανακάμπτω	e p a n a k a m p t o
λιγότερα	l i ɣ o t e r a
ντίνα	d i n a
προμηθέων	p r o m i θ e o n
φώνημα	f o n i m a
άρα	a ɾ a
συγγραφήσ	s i ŋ ɣ r a f i s
βδελύγματοσ	v ð e l i ɣ m a t o s
σοφέσ	s o f e s
παρεξετράπη	p a ɾ e k s e t ɾ a p i
κιτσ	c i t s
αγνάντεψα	a ɣ n a n d e p s a
κωνσταντινουπόλεωσ	k o n s t a n d i n u p o l e o s
αφουγκράστηκα	a f u ɡ ɾ a s t i k a
παρακείμενησ	p a ɾ a c i m e n i s
αγκυλιού	a ŋ ɟ i ʎ u
άκησ	a c i s
απογοητεύθηκα	a p o ɣ o i t e f θ i k a
άνδρε	a n ð ɾ e
πίνω	p i n o
θλιμμένοσ	θ l i m e n o s
αιχμαλώτισα	e x m a l o t i s a
ανατρέπω	a n a t ɾ e p o
τάλαντο	t a l a n d o
ον	o n
απέδειξε	a p e ð i k s e
εκκλησιάζομαι	e k l i s i a z o m e
σίγουροσ	s i ɣ u ɾ o s
σοροί	s o ɾ i
αποδείχνομαι	a p o ð i x n o m e
τορόντο	t o ɾ o n d o
ανέσκαψα	a n e s k a p s a
χαζομάρα	x a z o m a ɾ a
λωποδύτησ	l o p o ð i t i s
προβλέφθηκα	p ɾ o v l e f θ i k a
αντιγράφηκα	a n d i ɣ r a f i k a
χρονολογίασ	x r o n o l o ʝ i a s
πουδραρίστηκα	p u ð ɾ a ɾ i s t i k a
λιγότερουσ	l i ɣ o t e r u s
παιδεραστία	p e ð e ɾ a s t i a
φιλολογίασ	f i l o l o ʝ i a s
ιδιοσυγκρασία	i ð i ɔ s i ŋ ɡ ɾ a s i a
αθεϊσμοί	a θ e i z m i
έχεισ	e ç i s
πειθόμενου	p i θ o m e n u
παραπάνω	p a ɾ a p a n o
πολλάκισ	p o l a c i s
εγγράφτηκαν	e ŋ ɣ r a f t i k a n
καλύφτηκα	k a l i f t i k a
μεσαιωνικέσ	m e s e o n i c e s
είμαι	i m e̞
σορόσ	s o ɾ o s
ακοήσ	a k o i s
έχω	e x o
φυτικαῖσ	f i t i c e s
παρεξετράπησαν	p a ɾ e k s e t ɾ a p i s a n
κοινολέκτων	c i n o l e k t o n
καλησπέρα	k a l i s p e r a
προπονήσεισ	p r o p o n i s i s
ξυπόλυτοσ	k s i p o l i t o s
ξενοδόχα	k s e n o ð o x a
ντουμπλάρισα	d u b l a ɾ i s a
χαλασμένουσ	x a l a z m e n u s
αμφίλογοσ	a ɱ f i l o ɣ o s
θαυμάζομε	θ a v m a z o m e
ναύπακτε	n a f p a k t e
γουστάρισε	ɣ u s t a ɾ i s e
αλαφιασμένοσ	a l a f ç a z m e n o s
μεσολόγγι	m e s o l o ŋ ɟ i
παγωμένο	p a ɣ o m e n o
δυχατέρα	ð u x a t e̞ r a
απέκοψα	a p e k o p s a
καλομάνεσ	k a l o m a n e s
μουσκεμένο	m u s c e m e n o
ακροχορδώνα	a k ɾ o x o ɾ ð o n a
γιάννενα	ʝ a n e n a
συγκρουόμενων	s i ŋ ɡ r u o m e n o n
πρωτοανακάλυψα	p ɾ o t o a n a k a l i p s a
μαζικότερε	m a z i k o t e r e
απαρχαιωμένα	a p a r ç e o m e n a
εξαίρομαι	e k s e r o m e
αστράφτει	a s t ɾ a f t i
αποσείστηκα	a p o s i s t i k a
επαλείφουμε	e p a l i f u m e
ασελγείσ	a s e l ʝ i s
ανεπαρκώσ	a n e p a ɾ k o s
ερρινότητασ	e r i n o t i t a s
αναταράζω	a n a t a r a z o
πάμμαυρε	p a m a v ɾ e
διδάσκω	ð i ð a s k o
ανασκαλεύομαι	a n a s k a l e v o m e
καλντερίμι	k a l d e ɾ i m i
κυνηγημένοσ	c i n i ʝ i m e n o s
ιεράρχησ	i e r a r ç i s
ζάκυνθο	z a c i n θ o
ιερόδουλοσ	i e ɾ o ð u l o s
λυπημένη	l i p i m e n i
λιγάκι	l i ɣ a c i
πλαγίασα	p l a ʝ i a s a
μπαλαδόροσ	b a l a ð o ɾ o s
ποικίλοι	p i c i l i
μαζικών	m a z i k o n
παρκάρω	p a ɾ k a ɾ o
επανιδρύθηκα	e p a n i ð r i θ i k a
ματοβαμμένησ	m a t o v a m e n i s
απασχολώ	a p a s x o l o
αναπνοή	a n a p n o i
λέγεισ	l e ʝ i s
δορυφόροσ	ð o r i f o r o s
ποδαριού	p o ð a ɾ ʝ u
αντικρούομε	a n d i k r u o m e
ξεψυχάω	k s e p s i x a o
κάλπη	k a l p i
μυταρού	m i t a ɾ u
παρεμποδίζω	p a r e m b o ð i z o
απελπισμένου	a p e l p i z m e n u
εργάστηκα	e ɾ ɣ a s t i k a
φλόριντα	f l o ɾ i d a
τάχα	t a x a
κινεζοποίηση	c i n e z o p i i s i
μπουνατσάρισε	b u n a t s a ɾ i s e
ετράπην	e t ɾ a p i n
λοχίασ	l o ç i a s
ομολογώ	o m o l o ɣ o
προμήνυσα	p r o m i n i s a
γενιών	ʝ e ɲ o n
διαπνέομαι	ð i a p n e o m e
χριστόψωμου	x r i s t o p s o m u
περασμένου	p e r a z m e n u
γητεύτηκα	ʝ i t e f t i k a
νεκρό	n e k ɾ o
επαρκέστεροι	e p a ɾ c e s t e ɾ i
εμπνευσμένου	e m b n e v z m e n u
κομμένοσ	k o m e n o s
καταιγίδα	k a t e ʝ i ð a
έβενοσ	e v e n o s
κεκλεισμένο	c e k l i z m e n o
κορίτσαρου	k o r i t s a r u
εορτάστηκα	e o ɾ t a s t i k a
έσυρα	e s i r a
προσγράφομαι	p ɾ o z ɣ r a f o m e
υπόγραψα	i p o ɣ r a p s a
απότρεψα	a p o t ɾ e p s a
πιλοτάρω	p i l o t a ɾ o
ανακαινίζομαι	a n a c e n i z o m e
αυλόσ	a v l o s
αγκίστρι	a ŋ ɟ i s t r i
παντρεύω	p a n d ɾ e v o
αίγιο	e ʝ i o
αγυιόπαιδα	a ʝ i o p e ð a
ενημερώσεισ	e n i m e r o s i s
αγιοπουλιού	a ʝ o p u ʎ u
πρόσωπο	p ɾ ɔ s ɔ p ɔ
βλάφτω	v l a f t o
τούρτασ	t u ɾ t a s
πονταρίστηκα	p o n d a ɾ i s t i k a
τσακώνικων	t s a k o n i k o n
μοναξιά	m o n a k s ç a
σερβιρίζομαι	s e ɾ v i ɾ i z o m e
μαζικέ	m a z i c e
χεσμένα	ç e z m e n a
φιλί	f i l i
προπόνηση	p r o p o n i s i
μεσαίωνασ	m e s e o n a s
εμπνεύστηκα	e m b n e f s t i k a
αρρωστημένο	a r o s t i m e n o
ιόσ	i ɔ s
ραγιάδων	ɾ a ʝ a ð o n
μήπωσ	m i p o s
στειρότητα	s t i ɾ o t i t a
αιματοβαμμένου	e m a t o v a m e n u
αναπάλλω	a n a p a l o
πεισμένοσ	p i z m e n o s
υποδύομαι	i p o ð i o m e
προαγωγή	p ɾ o a ɣ o ʝ i
φαρμακείο	f a r m a c i o
αποκρούουμε	a p o k r u u m e
μεταπτώσεων	m e t a p t o s e o n
λουκανικόπιτα	l u k a n i k o p i t a
ηλικιωμένων	i l i c i o m e n o n
ἀπεύχομαι	a p e f x o m e
παναγιώτατοσ	p a n a ʝ i o t a t o s
κεφιού	c e f ç u
βαίνω	v e n o
αναλυτήσ	a n a l i t i s
πατσαβουρόπιτα	p a t s a v u ɾ o p i t a
αίμα	ɛː m a
χλιων	x ʎ o n
ντροπιασμένεσ	d ɾ o p ç a z m e n e s
αξιαγάπητοσ	a k s i a ɣ a p i t o s
ηγεμονεύω	i ʝ e m o n e v o
ιλαρά	i l a ɾ a
προηγουμένων	p r o i ɣ u m e n o n
λύνομε	l i n o m e
παρέπεμψα	p a ɾ e p e m p s a
ρόδοσ	ɾ o ð o s
αγιάσθηκα	a ʝ i a s θ i k a
σεβίλλη	s e v i l i
αποδείχτηκε	a p o ð i x t i c e
καταξόδιασα	k a t a k s o ð ʝ a s a
θάλπω	θ a l p o
πιλόταρε	p i l o t a ɾ e
επισκέπτομαι	e p i s c e p t o m e
επιγράφηκε	e p i ɣ r a f i c e
βατραχάνθρωποσ	v a t ɾ a x a n θ ɾ ɔ p ɔ s
αποκρούστηκα	a p o k r u s t i k a
λαιστρυγών	l e s t r i ɣ o n
καπνίστηκα	k a p n i s t i k a
καδράρω	k a ð ɾ a ɾ o
αρμέγω	a ɾ m e ɣ o
σημειώνομε	s i m i o n o m e
κοκκινιστό	k o c i n i s t o
κουρασμένοι	k u r a z m e n i
σωρού	s o ɾ u
χρειάστηκε	x ɾ i a s t i c e
ζητιάνευ'	z i t ç a n e f
προσκόπτω	p ɾ o s k o p t o
πολυμήχανοσ	p o l i m i x a n o s
κεσέμια	c e s e m ɲ a
ντελαπάρω	d e l a p a ɾ o
περασμένα	p e r a z m e n a
κλώσσα	k l o s a
πουστάρα	p u s t a ɾ a
αλήστευτοσ	a l i s t e f t o s
ουσιαστικοποιήσεισ	u s i a s t i k o p i i s i s
ντροπαλόσ	d ɾ o p a l o s
ειλημμένουσ	i l i m e n u s
αγκυλιών	a ŋ ɟ i ʎ o n
περικόπτουμε	p e ɾ i k o p t u m e
κεντώ	c e n t o
ακροβασία	a k r o v a s i a
μαντολάτο	m a n d o l a t o
πεισμένη	p i z m e n i
όρνιθα	o r n i θ a
κάθιδροσ	k a θ i ð r o s
ξινίλα	k s i n i l a
λευκώ	l e f k o
ερχόμενη	e r x o m e n i
φούμαρα	f u m a ɾ a
βλαμμένη	v l a m e n i
καλύψεισ	k a l i p s i s
διασκέφθηκα	ð i a s c e f θ i k a
ερρινοποιήσεων	e r i n o p i i s e o n
μουνοπαγίδα	m u n o p a ʝ i ð a
αναδείχτηκα	a n a ð i x t i k a
θερμοδυναμικέ	θ e r m o ð i n a m i c e
κούκλα	k u k l a
εμπνευσμένα	e m b n e v z m e n a
έρχομαι	e ɾ x o m e
πιστεύτηκα	p i s t e f t i k a
συμφυρμούσ	s i ɱ f i r m i u s
λαμία	l a m i a
εξαιτίασ	e k s e t i a s
ανιδρύομε	a n i ð r i o m e
αλευρωμένε	a l e v r o m e n e
πίνομε	p i n o m e
επτά	e p t a
περασμένων	p e r a z m e n o n
ναυσικᾶσ	n a f s i k a s
κοινή	c i n i
αποκερματισμόσ	a p o c e ɾ m a t i z m o s
ορθόδοξοσ	o ɾ θ o ð o k s o s
μυγούλα	m i ɣ u l a
αναδημιουργημένη	a n a ð i m i u r ʝ i m e n i
αναλώνω	a n a l o n o
πιλοτάριζα	p i l o t a ɾ i z a
ματοκυλίζομαι	m a t o c i l i z o m e
τρίφτηκα	t r i f t i k a
ερρινομελήσ	e r i n o m e l i s
πεισμένα	p i z m e n a
πόρνη	p ɔ ɾ n i
κομμένο	k o m e n o
παρενέργεια	p a ɾ e n e ɾ ʝ i a
αρχίζω	a r ç i z o
απολογητικοί	a p o l o ʝ i t i c i
στιμμένουσ	s t i m e n u s
ζώδιο	z o ð i o
μπινέσ	b i n e s
διώχτηκα	ð ʝ o x t i k a
ξασπρίζω	k s a s p r i z o
γενεών	ʝ e n e o n
τσακωνικούσ	t s a k o n i k u s
σπίτωμα	s p i t o m a
φωτογραφείων	f o t o ɣ r a f i o n
αναπλειστηριασμόσ	a n a p l i s t i r i a z m o s
νόσου	n o s u
βαν	v a n
σείω	s i o
ζάρι	z a ɾ i
αγανακτισμένοι	a ɣ a n a k t i z m e n i
υποκρύπτω	i p o k ɾ i p t o
ζεσταμένα	z e s t a m e n a
γοητεύθηκα	ɣ o i t e f θ i k a
εισαγγελέασ	i s a ŋ ɟ e l e a s
ψημένουσ	p s i m e n u s
ξεβράκωτοσ	k s e v ɾ a k o t o s
ένρινου	e n r i n u
λύσουνε	l i s u n e
αθεϊσμέ	a θ e i z m e
εξοπλισμένο	e k s o p l i z m e n o
πρωτοβουλία	p ɾ o t o v u l i a
πρωτεύουσα	p ɾ ɔ t ɛ v u s a
λιώνω	ʎ o n o
γιατί	ʝ a t i
ποικιλότατου	p i c i l o t a t u
συγγράφω	s i ŋ ɣ r a f o
καλοφάγωτουσ	k a l o f a ɣ o t u s
αληθεύει	a l i θ e v i
ανακόπτω	a n a k o p t o
καψώνι	k a p s o n i
ολόφωτα	o l o f o t a
αποπέμπομαι	a p o p e m b o m e
εξέπεμψα	e k s e p e m p s a
πεπεισμένη	p e p i z m e n i
υπολείπομαι	i p o l i p o
εξετελέσθην	e k s e t e l e s θ i n
πλειόκαινο	p l i o c e n o
συγνώμη	s i ɣ n o m i
αναλύω	a n a l i o
ὑπογράφεισ	i p o ɣ r a f i s
παγωμένου	p a ɣ o m e n u
πούστικα	p u s t i k a
δέω	ð e o
ξινό	k s i n o
κοκκινιστόσ	k o c i n i s t o s
ηλικιωμένο	i l i c i o m e n o
τελῶ	t e l o
αβάραρε	a v a ɾ a ɾ e
έχαψα	e x a p s a
αβανγκαρντισμούσ	a v a ŋ ɡ a ɾ d i z m u s
πρωτάθλημα	p ɾ o t a θ l i m a
γράφω	ɣ r a f o
υπολογισμένα	i p o l o ʝ i z m e n a
φύομαι	f i o m e
διαβάζω	ð ʝ a v a z o
ιπποπόταμοσ	i p o p o t a m o s
ανεκόπην	a n e k o p i n
έλληνεσ	e l i n e s
συνέρρευσα	s i n e r e f s a
παραχαϊδεύω	p a ɾ a x a i̯ ð e v o
αράχνη	a ɾ a x n i
δράμα	ð r a m a
σκέπτομαι	s c e p t o m e
ψωμιού	p s o m ɲ u
ψάχνω	p s a x n o
αγανακτισμένουσ	a ɣ a n a k t i z m e n u s
σύρω	s i r o
παραδεκτή	p a ɾ a ð e k t i
γιογιό	ʝ o ʝ o
υπολογιστικά	i p o l o ʝ i s t i k a
εφτά	e f t a
κεκλεισμένεσ	c e k l i z m e n e s
διαλελυμένου	ð i a l e l i m e n u
λιμένων	l i m e n o n
αρχίδαμοσ	a ɾ ç i ð a m o s
αποτράπηκα	a p o t ɾ a p i k a
μουνόπανο	m u n o p a n o
πάλλευκοσ	p a l e f k o s
καθείλκυσα	k a θ i l c i s a
λυκάνθρωποσ	l i k a n θ ɾ o p o s
πεπεισμένοσ	p e p i z m e n o s
απασχολημένησ	a p a s x o l i m e n i s
μαρκάρισα	m a ɾ k a ɾ i s a
βάσω	v a s o
επιγραφτήκανε	e p i ɣ r a f t i k a n e
απαρχαιωμένησ	a p a r ç e o m e n i s
συνέγραψα	s i n e ɣ r a p s a
μάντησ	m a n d i s
σταματία	s t a m a t i a
αλεγράρισα	a l e ɣ ɾ a ɾ i s a
αλογόμυγα	a l o ɣ o m i ɣ a
ψημένοσ	p s i m e n o s
τσίτσιδοσ	t s i t s i ð o s
στεναχωρημένο	s t e n a x o r i m e n o
βαβαρία	v a v a r i a
ξενοδοχειακόσ	k s e̞ n o̞ ð o̞ ç ɐ o̞ s
διαμηνύομαι	ð i a m i n i o m e
υπερτροφία	i p e ɾ t ɾ o f i a
στειμμένων	s t i m e n o n
τρόμοσ	t r o m o s
ποικιλότερη	p i c i l o t e r i
αετιδεύσ	a e t i ð e f s
συνδέθηκα	s i n ð e θ i k a
ακταιωρέ	a k t e o r e
λύνοντασ	l i n o n d a s
πνεύμα	p n e v m a
ανάλυση	a n a l i s i
συμπολεμίστρια	s i m b o l e m i s t r i a
τσακώνικησ	t s a k o n i c i s
γουρούνα	ɣ u ɾ u n a
καταξοδιάστηκα	k a t a k s o ð ʝ a s t i k a
εμπαίζω	e m b e z o
παϊδάκια	p a i ð a c a
σβήνω	z v i n o
κτηνοβάτησ	k t i n o v a t i s
αθεϊσμού	a θ e i z m u
χαράμι	x a ɾ a m i
πανεύκολα	p a n e f k o l a
κοινόν	c i n o n
απολογητικά	a p o l o ʝ i t i k a
βυθισμένη	v i θ i z m e n i
αγλάισμα	a ɣ l a i z m a
αναβαλλόμενοσ	a n a v a l o m e n o s
τηλεθέαση	t i l e θ e a s i
γουστάρω	ɣ u s t a ɾ o
προσγράφομε	p ɾ o z ɣ r a f o m e
χεζάσ	ç e z a s
αποκυήματοσ	a p o c i i m a t o s
πέταμα	p e t a ɣ m a
βράδυ	v r a ð i
λύναν	l i n a n
αγαπιέμαι	a ɣ a p ç e m e
κοιτάζομαι	c i t a z o m e
αδρεναλίνη	a ð ɾ e n a l i n i
τσακώνικουσ	t s a k o n i k u s
λόφοσ	l o f o s
χρονολογώ	x r o n o l o ɣ o
εγέρθητι	e ʝ e ɾ θ i t i
βαθμολογημένοι	v a θ m o l o ʝ i m e n i
κοιτίδεσ	c i t i ð e s
περιορισμένοσ	p e ɾ i o ɾ i z m e n o s
επτακόσια	e p t a k o s ç a
αληθούσ	a l i θ u s
ιντιάνα	i n d i a n a
αμφιλεγόμενε	a ɱ f i l e ɣ o m e n e
φαιόσ	f e o s
αραχνιασμένα	a ɾ a x ɲ a z m e n a
άσεβο	a s e v o
εὐσέβεια	e f s e v i a
λυνόντουσαν	l i n o n d u s a n
κανονικόσ	k a n o n i k o s
παντού	p a n d u
αναπόσβεστοσ	a n a p o z v e s t o s
ντουσ	d u s
κοριτσιών	k o ɾ i t s ç o n
αποστηθίζομαι	a p o s t i θ i z o m e
αιματοβαμμένα	e m a t o v a m e n a
ραγιάδεσ	ɾ a ʝ a ð e s
ανασαλεύτηκα	a n a s a l e f t i k a
επικαλύφτηκα	e p i k a l i f t i k a
αρχίδι	a ɾ ç i ð i
ήσαστε	i s a s t e
ξεκωλώνω	k s e k o l o n o
σύρθηκα	s i r θ i k a
πάμμαυρων	p a m a v ɾ o n
στενοχωρημένο	s t e n o x o r i m e n o
διαπνέουμε	ð i a p n e u m e
ένρινησ	e n r i n i s
βυθισμένα	v i θ i z m e n a
συγκρούσθηκα	s i ŋ ɡ r u s θ i k a
δικόσ	ð i k o s
πρήζομαι	p ɾ i z o m e
ψοφάω	p s o f a o
βρεφοκομείο	v ɾ e f o k o m i o
σκάσε	s k a s e
διαμοιραστήσ	ð i a m i r a s t i s
αγκαζαρίστηκα	a ŋ ɡ a z a ɾ i s t i k a
στολίζομαι	s t o l i z o m e
λύομε	l i o m e
ὑπογράφει	i p o ɣ r a f i
σταθμόσ	s t a θ m o s
φέτα	f e t a
σκορδόψωμα	s k o ɾ ð o p s o m a
υπέθαλψα	i p e θ a l p s a
ανέγραψα	a n e ɣ r a p s a
μαλώνω	m a l o n o
πνέω	p n e o
ικανοποιημένο	i k a n o p i i m e n o
πίπα	p i p a
στέφομαι	s t e f o m e
ψηφοδέλτιο	p s i f o ð e l t i o
τετριμμένοσ	t e t r i m e n o s
λογίζομαι	l o ʝ i z o m e
ξεσκατίζω	k s e s k a t i z o
ταράχτηκα	t a r a x t i k a
βλαμμένο	v l a m e n o
μωροί	m o ɾ i
λύνω	l i n o
χοντρομπαλάσ	x o n d ɾ o b a l a s
τρέμω	t r e m o
ακοομέτρηση	a k o o m e t r i s i
παιδεύω	p e ð e v o
πρόφτασα	p ɾ ɔ f t a s a
αλυσοδεμένοσ	a l i s o ð e m e n o s
τόσοσ	t o s o s
αποσταίνω	a p o s t e n o
τολμάω	t o l m a o
προμηθέασ	p r o m i θ e a s
ματόκλαδων	m a t o k l a ð o n
λείπω	l i p o
κοιτίδα	c i t i ð a
πλακούντασ	p l a k u n d a s
λιγότερε	l i ɣ o t e r e
ελλάσ	e l a s
πεισμένησ	p i z m e n i s
αμαλιάδα	a m a ʎ a d a
νυστάζω	n i s t a z o
παριστάνω	p a r i s t a n o
ανθρώπεψα	a n θ ɾ o p e p s a
μαυρισμένων	m a v r i z m e n o n
ανασκάπτομαι	a n a s k a p t o m e
εφάπτομαι	e f a p t o m e
ψαρεύω	p s a ɾ e v o
υπολογισμένο	i p o l o ʝ i z m e n o
γκαστρωμένα	ɡ a s t r o m e n a
μαφιόζοσ	m a f ʝ o z o s
ελκύουμε	e l c i u m e
αναπαρασταίνομαι	a n a p a r a s t e n o m e
αγγελοκρούστηκα	a ŋ ɟ e l o k r u s t i k a
χλιουσ	x ʎ u s
πι	p i
ακρίτασ	a k r i t a s
ακονίστηκα	a k o n i s t i k a
βουτυρωμένουσ	v u t i r o m e n u s
παρακείμενου	p a ɾ a c i m e n u
έρρευσα	e r e f s a
κλεισμένουσ	k l i z m e n u s
στρέφομε	s t ɾ e f o m e
ζεσταμένου	z e s t a m e n u
ματόκλαδα	m a t o k l a ð a
κλεισμένων	k l i z m e n o n
πρωταγωνιστή	p ɾ o t a ɣ o n i s t i
προπόνησησ	p r o p o n i s i s
γαμημένοσ	ɣ a m i m e n o s
παιδοβούβαλοσ	p e ð o v u v a l o s
πάρκαρε	p a ɾ k a ɾ e
καλαμποκόψωμου	k a l a m b o k o p s o m u
βάσανο	v a s a n o
αξέχαστοσ	a k s e x a s t o s
πιονίων	p i o n i o n
τσεκάριζα	t s e k a ɾ i z a
καθομιλουμένησ	k a θ o m i l u m e n i s
τσιμπουκώνω	t s i m b u k o n o
κατέλυσα	k a t e l i s a
κριθαρόψωμο	k r i θ a r o p s o m o
αιματοβαμμένο	e m a t o v a m e n o
μνημών	m n i m o n
παρεξέτρεψα	p a ɾ e k s e t r e p s a
επιλέγω	e p i l e ɣ o
γλιτώνω	ɣ l i t o n o
ιερόδουλη	i e ɾ o ð u l i
μπιχλιμπίδι	b i x l i b i ð i
στενοχωρούμαι	s t e n o x o r u m e
αλλάχ	a l a x
καταιγίδασ	k a t e ʝ i ð a s
αργαλειόσ	a ɾ ɣ a ʎ o s
χαρτζιλίκι	x a ɾ d z i l i c i
τρυγόνα	t r i ɣ o n a
μουσκεμένουσ	m u s c e m e n u s
γρεβενά	ɣ ɾ e v e n a
σκιάχτρο	s c a x t ɾ o
περικλείω	p e r i k l i o
εμπερικλείομε	e m b e r i k l i o m e
μουσκεύομαι	m u s c e v o m e
εκπλέω	e k p l e o
εκμισθωτήσ	e k m i s θ o t i s
πασπάτεψα	p a s p a t e p s a
νεβάδα	n e v a ð a
δημοσιεύουμε	ð i m o s i e v u m e
αναπόφευκτοσ	a n a p o f e f k t o s
μεθαύριο	m e θ a v ɾ i o
ξερογλείφομαι	k s e ɾ o ɣ l i f o m e
καθέλκυσα	k a θ e l c i s a
κανάκεψε	k a n a c e p s e
περικλείουμε	p e r i k l i u m e
προσέκοψα	p ɾ o s e k o p s a
ντετερμινισμούσ	d e t e r m i n i z m i u s
εξετράπην	e k s e t ɾ a p i n
περίοδοσ	p e r i o ð o s
βυζί	v i z i
ψωμιών	p s o m ɲ o n
λύνεισ	l i n i s
αναλογίστηκα	a n a l o ʝ i s t i k a
στυμμένοσ	s t i m e n o s
ακοή	a k o i
πεπεισμένο	p e p i z m e n o
λυνόσασταν	l i n o s a s t a n
ποντάριζε	p o n d a ɾ i z e
αναπότρεπτοσ	a n a p o t ɾ e p t o s
πολυξένη	p o l i k s e n i
βέροια	v e ɾ i a
ναυσ	n a f s
γαλακτομπούρεκο	ɣ a l a k t o b u ɾ ɛ k o
θυελλωδώσ	θ i e l o ð o s
χαστουκίζω	x a s t u c i z o
μπανιέρα	b a ɲ e ɾ a
βασανίστρια	v a s a n i s t ɾ i a
αποκλείσθηκε	a p o k l i s θ i c e
αποδεικνύομε	a p o ð i k n i o m e
αντευχήθηκα	a n d e f ç i θ i k a
καλομοίρα	k a l o m i r a
κομμένα	k o m e n a
περιοδικέ	p e r i o ð i c e
λύνουμε	l i n u m e
πανταχού	p a n d a x u
δυσκοίλιοσ	ð i s c i l i o s
κορνάρω	k o r n a r o
οπλισμένο	o p l i z m e n o
απελπισμένησ	a p e l p i z m e n i s
ιματιοθήκη	i m a t i o θ i c i
καμπέρα	k a b e r a
μαγειρεύομαι	m a ʝ i ɾ e v o
έκχυσα	e k ç i s a
ηφαίστειο	i f ɛ s t i ɔ
όγδοοσ	o ɣ ð o o s
απεδείχθησαν	a p e ð i x θ i s a n
αφορίζω	a f o ɾ i z o
σκορδόψωμο	s k o ɾ ð o p s o m o
λιμένασ	l i m e n a s
ματοβαμμένου	m a t o v a m e n u
αορτή	a ɔ ɾ t i
πλειστηριάζω	p l i s t i r i a z o
κατάλευκοσ	k a t a l e f k o s
παραγράφτηκαν	p a ɾ a ɣ ɾ a f t i k a n
αντέτε	a d e t e
ενεγράφην	e n e ɣ r a f i n
κοπή	k o p i
τσακώνικεσ	t s a k o n i c e s
συνεχίζω	s i n e ç i z o
τέλεια	t e l i a
συνηθισμένη	s i n i θ i z m e n i
αγριεύω	a ɣ ɾ i e v o
κώλυσα	k o l i s a
αγανακτισμένησ	a ɣ a n a k t i z m e n i s
αλλού	a l u
ντροπιάζομαι	d ɾ o p ç a z o m e
συγγνώμη	s i ŋ ɣ n o m i
τούρτεσ	t u ɾ t e s
καλομαθημένοι	k a l o m a θ i m e n i
αιματοβαμμένοι	e m a t o v a m e n i
βέρα	v e ɾ a
μπουγάζι	b u ɣ a z i
καλαμποκόψωμα	k a l a m b o k o p s o m a
ντροπιασμένησ	d ɾ o p ç a z m e n i s
επιγραφτήκαν	e p i ɣ r a f t i k a n
φυτική	f i t i c i
οδούσ	o ð u s
αμυδρόσ	a m i ð ɾ o s
επιγράφηκαν	e p i ɣ r a f i k a n
στιμμένο	s t i m e n o
απασχολημένο	a p a s x o l i m e n o
βερολίνο	v e r o l i n o
εκλέχτηκα	e k l e x t i k a
αγγισμένη	a ŋ ɟ i z m e n i
αντιβουίζω	a n d i v u i z o
τούρτα	t u ɾ t a
αδειάστηκα	a ð ʝ a s t i k a
γλώσσα	ɣ l o s a
ψωμάδικου	p s o m a ð i k u
λύσανε	l i s a n e
αναμμένα	a n a m e n a
στεφάνη	s t e f a n i
πίθοι	p i θ i
ερχομένουσ	e r x o m e n u s
γελάμε	ʝ e l a m e
μαζικότατων	m a z i k o t a t o n
ζάχαρη	z a x a r i
νάουσα	n a u s a
συντριφτήκανε	s i n d r i f t i k a n e
ευχαριστώ	e f x a ɾ i s t o
γεν	ʝ e n
προηγουμένωσ	p r o i ɣ u m e n o s
γαργαλίζω	ɣ a ɾ ɣ a l i z o
γουστάριζε	ɣ u s t a ɾ i z e
ορθόδοξα	o ɾ θ o ð o k s a
μολογάω	m o l o ɣ a o
ημερεύτε	i m e ɾ e f t e
ἐξετελέσθην	e k s e t e l e s θ i n
αναγράφηκα	a n a ɣ r a f i k a
αποκρύβω	a p o k ɾ i v o
εφοδιάστηκα	e f o ð i a s t i k a
τσακωνιά	t s a k o ɲ a
αγαπημένοσ	a ɣ a p i m e n o s
καλομοίρικα	k a l o m i r i k a
άκουγα	a k u ɣ a
μπαστούνι	b a s t u n i
ελιόψωμου	e ʎ o p s o m u
χριστούγεννα	x ɾ i s t u ʝ e n a
οκτακόσια	o k t a k o s ç a
άρκτε	a ɾ k t e
κλείνομε	k l i n o m e
παραγραφήκαν	p a ɾ a ɣ ɾ a f i k a n
κλανιά	k l a ɲ a
κωμειδύλλιο	k o m i ð i l i o
χειμωνιάτικα	ç i m o ɲ a t i k a
τέρπομαι	t e ɾ p o m e
διανύομε	ð i a n i o m e
κουρασμένοσ	k u r a z m e n o s
δικαίωμα	ð i c e o m a
αγγίζουμε	a ŋ ɟ i z u m e
γεννάω	ʝ e n a o
τεχνολογίασ	t e x n o l o ʝ i a s
προαλείφω	p ɾ o a l i f o
κραγμένο	k r a ɣ m e n o
συνηθισμένοσ	s i n i θ i z m e n o s
βούδασ	v u ð a s
φωνάζω	f o n a z o
νάζαρα	n a z a r a
ανενταφίαστοσ	a n e n d a f i a s t o s
παρφουμάρω	p a ɾ f u m a ɾ o
περιθάλπομε	p e ɾ i θ a l p o m e
στειμμένα	s t i m e n a
συνήθωσ	s i n i θ o s
πόδι	p o ð i
ειλημμένου	i l i m e n u
μορφέασ	m ɔ r f ɛ a s
αγγισμένοσ	a ŋ ɟ i z m e n o s
περήφανοσ	p e r i f a n o s
αναμαλλιασμένοι	a n a m a ʎ a z m e n i
κόκκινησ	k o c i n i s
μαρκάρισε	m a ɾ k a ɾ i s e
συγκόπηκα	s i ŋ ɡ o p i k a
κεκλεισμένοι	c e k l i z m e n i
συριζαίοσ	s i ɾ i z e o s
θήβα	θ i v a
δόγμα	ð o ɣ m a
μυγιάζομαι	m i ʝ a z o m e
ντροπιασμένοσ	d ɾ o p ç a z m e n o s
γέροσ	ʝ e ɾ o s
ακτινοσκόπηση	a k t i n o s k o p i s i
ενσταλάζω	e n s t a l a z o
κουφάρι	k u f a ɾ i
θαλαμηγέ	θ a l a m i ʝ e
παντρεμένοι	p a n d ɾ e m e n i
παρακάμψεισ	p a ɾ a k a m p s i s
ένρινο	e n r i n o
σταμάτηδεσ	s t a m a t i ð e s
λύνεστε	l i n e s t e
αγαντάριζα	a ɣ a n d a r i z a
έλαμψα	e l a m p s a
απελπισμένουσ	a p e l p i z m e n u s
κουραστικόσ	k u r a s t i k o s
κωλοπαιδαράσ	k o l o p e ð a ɾ a s
αλαφιασμένησ	a l a f ç a z m e n i s
καμουφλάρισα	k a m u f l a ɾ i s a
αποκαλύπτομε	a p o k a l i p t o m e
στρέφομαι	s t ɾ e f o m e
απεραντολογία	a p e ɾ a n d o l o ʝ i a
ημερέψτε	i m e ɾ e p s t e
κολοράντο	k o l o ɾ a d o
αγαντάρω	a ɣ a n d a ɾ o
χορτοφαγία	x o ɾ t o f a ʝ i a
τσίσια	t s i s ç a
εμπερικλείστηκα	e m b e r i k l i s t i k a
κλασμένοσ	k l a z m e n o s
γκομενίτσα	ɡ o m e n i t s a
ακταιωρό	a k t e o r o
διανύω	ð i a n i o
αρούμπα	a ɾ u b a
είμαστε	i m a s t e
άραγε	a ɾ a ʝ e
έβδομοσ	e v ð o m o s
νόστιμοσ	n o s t i m o s
ισόγειο	i s o ʝ i o
αναβαλλόμενουσ	a n a v a l o m e n u s
έστεψα	e s t e p s a
μήτσοσ	m i t s o s
γαμάτοσ	ɣ a m a t o s
ζεσταμένοσ	z e s t a m e n o s
αναμαλλιασμένα	a n a m a ʎ a z m e n a
ανασκαφτείσ	a n a s k a f t i s
ντουμπλάρω	d u b l a ɾ o
περίπλοι	p e r i p l i
στέφομε	s t e f o m e
καληνύχτα	k a l i n i x t a
μπελάσ	b e l a s
μπαστουνιά	b a s t u ɲ a
εισρέω	i z r e o
συγκινημένε	s i ŋ ɟ i n i m e n e
καλοφάγωτοι	k a l o f a ɣ o t i
νοῶ	n o o
επανιδρύομαι	e p a n i ð r i o m e
ρέω	r e o
χορεύουνε	x o ɾ e v u n e
ποπόσ	p o p o s
βιολί	v ʝ o l i
λασίθι	l a s i θ i
αϊ	a i
φλιτζανάκια	f l i d z a n a c a
μούναροσ	m u n a ɾ o s
συντρίβω	s i n d r i v o
αποστέλλω	a p o s t e l o
φανταστική	f a n d a s t i ç i
ανάδειξα	a n a ð i k s a
αρχειοθήκη	a r ç i o θ i c i
συγκινητικόσ	s i ŋ ɟ i n i t i k o s
γαργηττόσ	ɣ a r ʝ i t o s
τεχνολόγοσ	t e x n o l o ɣ o s
γόνυ	ɣ o n i
πρωτοχρονιά	p ɾ o t o x ɾ o ɲ a
παιδότοποσ	p e ð o t o p o s
κίμωλοσ	c i m o l o s
ροβέρτοσ	ɾ o v e ɾ t o s
μπονατσάρει	b o n a t s a ɾ i
πολωνικέ	p o l o n i c e
ανεβαίνω	a n e v e n o
σοφότερου	s o f o t e ɾ u
μιλάνο	m i l a n o
αλαλάζω	a l a l a z o
αισχροκερδήσ	e s x r o c e r ð i s
πινακοθήκη	p i n a k o θ i c i
ντροπιασμένων	d ɾ o p ç a z m e n o n
αναμαλλιασμένων	a n a m a ʎ a z m e n o n
πακετάρισα	p a c e t a ɾ i s a
διήνυσα	ð i i n i s a
κρεμασμένοι	k r e m a z m e n i
μοιράζω	m i ɾ a z o
διανύομαι	ð i a n i o m e
ειλημμένοσ	i l i m e n o s
αγαπημένων	a ɣ a p i m e n o n
αγορά	a ɣ o r a
μινόρε	m i n o ɾ e
γαλλία	ɣ a l i a
αγγιγμένοι	a ŋ ɟ i ɣ m e n i
εννιακόσια	e ɲ a k o s ç a
αλυσοδεμένου	a l i s o ð e m e n u
ευσεβήσ	e f s e v i s
αηδιαστικοί	a i ð ʝ a s t i c i
στρατόσ	s t ɾ a t o s
γλυκίσματοσ	ɣ l i c i z m a t o s
ήντα	i n d a
φυτικών	f i t i k o n
ενημερώσεων	e n i m e r o s e o n
παρκάριζε	p a ɾ k a ɾ i z e
χοντροκώλησ	x o n d ɾ o k o l i s
ωσότου	o s o t u
κιμώλου	c i m o l u
ελληνικό	e l i n i k o
κίτρε	c i t ɾ e
αβγοκομμένα	a v ɣ o k o m e n a
σπιτικοί	s p i t i c i
ζεσταμένησ	z e s t a m e n i s
αποκρύψεισ	a p o k ɾ i p s i s
αληθώσ	a l i θ o s
κορίτσια	k o ɾ i t s ç a
γαμοσταυρίζω	ɣ a m o s t a v ɾ i z o
ανακαλύπτομε	a n a k a l i p t o m e
ρώγα	r o ɣ a
χαστούκισμα	x a s t u c i z m a
σοφιών	s o f i o n
φωτογραφία	f o t o ɣ r a f i a
εγκλείσθηκα	e ŋ ɡ l i s θ i k a
απασχόλησα	a p a s x o l i s a
τσεκάρισα	t s e k a ɾ i s a
αντικλεπτικών	a n d i k l e p t i k o n
χαλίφησ	x a l i f i s
αγγιγμένου	a ŋ ɟ i ɣ m e n u
μαλωμένοι	m a l o m e n i
εκτρέπομε	e k t ɾ e p o m e
ντετερμινισμέ	d e t e r m i n i z m e
χέζω	ç e z o
λιπών	l i p o n
σπίθιζε	s p i θ i z e
αρμόδιοσ	a ɾ m o ð i o s
παραγγέλλω	p a r a ŋ ɟ e l o
αναγνώστρια	a n a ɣ n o s t ɾ i a
παρακειμένων	p a r a c i m e n o n
γκομενάκι	ɡ o m e n a c i
πατινάρω	p a t i n a ɾ o
συγκρουόμενοι	s i ŋ ɡ r u o m e n i
φιλιού	f i ʎ u
αναιτιολόγητοσ	a n e t i o l o ʝ i t o s
στριμμένοι	s t ɾ i m e n i
βυθισμένων	v i θ i z m e n o n
κωσταντίνοσ	k o s t a n d i n o s
μπομπότα	b o b o t a
κομμένησ	k o m e n i s
κόρινθοσ	k o ɾ i n θ o s
εστιατόριο	e s t i a t o ɾ i o
τυροπιτάκι	t i ɾ o p i t a k i
αερολιμένασ	a e r o l i m e n a s
δαίμονασ	ð ɛ m ɔ n a s
αιματοκυλίστηκα	e m a t o c i l i s t i k a
φλωρίνησ	f l o r i n i s
βουλιάξτε	v u ʎ a k s t e
αιματοβαμμένη	e m a t o v a m e n i
ταιριάζετε	t e r ʝ a z e t e
μεσαιωνικά	m e s e o n i k a
παγωτατζήσ	p a ɣ o t a d z i s
ματοβαμμένα	m a t o v a m e n a
αμπαλάρισα	a m b a l a ɾ i s a
πίθων	p i θ o n
αναγεννώ	a n a ʝ e n o
αναδημιουργημένων	a n a ð i m i u r ʝ i m e n o n
χαϊδεύω	x a i̯ ð e v o
σεφαρδίτησ	s e f a ɾ ð i t i s
κακό	k a k o
βγάζοντασ	v ɣ a z o n d a s
αστυνομοκρατία	a s t i n o m o k ɾ a t i a
εξανάγκασα	e k s a n a ŋ ɡ a s a
μπερδεύω	b e ɾ ð e v o
ένατοσ	e n a t o s
κυράτσα	c i ɾ a t s a
λύση	l i s i
μετάπτωση	m e t a p t o s i
συντρίφθηκα	s i n d r i f θ i k a
ταχύτητα	t a ç i t i t a
βίζιτα	v i z i t a
στειμμένοσ	s t i m e n o s
διανύουμε	ð i a n i u m e
αναγκάζω	a n a ŋ ɡ a z o
αναβαλλόμενων	a n a v a l o m e n o n
επιχείρηση	e p i ç i ɾ i s i
γεια	ʝ a
κύπρου	c i p ɾ u
αντίγραφο	a n d i ɣ ɾ a f o
κλέφτικα	k l e f t i k a
εφοδίασα	e f o ð i a s a
ολόφωτη	o l o f o t i
παρελθόντων	p a r e l θ o n d o n
χορέψτε	x o ɾ e p s t e
εκκρούουμε	e k r u u m e
ηγούμενε	i ɣ u m e n e
στείροσ	s t i ɾ o s
σέρβιρε	s e ɾ v i ɾ e
εκκολάψεισ	e k o l a p s i s
περιστρέφομε	p e ɾ i s t ɾ e f o m e
ενέχυσα	e n e ç i s a
φαντάστηκα	f a n d a s t i k a
ματοβαμμένο	m a t o v a m e n o
αφεντικό	a f e n d i k o
κοροϊδέψτε	k o ɾ o i̯ ð e p s t e
φιλοσοφώ	f i l o s o f o
χειλιού	ç i ʎ u
πισωγλέντησ	p i s o ɣ l e n d i s
αρχήθεν	a r ç i θ e n
αβγατισμένων	a v ɣ a t i z m e n o n
βασανίζω	v a s a n i z o
αγανακτισμένων	a ɣ a n a k t i z m e n o n
συγκινημένου	s i ŋ ɟ i n i m e n u
περιόδουσ	p e r i o ð u s
μπισκότο	b i s k o t o
ταλέντο	t a l e n d o
καθισμένα	k a θ i z m e n a
εξαπολύουμε	e k s a p o l i u m e
αναπάλθηκα	a n a p a l θ i k a
δολιοφθορά	ð o ʎ o f o ɾ a
μουσκεμένα	m u s c e m e n a
στενοχωρημένοσ	s t e n o x o r i m e n o s
μισθωτήσ	m i s θ o t i s
ξεσκατώνω	k s e s k a t o n o
εμβατήριο	e ɱ v a t i ɾ i o
ενστάλαξα	e n s t a l a k s a
λούφα	l u f a
αλιεύτηκα	a l i e f t i k a
ενόχληση	e n o x l i s i
έλξατε	e l k s a t e
εξάρθηκα	e k s a r θ i k a
σωρό	s o ɾ o
απ	a p
ακουστόσ	a k u s t o s
ηλικιωμένουσ	i l i c i o m e n u s
αβγατίζω	a v ɣ a t i z o
μαζικότερων	m a z i k o t e r o n
γουστάρισα	ɣ u s t a ɾ i s a
αναγέννησα	a n a ʝ e n i s a
λαογραφία	l a o ɣ ɾ a f i a
χάφτηκα	x a f t i k a
δυτικόσ	ð i t i k o s
πάγκρεασ	p a ŋ ɡ ɾ e a s
αναμμένη	a n a m e n i
στέλιοσ	s t e ʎ o s
χείλη	ç i l i
φθινοπωριάτικα	f θ i n o p o ɾ ʝ a t i k a
υπέκρυψα	i p e k ɾ i p s a
άγγισα	a ŋ ɟ i s a
μαλακισμένη	m a l a c i z m e n i
ετεροφυλόφιλοσ	e t e ɾ o f i l o f i l o s
τσεκάρομαι	t s e k a ɾ o m e
ξαποσταίνω	k s a p o s t e n o
άκακοσ	a k a k o s
προσεύχομαι	p r o s e f x o m e
κωσταντίνε	k o s t a n d i n e
κόκκινοι	k o c i n i
ενεγράφη	e n e ɣ r a f i
δημοψήφισμα	ð i m o p s i f i z m a
γαϊδούρα	ɣ a i ð u ɾ a
σβηστήρασ	z v i s t i ɾ a s
παρφουμάρομαι	p a ɾ f u m a ɾ o m e
λευκά	l e f k a
έσκισα	e s c i s a
προτρέπουμε	p ɾ o t ɾ e p u m e
προμηθεύομαι	p ɾ ɔ m i θ e v o m e
ηλικιωμένοσ	i l i c i o m e n o s
μυρωμένο	m i r o m e n o
αραχνάκι	a ɾ a x n a c i
εκχύθηκα	e k ç i θ i k a
προβλέπω	p ɾ o v l e p o
απειθώ	a p i θ o
ωραίοσ	ɔ ɾ ɛ ɔ s
βαρελότο	v a ɾ e l o t o
φουμάρω	f u m a r o
χείλι	ç i l i
καλοκαίρι	k a l o c e r i
μαμμόθρεφτοσ	m a m o θ ɾ e f t o s
αποπέμπω	a p o p e m b o
χαλασμένοσ	x a l a z m e n o s
ανορθόδοξοσ	a n o ɾ θ o ð o k s o s
συγγράφομε	s i ŋ ɣ r a f o m e
στεναχωράω	s t e n a x o r a o
λατρεύω	l a t ɾ e v o
αφουγκράζομαι	a f u ɡ ɾ a z o m e
πιθαριών	p i θ a r ʝ o n
ακριτικόσ	a k r i t i k o s
επικάλυψα	e p i k a l i p s a
απολογητική	a p o l o ʝ i t i c i
κριθαρόψωμων	k r i θ a r o p s o m o n
γινάτι	ʝ i n a t i
αγγισμένο	a ŋ ɟ i z m e n o
μισθοφόροσ	m i s θ o f o ɾ o s
ψοφώ	p s o f o
εσωκλείστηκα	e s o k l i s t i k a
προσφύομαι	p r o s f i o m e
τετριμμένε	t e t r i m e n e
κωλύομε	k o l i o m e
ποδαριών	p o ð a ɾ ʝ o n
απαλείφτηκα	a p a l i f t i k a
αφορούσε	a f o r u s e
αθροίζομαι	a θ ɾ i z o m e
παιδί	p e ð i
βράζω	v r a z o
παρελθόντοσ	p a r e l θ o n d o s
λαιστρυγόνεσ	l e s t r i ɣ o n e s
καθιδρύω	k a θ i ð r i o
αποκρούω	a p o k r u o
κάτασπροσ	k a t a s p ɾ o s
έκρουσα	e k r u s a
κωλάρα	k o l a ɾ a
απολύουμε	a p o l i u m e
γαμώτη	ɣ a m o t i
εσώρουχο	e s o ɾ u x o
βασιλεία	v a s i l i a
προσγράφτηκα	p ɾ o z ɣ r a f t i k a
απέρριψα	a p e ɾ i p s a
αγαπημένη	a ɣ a p i m e n i
περικόβω	p e ɾ i k o v o
παζαρεύομαι	p a z a ɾ e v o m e
αναμμένων	a n a m e n o n
μουνότρυπα	m u n o t ɾ i p a
αναπαριστάνω	a n a p a r i s t a n o
μαγικόσ	m a ʝ i k o s
συνήλθα	s i n i l θ a
καταξοδεύω	k a t a k s o ð e v o
αιτιοκρατίεσ	e t i o k r a t i e s
ζευγών	z e v ɣ o n
σπέτσεσ	s p e t s e s
αποκλεισμένουσ	a p o k l i z m e n u s
αρμόδιοι	a ɾ m o ð i i
επιτρέπομε	e p i t ɾ e p o m e
ανασκάπτομε	a n a s k a p t o m e
έρρινη	e r i n i
πιστεύουμε	p i s t e v u m e
στυμμένη	s t i m e n i
αηδία	a i ð i a
ἀνεγράφην	a n e ɣ r a f i n
συμπεριφορά	s i m b e ɾ i f o ɾ a
ξόδιασα	k s o ð ʝ a s a
ντροπιαστικά	d ɾ o p ç a s t i k a
αναβαθμολογούμαι	a n a v a θ m o l o ɣ u m e
κινδύνευσα	c i n ð i n e f s a
αρετών	a r e t o n
επανειλημμένησ	e p a n i l i m e n i s
μετάπτωσησ	m e t a p t o s i s
λιγότεροι	l i ɣ o t e r i
χριστουγεννιάτικα	x r i s t u ʝ e ɲ a t i k a
συνοδού	s i n o ð u
ποικιλότερου	p i c i l o t e r u
εγγράφομαι	e ŋ ɣ r a f o m e
επανειλημμένεσ	e p a n i l i m e n e s
πλίνθοι	p l i n θ i
παράξενοσ	p a ɾ a k s e n o s
αντιγράφομαι	a n d i ɣ r a f o m e
αγαντάρισε	a ɣ a n d a r i s e
ενστερνίζομαι	e n s t e r n i z o m e
άσεβα	a s e v a
καν	k a n
μωρέ	m o ɾ e
καφεμαντεία	k a f e m a n d i a
συγχαρήκανε	s i ŋ x a ɾ i k a n e
τούβλο	t u v l o
ομόλογοι	o m o l o ʝ i
ιταλικό	i t a l i k o
αγυιόπαιδοσ	a ʝ i o p e ð o s
καταναγκάζουμε	k a t a n a ŋ ɡ a z u m e
λύσατε	l i s a t e
βουβάλι	v u v a l i
σαλαμίνα	s a l a m i n a
αιματοβαμμένοσ	e m a t o v a m e n o s
τετριμμένουσ	t e t r i m e n u s
απαρχαιωμένων	a p a r ç e o m e n o n
υδρογόνο	i ð r o ɣ o n o
τσιμπούκι	t s i m b u c i
εξαναγκάσθηκα	e k s a n a ŋ ɡ a s θ i k a
βασίλεψε	v a s i l e p s e
πίτεσ	p i t e s
φανταστικοί	f a n d a s t i ç i
τάφρο	t a f r o
εξωμήτριοσ	e k s o m i t ɾ i o s
φουμάρισα	f u m a ɾ i s a
ματοβαμμένε	m a t o v a m e n e
πλούσιοσ	p l u s i o s
διαμηνύθηκα	ð i a m i n i θ i k a
λύσεισ	l i s i s
σπρώχνω	s p ɾ o x n o
απασχολήσεισ	a p a s x o l i s i s
λάκωνοσ	l a k o n o s
χρονολογούμε	x r o n o l o ɣ u m e
δυναμιτίζω	ð i n a m i t i z o
χιλιάδα	ç i ʎ a ð a
φοροέκλεψα	f o ɾ o e k l e p s a
βυζάκι	v i z a c i
αυτό	a f t o
γένι	ʝ e ɲ i
λουφαδόροσ	l u f a ð o ɾ o s
αδελφομάνα	a ð e l f o m a n a
πομφολύγων	p o ɱ f o l i ɣ o n
πρόκειται	p ɾ o c i t e
γαμώντασ	ɣ a m o n d a s
τελευταία	t e l e f t e a
ανατραπήκαν	a n a t ɾ a p i k a n
επισείω	e p i s i o
αυνανίζομαι	a v n a n i z o m e
προφητεύθηκα	p ɾ ɔ f i t e f θ i k a
προάλειψα	p ɾ o a l i p s a
νοστίμεψε	n o s t i m e p s e
ασπρίζω	a s p ɾ i z o
μισαλλοδοξία	m i s a l o ð o k s i a
αγκάλιασα	a ŋ ɡ a ʎ a s a
προτρέπω	p ɾ o t ɾ e p o
αρρωστημένα	a r o s t i m e n a
ακροάστηκα	a k r o a s t i k a
αμπαλάρω	a m b a l a ɾ o
αιματοκυλίζω	e m a t o c i l i z o
ημέρεψα	i m e ɾ e p s a
ψήφουσ	p s i f u s
βουτυρωμένοσ	v u t i r o m e n o s
κρούσθηκα	k r u s θ i k a
κωνσταντινούπολη	k o n s t a n d i n u p o l i
εξέγερση	e k s e ʝ e r s i
ποτέ	p o t e
χρονολογήθηκα	x r o n o l o ʝ i θ i k a
ρόδι	ɾ o ð i
ανέπλευσα	a n e p l e f s a
ανεπηρέαστοσ	a n e p i ɾ e a s t o s
πλέθρο	p l e θ r o
αβγό	a v ɣ o
μαδρίτη	m a ð ɾ i t i
πειθόμενα	p i θ o m e n a
χαϊδεύτηκα	x a i̯ ð e f t i k a
αυγό	a v ɣ o
υιοθέτησα	i o θ e t i s a
φάροσ	f a r o s
πρήξιμο	p ɾ i k s i m o
ραγιάσ	ɾ a ʝ a s
εξαναγκάζομαι	e k s a n a ŋ ɡ a z o m e
παντρεμένοσ	p a n d ɾ e m e n o s
αναλυτόσ	a n a l i t o s
στεφάνι	s t e f a n i
απέπεμψα	a p e p e m p s a
αναγεννήσεισ	a n a ʝ e n i s i s
πεπεισμένα	p e p i z m e n a
χειμερινόσ	ç i m e r i n o s
επείγον	e p i ɣ o n
παρακωλύθηκα	p a r a k o l i θ i k a
ξεμπερδεύτηκα	k s e b e ɾ ð e f t i k a
στέφουμε	s t e f u m e
μαυρισμένοσ	m a v r i z m e n o s
κοινόλεκτο	c i n o l e k t o
φλίπερ	f l i p e ɾ
δαιμονισμόσ	ð e m o n i z m o s
ταράζομαι	t a r a z o m e
εξαπολύομε	e k s a p o l i o m e
πεθαμένου	p e θ a m e n u
προηγουμένουσ	p r o i ɣ u m e n u s
θλιμμένων	θ l i m e n o n
προηγούμενησ	p r o i ɣ u m e n i s
ξερόψωμων	k s e r o p s o m o n
σορών	s o ɾ o n
ένρινουσ	e n r i n u s
υποσπαδίασ	i p o s p a ð i a s
πωσ	p o s
συμπρωταγωνιστών	s i m b ɾ o t a ɣ o n i s t o n
κρυμμένα	k r i m e n a
λέσβε	l e z v e
συμφυρμού	s i ɱ f i r m u
γυρεύτηκα	ʝ i ɾ e f t i k a
τυχερόσ	t i ç e r o s
γκαστρωμένων	ɡ a s t r o m e n o n
γαμώτο	ɣ a m o t o
χρονολόγησησ	x r o n o l o ʝ i s i s
καραπουτάνα	k a r a p u t a n a
είσαι	i s e
γρηγόρησ	ɣ ɾ i ɣ o ɾ i s
κορίτσι	k ɔ ɾ i t s i
ευαγγελίστηκα	e v a ŋ ɟ e l i s t i k a
μαλακισμένεσ	m a l a c i z m e n e s
είχα	i x a
ντε	d e
άγραφοσ	a ɣ r a f o s
καταστρέφομαι	k a t a s t ɾ e f o m e
λιόψωμο	ʎ o p s o m o
αναθεματισμένουσ	a n a θ e m a t i z m e n u s
οφιοειδών	o f i o i ð o n
ντελιβερά	d e l i v e r a
συγκρουόμενε	s i ŋ ɡ r u o m e n e
επαλείφθηκα	e p a l i f θ i k a
βυθισμένο	v i θ i z m e n o
μύλο	m i l o
τσίτσασ	t s i t s a s
διανομή	ð ʝ a n o m i
ερρινοποίησησ	e r i n o p i i s i s
ακίνδυνοσ	a c i n ð i n o s
ευρώπη	e v r o p i
γήτεψα	ʝ i t e p s a
αμφιλεγόμενοι	a ɱ f i l e ɣ o m e n i
ψηφίστηκα	p s i f i s t i k a
γουρούνι	ɣ u ɾ u n i
ερχόμενο	e r x o m e n o
καταστρέφω	k a t a s t ɾ e f o
εγγραφή	e ŋ ɣ r a f i
γαϊδουριά	ɣ a i ð u ɾ j a
μάζα	m a z a
λέγω	l e ɣ o
δημητρούλα	ð i m i t ɾ u l a
βλαμμένα	v l a m e n a
γκιλοτίνα	ɟ i l o t i n a
καθοίκι	k a θ i c i
ουστ	u s t
νιάου	ɲ a u
μάζευε	m a z e v e
διεμήνυσα	ð i e m i n i s a
υπολείφθηκα	i p o l i f θ i k a
αγένεια	a ʝ e n i a
άσεβου	a s e v u
πειθόμενο	p i θ o m e n o
εκλεράκι	e k l e ɾ a c i
βυθισμένε	v i θ i z m e n e
κοριτσάρα	k o r i t s a r a
δεκαεννέα	ð e k a e n e a
άβλαφτοσ	a v l a f t o s
εὔχεται	e f ç e t e
νεκροκεφαλή	n e k ɾ o c e f a l i
στιβάδα	s t i v a ð a
λιμένα	l i m e n a
ανασάλεψε	a n a s a l e p s e
γνώση	ɣ n ɔ s i
πρωταθλήτρια	p ɾ o t a θ l i t ɾ i a
στριμμένου	s t ɾ i m e n u
ξοδεύτηκα	k s o ð e f t i k a
περιγράφω	p e ɾ i ɣ r a f o
σκορδόψωμων	s k o ɾ ð o p s o m o n
έλυσε	e l i s e
πουλερικό	p u l e r i k o
λυνόσαστε	l i n o s a s t e
ποιοσ	p ç o s
μαθημένων	m a θ i m e n o n
ψυχιατρικοί	p s i ç a t r i c i
εξοπλισμένα	e k s o p l i z m e n a
αναδημιουργημένοι	a n a ð i m i u r ʝ i m e n i
ποικιλότατο	p i c i l o t a t o
λήμνοσ	l i m n o s
τεχνολόγων	t e x n o l o ɣ o n
λυμένου	l i m e n u
εορτάζω	e o ɾ t a z o
εισπνέουμε	i s p n e u m e
βίβλοσ	v i v l o s
παράβυστοσ	p a r a v i s t o s
ρόγα	r o ɣ a
αλατίστηκα	a l a t i s t i k a
ζεσταμένεσ	z e s t a m e n e s
συνελέγην	s i n e l e ʝ i n
εβδομάδα	e v ð o m a ð a
συγγραφέασ	s i ŋ ɣ r a f e a s
τρομαγμένη	t ɾ o m a ɣ m e n i
αβγατισμένου	a v ɣ a t i z m e n u
νεποτισμόσ	n e p o t i z m o s
χρονολόγησα	x r o n o l o ʝ i s a
τσέκαρα	t s e k a ɾ a
ποδάρι	p o ð a ɾ i
φουμάριζα	f u m a ɾ i z a
εισέπνευσα	i s e p n e f s a
ανατράπηκε	a n a t ɾ a p i c e
τσούκτρα	t͡s u k t r a
περικλείστηκα	p e r i k l i s t i k a
χέσιμο	ç e s i m o
ανακατώνω	a n a k a t o n o
κυνηγημένοι	c i n i ʝ i m e n i
συνθετικά	s i n θ e t i k a
δύο	ð i o
αλυσοδεμένα	a l i s o ð e m e n a
ελληναράσ	e l i n a ɾ a s
κιλκίσ	c i l c i s
ανασαλεύω	a n a s a l e v o
ενοικιαστήσ	e n i c i a s t i s
ναύπλιο	n a f p l i o
κραγμένου	k r a ɣ m e n u
πλησιάζουμε	p l i s i a z u m e
γάιδαροσ	ɣ a i ð a ɾ o s
ανέκαμψα	a n e k a m p s a
αιματοβαμμένουσ	e m a t o v a m e n u s
χοντρομαλάκασ	x o n d ɾ o m a l a k a s
λύνανε	l i n a n e
βάζοντασ	v a z o n d a s
εξακόσια	e k s a k o s ç a
παρεισφρέω	p a r i s f r e o
αυτί	a f t i
πλέκω	p l e k o
ακουμπιστήρι	a k u m b i s t i ɾ i
κοινόλεκτοι	c i n o l e k t i
ντουμπλάρισε	d u b l a ɾ i s e
άθροισα	a θ ɾ i s a
ροδάκινων	r o ð a c i n o n
συνέθλιψα	s i n e θ l i p s a
αιματοβαμμένε	e m a t o v a m e n e
θαύμασα	θ a v m a s a
γλωσσάκι	ɣ l o s a c i
αναμμένου	a n a m e n u
δρόμοσ	ð r o m o s
είμεθα	i m e θ a
ακροατήσ	a k ɾ o a t i s
πλείστοσ	p l i s t o s
φωτογραφικέ	f o t o ɣ r a f i c e
υποσκάφθηκα	i p o s k a f θ i k a
χαρτομαντεία	x a ɾ t o m a n d i a
στων	s t o n
αιθέρασ	ɛ θ ɛ ɾ a s
σκόνταψα	s k o n d a p s a
τσεκάρισε	t s e k a ɾ i s e
ουλή	u l i
εμπνευσμένεσ	e m b n e v z m e n e s
τρυγόνασ	t r i ɣ o n a s
γαμιέμαι	ɣ a m ɲ e m e
μπαρμπούλησ	b a ɾ b u l i s
μεγαλειότατοσ	m e ɣ a l i o t a t o s
σφιχταγκαλιάστηκα	s f i x t a ŋ ɡ a ʎ a s t i k a
κερατάσ	c e ɾ a t a s
έλυσαν	e l i s a n
κτήματα	k t i m a t a
τσακώνικη	t s a k o n i c i
έλκοσ	e l k o s
δίωξα	ð i o k s a
συγκινητικοί	s i ŋ ɟ i n i t i c i
μερεύω	m e ɾ e v o
σημειώνομαι	s i m i o n o m e
κωνσταντῖνοσ	k o n s t a n d i n o s
γκαστρωμένοι	ɡ a s t ɾ o m e n i
εγγράφω	e ŋ ɣ ɾ a f o
κλέφτηκα	k l e f t i k a
υπέσκαψα	i p e s k a p s a
κοροϊδεύω	k o ɾ o i̯ ð e v o
αμφιλεγόμενουσ	a ɱ f i l e ɣ o m e n u s
απλούσ	a p l u s
σημειωτόν	s i m i o t o n
τετριμμέναι	t e t r i m e n e
ψηφοδόχοσ	p s i f o ð i o x o s
κοιτάζω	c i t a z o
τσογλάνι	t s o ɣ l a n i
φωτόλυση	f ɔ t ɔ l i s i
παρών	p a ɾ o n
μέιν	m e i n
ειρωνικόσ	i r o n i k o s
λύσσα	l i s a
στεναχωρημένου	s t e n a x o r i m e n u
ζευγαριού	z e v ɣ a r ʝ u
αγκαζάρισα	a ŋ ɡ a z a ɾ i s a
πειρατήσ	p i r a t i s
καραβάνι	k a ɾ a v a n i
παρακείμενε	p a r a c i m e n e
στεναχωρημένε	s t e n a x o r i m e n e
χρηματοκιβώτιο	x ɾ i m a t o k i v o t i o
πεθαμένοι	p e θ a m e n i
ανεπαρκήσ	a n e p a ɾ c i s
κεκλεισμένοσ	c e k l i z m e n o s
παρακάμφθηκα	p a ɾ a k a m f θ i k a
γραφειοκρατία	ɣ ɾ a f i o k ɾ a t i a
αποστάσεισ	a p o s t a s i s
ιταλικόσ	i t a l i k o s
κραγμένουσ	k r a ɣ m e n u s
καρεκλίτσα	k a ɾ e k l i t s a
σάλεψε	s a l e p s e
ταχυδακτυλουργία	t a ç i ð a k t i l u ɾ ʝ i a
ταράζω	t a r a z o
ταχυδρομικόσ	t a ç i ð ɾ o m i k o s
τριμμένα	t r i m e n a
ανακαλύπτομαι	a n a k a l i p t o m e
μαυρισμένα	m a v r i z m e n a
αγιάγκαθο	a ʝ a ŋ ɡ a θ o
αναπάλλομαι	a n a p a l o m e
καλοφάγωτα	k a l o f a ɣ o t a
αποκλεισμένα	a p o k l i z m e n a
γαμάτοι	ɣ a m a t i
νεπάλ	n ɛ p aː l
ανανάδων	a n a n a ð o n
αγγουριού	a ŋ ɡ u ɾ ʝ u
προσέκρουσα	p r o s e k r u s a
προσελκύσθηκα	p r o s e l c i s θ i k a
κυνηγημένα	c i n i ʝ i m e n a
αβανγκαρντισμού	a v a ŋ ɡ a ɾ d i z m u
σωκράτησ	s o k ɾ a t i s
παγωμένεσ	p a ɣ o m e n e s
ἔστρεψα	e s t ɾ e p s a
μπογάζια	b o ɣ a z ʝ a
παρεκτραπήκαν	p a ɾ e k t ɾ a p i k a n
αδρανήσ	a ð ɾ a n i s
κάθαρμα	k a θ a ɾ m a
αποκεφαλίζω	a p o c e f a l i z o
ιωάννα	i o a n a
γενιά	ʝ e ɲ a
ντροπαλή	d ɾ o p a l i
συγχάρηκα	s i ŋ x a r i k a
μαυροπούλι	m a v r o p u l i
λέμε	l e m e
κρύπτω	k ɾ i p t o
βραδέωσ	v ɾ a ð e o s
γαμήσι	ɣ a m i s i
κακογαμημένοι	k a k o ɣ a m i m e n i
αναστρέφομαι	a n a s t ɾ e f o m e
αμάθειασ	a m a θ i a s
κοτίτσα	k o t i t s a
αναβοσβήνω	a n a v o z v i n o
χαρχάλεμα	x a ɾ x a l e m a
γκαστρώνω	ɡ a s t ɾ o n o
απασχολημένοι	a p a s x o l i m e n i
έχουμε	e x u m e
μπιντέσ	b i d ɛ s
εξέλεξα	e k s e l e k s a
φανταχτερόσ	f a n d a x t e r o s
γιαννάκησ	ʝ a n a c i s
ναυσικάσ	n a f s i k a s
καντάδα	k a n d a ð a
παρασταίνω	p a r a s t e n o
ανάγκεσ	a n a ŋ ɟ e s
γιουχαΐζω	ʝ u x a i z o
φωτογραφεία	f o t o ɣ r a f i a
στενοχωρημένησ	s t e n o x o r i m e n i s
λιτόσ	l i t o s
αηδιασμένη	a i ð i a z m e n i
πενηντάρικο	p e n i n d a ɾ i k o
σφύζω	s f i z o
ανέκυψα	a n e c i p s a
πλειστάκισ	p l i s t a c i s
εκδρομή	e k ð ɾ o m i
υπέκλεψα	i p e k l e p s a
σίγμα	s i ɣ m a
σκουλήκι	s k u l i c i
αμφιβολία	a m f i v o l i a
επανέκαμψα	e p a n e k a m p s a
σερβίρομαι	s e ɾ v i ɾ o m e
ντροπιαστικόσ	d ɾ o p ç a s t i k o s
κέρδοσ	c e r ð o s
θλιμμένου	θ l i m e n u
νεκρόσ	n e k ɾ o s
ευσεβή	e f s e v i
γαμημένησ	ɣ a m i m e n i s
αγιασματάρι	a ʝ a z m a t a r i
τριφύλλι	t ɾ i f i l i
τριταγωνιστών	t r i t a ɣ o n i s t o n
τζάμπα	t s a m b a
έζησα	e z i s a
εγγράφηκε	e ŋ ɣ r a f i c e
μουσκεμένων	m u s c e m e n o n
παράπαια	p a r a p e a
χαλκίδα	x a l c i ð a
αβγουλάκι	a v ɣ u l a c i
τσακωνικά	t s a k o n i k a
απορρίπτομε	a p o ɾ i p t o m e
ντουλάπα	d u l a p a
νεκροθάλαμοσ	n e k ɾ o θ a l a m o s
ιρλανδία	i ɾ l a n ð i a
εξαλείφθηκα	e k s a l i f θ i k a
νοσοκομείο	n ɔ s ɔ k ɔ m i ɔ
ταίρι	t e r i
μαζικότερεσ	m a z i k o t e r e s
εκκολάφτηκα	e k o l a f t i k a
δημοσιεύω	ð i m o s i e v o
ματοκυλίστηκα	m a t o c i l i s t i k a
ισχυρίσθηκα	i s ç i ɾ i s θ i k a
μαζικότατε	m a z i k o t a t e
μωρό	m o ɾ o
πορδίζω	p o ɾ ð i z o
άρχοντασ	a ɾ x ɔ n d a s
εμπνέω	e m b n e o
λυνόμουν	l i n o m u n
μολύβι	m ɔ l i v i
φλερτάκι	f l e ɾ t a c i
γιορτάζομαι	ʝ o ɾ t a z o m e
στιμμένησ	s t i m e n i s
ξερόλα	k s e ɾ o l a
λυμένο	l i m e n o
συρρέω	s i r e o
κουράστηκα	k u ɾ a s t i k a
αρρωστημένε	a r o s t i m e n e
ανακατώνομαι	a n a k a t o n o m e
υγείεσ	i ʝ i e s
νόθοσ	n o θ o s
νταραβερίστηκα	d a ɾ a v e ɾ i s t i k a
ερρινισμόσ	e r i n i z m o s
κλάνω	k l a n o
περιγράφομε	p e ɾ i ɣ r a f o m e
ηγουμένου	i ɣ u m e n u
ιριδίζω	i r i ð i z o
ανάποδα	a n a p o ð a
ἀθήναισ	a θ i n e s
ενέκλεισα	e n e k l i s a
απορρίπτομαι	a p o ɾ i p t o m e
ιωάννινα	i o a n i n a
ρε	ɾ e
συγκροτώ	s i ŋ ɡ ɾ o t o
προσευχήθηκα	p r o s e f ç i θ i k a
στριμμένουσ	s t ɾ i m e n u s
στενοχωρούμε	s t e n o x o r u m e
σούταρε	s u t a ɾ e
πίθον	p i θ o n
θερμοδυναμικά	θ e r m o ð i n a m i k a
συνηθισμένεσ	s i n i θ i z m e n e s
άκων	a k o n
καθισμένησ	k a θ i z m e n i s
σακάτησ	s a k a t i s
ξεσκάτωμα	k s e s k a t o m a
ολόφωτησ	o l o f o t i s
συγγενήσ	s i ŋ ɟ e n i s
λύω	l i o
καταξοδεύομαι	k a t a k s o ð e v o m e
γιάντα	ʝ a n d a
ξοδιάστηκα	k s o ð ʝ a s t i k a
ασεβέστατα	a s e v e s t a t a
προηγουμένη	p r o i ɣ u m e n i
μυγοπαγίδα	m i ɣ o p a ʝ i ð a
ακριβοπληρώνω	a k r i v o p l i ɾ o n o
τοστιέρα	t o s t ç e ɾ a
στρίβομαι	s t ɾ i v o m e
υποσκάφτηκα	i p o s k a f t i k a
αγόρασα	a ɣ o ɾ a s a
σοφέ	s o f e
πλησιάζομε	p l i s i a z o m e
κόκκινου	k o c i n u
επανειλημμένο	e p a n i l i m e n o
πύο	p i o
σχολίου	s x o l i u
σύνθλιψα	s i n θ l i p s a
κλάνοντασ	k l a n o n d a s
απαρχαιωμένε	a p a r ç e o m e n e
σκεπάρνι	s c e p a r n i
ιρλανδέζικοσ	i ɾ l a n ð e z i k o s
λύνονταν	l i n o n d a n
τουβλάκι	t u v l a c i
βαμπίρ	v a m p i ɾ
ανθρωπόκαινοσ	a n θ ɾ o p o c e n o s
κουμπάροσ	k u m b a r o s
συγκινημένο	s i ŋ ɟ i n i m e n o
νήστεψα	n i s t e p s a
ναυτολόγιο	n a f t o l o ʝ i o
μάστορασ	m a s t o r a s
κωσταντίνο	k o s t a n d i n o
αποκρύβομαι	a p o k ɾ i v o m e
χλιοι	x ʎ i
επέπλευσα	e p e p l e f s a
επαλείφομαι	e p a l i f o m e
έρρινεσ	e r i n e s
παρεστιγμένη	p a ɾ e s t i ɣ m e n i
επισκέφτηκα	e p i s c e f t i k a
αποκλεισμένοσ	a p o k l i z m e n o s
ζώο	z o o
λάτρεψα	l a t ɾ e p s a
μαθημένησ	m a θ i m e n i s
κότα	k o t a
κλείνομαι	k l i n o m e
ακροχορδόνα	a k ɾ o x o ɾ ð o n a
αντικρούω	a n d i k r u o
πισωκολλητό	p i s o k o l i t o
εξοπλισμένουσ	e k s o p l i z m e n u s
καλομαθημένη	k a l o m a θ i m e n i
χέστρα	ç e s t ɾ a
εθνάρχου	e θ n a r x u
λιγοστεύω	l i ɣ o s t e v o
ξύλινοσ	k s i l i n o s
καθιδρύουμε	k a θ i ð r i u m e
ένρινη	e n r i n i
φλώροσ	f l o ɾ o s
υποσκάπτομαι	i p o s k a p t o m e
άσπρισα	a s p ɾ i z o
αλυσοδεμένησ	a l i s o ð e m e n i s
πιλοταρίστηκα	p i l o t a ɾ i s t i k a
ολόφωτοσ	o l o f o t o s
λυθείτε	l i θ i t e
καλομοίρικων	k a l o m i r i k o n
ζηλεύω	z i l e v o
ρεζιλεύω	ɾ e z i l e v o
κέφι	c e f i
καθίζω	k a θ i z o
ξύλο	k s i l o
κοίταξα	c i t a k s a
ψήφε	p s i f e
μαρασκίνο	m a ɾ a s c i n o
καταναγκάζομαι	k a t a n a ŋ ɡ a z o m e
αποπέμπουμε	a p o p e m b u m e
σαντούρια	s a n d u r ʝ a
πεισμένο	p i z m e n o
έντρομη	e n d ɾ o m i
αποδεικνύομαι	a p o ð i k n i o m e
ταλαιπωρώ	t a l e p o ɾ o
ποίησησ	p i i s i s
φτάνομαι	f t a n o m e
κλεισμένο	k l i z m e n o
καλοφάγωτου	k a l o f a ɣ o t u
αγγουριών	a ŋ ɡ u ɾ ʝ o n
σμύρνη	z m i ɾ n i
έκλεψα	e k l e p s a
λούστηκα	l u s t i k a
εισέρρευσα	i s e r e f s a
σοφών	s o f o n
λιγότερων	l i ɣ o t e r o n
γαλοπούλα	ɣ a l o p u l a
ένρινοσ	e n r i n o s
αναμαλλιασμένου	a n a m a ʎ a z m e n u
αληθείσ	a l i θ i s
συνεθλίβην	s i n e θ l i v i n
αποκλεισμένη	a p o k l i z m e n i
κλαδεύομαι	k l a ð e v o m e
νεοελληνικά	n e o e l i n i k a
σφυρίχτηκα	s f i r i x t i k a
καθομιλουμένη	k a θ o m i l u m e n i
χριστουγεννιάτικοσ	x r i s t u ʝ e ɲ a t i k o s
βιβλιοπωλεία	v i v l i o p o l i a
πουδράρισα	p u ð ɾ a ɾ i s a
απέβλεψα	a p e v l e p s a
φτιάχνομαι	f t ç a x n o m e
υιόσ	i ɔ s
αναρμόδιοσ	a n a ɾ m o ð i o s
ματοβαμμένοι	m a t o v a m e n i
ἀνίδρυσα	a n i ð r i s a
φτύνομαι	f t i n o m e
σημειωθήκαν	s i m i o θ i k a n
αντιγράφεισ	a n d i ɣ r a f i s
φυτεύομαι	f i t e v o m e
ανακρούστηκα	a n a k r u s t i k a
σαπούνι	s a p u n i
χόρτασα	x o ɾ t a s a
έριδα	e r i ð a
αξίζω	a k s i z o
σπιτόγατοσ	s p i t o ɣ a t o s
συγκινητικώσ	s i ŋ ɟ i n i t i k o s
αδειάζω	a ð ʝ a z o
χάφτω	x a f t o
γιάννινα	ʝ a n i n a
απέπνευσα	a p e p n e f s a
στρατοπέδου	s t ɾ a t o p e ð u
ανέρχομαι	a n e r x o m e
κοίτη	c i t i
κάρδαμο	k a r ð a m o
αμφιθέατρο	a m f i θ e a t ɾ o
κωλοπηλάλα	k o l o p i l a l a
οργασμόσ	ɔ ɾ ɣ a z m ɔ s
κοροϊδεύτηκα	k o ɾ o i̯ ð e f t i k a
παρεστιγμένοσ	p a ɾ e s t i ɣ m e n o s
αραχνιασμένοι	a ɾ a x ɲ a z m e n i
υπολογισμένησ	i p o l o ʝ i z m e n i s
κωλύω	k o l i o
τίνων	t i n o n
βούλιαξα	v u ʎ a k s a
κεραμίδι	c e ɾ a m i ð i
εκπομπέσ	e k p o m b e s
τέωσ	t e o s
πέμπομαι	p e m b o m e
πυροφάνι	p i ɾ o f a n i
αγαντάριζε	a ɣ a n d a r i z e
λυπημένε	l i p i m e n e
ανίδρυσα	a n i ð r i s a
κλείω	k l i o
βρεφοκτονία	v ɾ e f o k t o n i a
βαλσ	v a l s
θλιμμένε	θ l i m e n e
αγγιγμένησ	a ŋ ɟ i ɣ m e n i s
καταστρέφουμε	k a t a s t ɾ e f u m e
αλληλοσυγκρουόμενεσ	a l i l o s i ŋ ɡ r u o m e n e s
πείστηκα	p i s t i k a
παρέγραψα	p a ɾ e ɣ ɾ a p s a
διπλανόσ	ð i p l a n o s
χειμωνιάτικοσ	ç i m o ɲ a t i k o s
κόρνα	k o ɾ n a
κυνηγημένο	c i n i ʝ i m e n o
καπνίζομαι	k a p n i z o m e
σχηματίζω	s ç i m a t i z o
χάη	x a i
διεκόπην	ð i e k o p i n
λιμένοσ	l i m e n o s
έκρηξη	ɛ k ɾ i k s i
ανασκάπτουμε	a n a s k a p t u m e
σείομε	s i o m e
χλιου	x ʎ u
απαλείφομε	a p a l i f o m e
σβηστήρια	z v i s t i ɾ ʝ a
τεχνολόγε	t e x n o l o ʝ e
συνηθισμένων	s i n i θ i z m e n o n
απεκαλύφθην	a p e k a l i f θ i n
στυμμένησ	s t i m e n i s
συγκρουόμενησ	s i ŋ ɡ r u o m e n i s
ανιδρύομαι	a n i ð r i o m e
πλέχτηκα	p l e x t i k a
ανέστρεψα	a n e s t ɾ e p s a
κάποτε	k a p o t e
μυκτήρ	m i k t i r
κωσταντίνου	k o s t a n d i n u
σωρούσ	s o ɾ u s
παραγράφηκα	p a ɾ a ɣ ɾ a f i k a
μέμφθηκα	m e m f θ i k a
ξερόψωμα	k s e r o p s o m a
στουτγάρδη	s t u t ɣ a r ð i
καταγραφείσ	k a t a ɣ r a f i s
απέδειξα	a p e ð i k s a
ίε	i e
δυσκόλεψα	ð i s k o l e p s a
υπεγράφην	i p e ɣ r a f i n
γεωγραφία	ʝ e o ɣ r a f i a
συνδέουμε	s i n ð e u m e
μαυρίζω	m a v r i z o
απεδείχθη	a p e ð i x θ i
αποκαλύπτομαι	a p o k a l i p t o m e
ψύχωση	p s i x ɔ s i
πίσον	p i s o n
παιδεύομαι	p e ð e v o m e
κανακεύω	k a n a c e v o
ήχε	i ç e
αποστάζομαι	a p o s t a z o m e
παραπέμπω	p a ɾ a p e m b o
μάζευ'	m a z e f
γητεύομαι	ʝ i t e v o m e
κυνηγάω	c i n i ɣ a o
διαμείφθηκαν	ð i a m i f θ i k a n
σουβλατζίδικο	s u v l a d z i ð i k o
γάδαροσ	ɣ a ð a ɾ o s
πλοίο	p l i ɔ
αμοιβή	a m i v i
αποκλείετε	a p o k l i e t e
έπλευσα	e p l e f s a
παρέκαμψε	p a ɾ e k a m p s e
γενεέσ	ʝ e n e e s
επιπλέω	e p i p l e o
στενοχωρήθηκα	s t e n o x o r i θ i k a
αγυιοπαίδων	a ʝ i o p e ð o n
επιτράπηκα	e p i t ɾ a p i k a
έλκω	e l k o
αθεϊσμόσ	a θ e i z m o s
άμυαλοσ	a m ɲ a l o s
αμβούργο	a ɱ v u r ɣ o
υπέρ	i p e r
συλλέχθηκα	s i l e x θ i k a
ελευθερουδάκησ	e l e f θ e r u ð a c i s
αναδείχνομαι	a n a ð i x n o m e
σούταρα	s u t a ɾ a
εμπνεύσθηκα	e m b n e f s θ i k a
μαζικότεροσ	m a z i k o t e r o s
στιμμένεσ	s t i m e n e s
άρια	a ɾ i a
ἐξώστησ	e k s o s t i s
εικοστόσ	i k o s t o s
ωρύομαι	o r i o m e
ψωμιέρεσ	p s o m ɲ e r e s
ακροάζομαι	a k r o a z o m e
παντεσπάνι	p a n d e s p a n i
ανατινάχθηκα	a n a t i n a x θ i k a
περισπώμενεσ	p e ɾ i s p o m e n e s
χαμηλοβλεπούσα	x a m i l o v l e p u s a
έφτασα	e f t a s a
καλύπτομαι	k a l i p t o m e
κουκλάρα	k u k l a ɾ a
καθίδρυσα	k a θ i ð r i s a
εορτάζομε	e o ɾ t a z o m e
κκε	k u k u e
κάλυμνε	k a l i m n e
ηλιθιότητα	i l i θ i o t i t a
ανελκύσθηκα	a n e l c i s θ i k a
κλεισμένη	k l i z m e n i
ακριβοπληρώνομαι	a k r i v o p l i ɾ o n o m e
κινδύνευα	c i n ð i n e v a
κυνηγημένησ	c i n i ʝ i m e n i s
στήθοσ	s t i θ o s
κυήματα	c i i m a t a
τζατζίκι	d͡z a d͡z i c i
κυνηγῶ	c i n i ɣ o
μαρκάρω	m a ɾ k a ɾ o
προηγούμενων	p r o i ɣ u m e n o n
κείνη	c i n i
παρακαλώ	p a r a k a l o
θεωρώ	θ e o r o
απεκλείσθη	a p e k l i s θ i
υπερκαινοφανήσ	i p e ɾ c e n o f a n i s
γονυπετούσ	ɣ o n i p e t u s
συναιρέσεων	s i n e r e s e o n
αναγκάζομε	a n a ŋ ɡ a z o m e
κοινολέκτου	c i n o l e k t u
ειλημμένων	i l i m e n o n
εκλέχθηκα	e k l e x θ i k a
διαπλέω	ð i a p l e o
αλατισμένησ	a l a t i z m e n i s
αμφιλεγόμενη	a ɱ f i l e ɣ o m e n i
γυρεύω	ʝ i ɾ e v o
θηλιά	θ i ʎ a
ξελύνομαι	k s e l i n o m e
ελκυστικόσ	e l c i s t i k o s
παζαρεύω	p a z a ɾ e v o
εγγράφηκαν	e ŋ ɣ r a f i k a n
μανώλησ	m a n o l i s
συρράφθηκα	s i ɾ a f θ i k a
ξεμπέρδεψα	k s e b e ɾ ð e p s a
ποικιλότατων	p i c i l o t a t o n
ἀνέσκαψα	a n e s k a p s a
θεμάτων	θ e m a t o n
τρεισήμισι	t ɾ i s i m i s i
παγκάκι	p a ŋ ɡ a c i
είντα	i n d a
καταλύθηκα	k a t a l i θ i k a
ξοδιάζω	k s o ð ʝ a z o
μαζική	m a z i c i
συμφύομαι	s i ɱ f i o m e
αποσείομαι	a p o s i o m e
αλαμπουρνέζικο	a l a b u r n e z i k o
ποικίλο	p i c i l o
αντικλεπτικούσ	a n d i k l e p t i k u s
πολωνικήσ	p o l o n i c i s
δηλώνω	ð i l o n o
ματόκλαδου	m a t o k l a ð u
ανακαλύπτω	a n a k a l i p t o
κόλλησα	k o l i s a
αυγοκομμένοσ	a v ɣ o k o m e n o s
εγγράφηκα	e ŋ ɣ r a f i k a
παρακειμένου	p a r a c i m e n u
φλερτ	f l e ɾ t
μελισσοκομία	m e l i s o k o m i a
χάμπουργκερ	x a m b u ɾ ŋ ɟ e ɾ
δαγκωθεί	ð a ŋ ɡ o θ i
μήτροσ	m i t ɾ o s
τσακώνω	t s a k o n o
επάλειψα	e p a l i p s a
ιβηρικόσ	i v i ɾ i k o s
συνθλίφτηκε	s i n θ l i f t i c e
άραχλοσ	a ɾ a x l o s
ντουζ	d u z
αληθεύω	a l i θ e v o
ψημένα	p s i m e n a
παλιόγρια	p a ʎ o ɣ ɾ i a
φραγκοφονιάσ	f ɾ a ŋ ɡ o f o ɲ a s
μετέχω	m e t e x o
κατέφθασα	k a t e f θ a s a
λειώνω	ʎ o n o
έφτιαξα	e f t ç a k s a
λυπημένουσ	l i p i m e n u s
τρίβομαι	t r i v o m e
έψαξα	e p s a k s a
άρχομαι	a r x o m e
συγγραφέα	s i ŋ ɣ r a f e a
αλείβομαι	a l i v o m e
χελώνα	ç e l o n a
νύσταξα	n i s t a k s a
υπολογιστικήσ	i p o l o ʝ i s t i c i s
σκοτωμόσ	s k o t o m o s
αισθάνομαι	e s θ a n o m e
συνοδών	s i n o ð o n
συνεχάρην	s i n e x a r i n
ηλικιωμένοι	i l i c i o m e n i
παρίσι	p a ɾ i s i
δυσκολεύομαι	ð i s k o l e v o m e
αγοράζω	a ɣ o ɾ a z o
τύρναβοσ	t i ɾ n a v o s
πουσταρέλι	p u s t a ɾ e l i
γέννασ	ʝ e n a s
καλμάρω	k a l m a ɾ o
αγία	a ʝ i a
ανακαινίζω	a n a c e n i z o
ακονίζομαι	a k o n i z o m e
ζήτα	z i t a
ποικιλότατη	p i c i l o t a t i
αρρωστημένησ	a r o s t i m e n i s
προαλείφουμε	p ɾ o a l i f u m e
πειθαναγκάζω	p i θ a n a ŋ ɡ a z o
κλέφτικο	k l e f t i k a
άκουα	a k u a
μαγειρέψει	m a ʝ i ɾ e p s i
λίθοι	l i θ i
αεροφωτογραφίζομαι	a e r o f o t o ɣ r a f i z o m e
περίπτωση	p e ɾ i p t o s i
σφυρίζομαι	s f i r i z o m e
ανέμενεσ	a n e m e n e s
τσακωνικό	t s a k o n i k o
βασίλεψα	v a s i l e p s a
κορίτσαρων	k o r i t s a r o n
γιατάκι	ʝ a t a c i
χειρομαντεία	ç i ɾ o m a n d i a
όλασπροσ	o l a s p ɾ o s
θερμοδυναμικού	θ e r m o ð i n a m i k u
παρκάρομαι	p a ɾ k a ɾ o m e
καλομοίρησ	k a l o m i r i s
αλαμπάμα	a l a b a m a
αντέκρουσα	a n d e k r u s a
γηροκομείο	ʝ i ɾ o k o m i o
αγγισμένοι	a ŋ ɟ i z m e n i
αναψοκοκκινίζω	a n a p s o k o c i n i z o
βαθμολογημένεσ	v a θ m o l o ʝ i m e n e s
πρωτότυποσ	p ɾ o t o t i p o s
αποκερματισμό	a p o c e ɾ m a t i z m o
λάκαινα	l a c e n a
πούλι	p u l i
σκωτία	s k ɔ t i a
μαυρισμένη	m a v r i z m e n i
ανακλαδίζομαι	a n a k l a ð i z o m e
περιγράφουμε	p e ɾ i ɣ r a f u m e
άντε	a d e
όφισ	o f i s
ματοβαμμένουσ	m a t o v a m e n u s
αναμαλλιασμένε	a n a m a ʎ a z m e n e
ηγουμένησ	i ɣ u m e n i s
αναθεματισμένα	a n a θ e m a t i z m e n a
ερρινοτήτων	e r i n o t i t o n
σαντούρι	s a n d u r i
τασάκι	t a s a c i
αεροφωτογραφίσεισ	a e r o f o t o ɣ r a f i s i s
δράμι	ð r a m i
σκατουλήσ	s k a t u l i s
προμηθέα	p r o m i θ e a
ένρινεσ	e n r i n e s
τόσο	t o s o
εγκλείστηκα	e ŋ ɡ l i s t i k a
συγγραφέωσ	s i ŋ ɣ r a f e o s
περίοδο	p e r i o ð o
τριμμένη	t r i m e n i
άμε	a m e
μαθημένα	m a θ i m e n a
παραδεχτόσ	p a ɾ a ð e x t o s
πασχαλίτσα	p a s x a l i t s a
παρελθόν	p a r e l θ o n
σοφού	s o f u
ψήφου	p s i f u
γεράματα	ʝ e ɾ a m a t a
παρακείμενο	p a ɾ a c i m e n o
περιοδικών	p e r i o ð i k o n
πείθω	p i θ o
υπολογίζω	i p o l o ʝ i z o
ανασκαλεύω	a n a s k a l e v o
αστυνομία	a s t i n o̞ m i a
ανασαλεύομαι	a n a s a l e v o m e
διέπνευσα	ð i e p n e f s a
σχετικά	s ç e t i k a
θλιμμένουσ	θ l i m e n u s
ψημένου	p s i m e n u
ζωντανεύω	z o n d a n e v o
αποτρέπω	a p o t ɾ e p o
μαλάκασ	m a l a k a s
επαλείφομε	e p a l i f o m e
απόδειξα	a p o ð i k s a
αλαμπουρνέζικοι	a l a b u r n e z i c i
πουδράριζα	p u ð ɾ a ɾ i z a
αποκλείστηκα	a p o k l i s t i k a
ευσέβειασ	e f s e v i a s
κοινόλεκτοσ	c i n o l e k t o s
σαντουριών	s a n d u r ʝ o n
νηστικόσ	n i s t i k o s
αντιστρέφομαι	a n d i s t ɾ e f o m e
σωρέ	s o ɾ e
ἔκλεισα	e k l i s a
ελιόψωμων	e ʎ o p s o m o n
μπουρνούζι	b u ɾ n u z i
παρεισέφρησα	p a r i s e f r i s a
στεναχωρημένη	s t e n a x o r i m e n i
φιξάρισα	f i k s a ɾ i s a
ολόκαινοσ	o l o c e n o s
συνεχίστηκα	s i n e ç i s t i k a
πέμπεισ	p e m b i s
διπλανή	ð i p l a n i
καλομαθημένε	k a l o m a θ i m e n e
ευσεβούσ	e f s e v u s
λακωνικόσ	l a k o n i k o s
δραπέτησ	ð ɾ a p e t i s
πληρώνομαι	p l i ɾ o n o m e
λούζω	l u z o
επέτρεψα	e p e t ɾ e p s a
ντροπαλοί	d ɾ o p a l i
τραγουδιστήσ	t ɾ a ɣ u ð i s t i s
μαθημένε	m a θ i m e n e
κεντάκι	c e n t a c i
αποκλεισμένου	a p o k l i z m e n u
μουσκεμένε	m u s c e m e n e
χαραλάμπησ	x a ɾ a l a m b i s
χιμπατζήσ	ç i m b a n d z i s
προαισθάνομαι	p r o e s θ a n o m e
ηλιοθεραπεία	i ʎ o θ e ɾ a p i a
κορόιδο	k o ɾ o i̯ ð o
προσκρούω	p r o s k r u o
μαγείρεψα	m a ʝ i ɾ e p s a
θεωρεία	θ e o r i a
εθνάρχεσ	e θ n a r ç e s
παγωμένησ	p a ɣ o m e n i s
κόμποσ	k o m b o s
θλιμμένοι	θ l i m e n i
ικέτεψα	i c e t e p s a
ευγηρία	e v ʝ i ɾ i a
αγγισμένων	a ŋ ɟ i z m e n o n
μαζικέσ	m a z i c e s
φορολογία	f o ɾ o l o ʝ i a
καλιαρντά	k a ʎ a r d a
ποδόσφαιρα	p o ð o s f e r a
αναβαθμολογήθηκα	a n a v a θ m o l o ʝ i θ i k a
ξενοδοχείο	k s e n o ð o ç i o
αγανακτισμένη	a ɣ a n a k t i z m e n i
συνέδεσα	s i n e ð e s a
λατρεύτηκα	l a t ɾ e f t i k a
φασουλιού	f a s u ʎ u
αιμομιξία	e m o m i k s i a
αγγίχτηκα	a ŋ ɟ i x t i k a
συγκινημένοι	s i ŋ ɟ i n i m e n i
ουγκιά	u ŋ ɟ a
συγκόπτομαι	s i ŋ ɡ o p t o m e
υπογραφείσ	i p o ɣ ɾ a f i s
αντικλεπτικοί	a n d i k l e p t i c i
νόσο	n o s o
υποκρύπτομε	i p o k ɾ i p t o m e
σερβιρίζω	s e ɾ v i ɾ i z o
μυγιάστηκα	m i ʝ a s t i k a
εκχύνω	e k ç i n o
περιστρέφω	p e ɾ i s t ɾ e f o
φυλαχτό	f i l a x t o
κουρασμένου	k u r a z m e n u
αηδιασμένοι	a i ð i a z m e n i
αγανακτισμένου	a ɣ a n a k t i z m e n u
υποθάλπω	i p o θ a l p o
ποικιλότατησ	p i c i l o t a t i s
ναυσικά	n a f s i k a
ορλάνδοσ	o r l a n ð o s
άκαρποσ	a k a ɾ p o s
ακόλλητοσ	a k o l i t o s
ευθέωσ	e f θ e o s
διαλογίστηκα	ð i a l o ʝ i s t i k a
πούδραρα	p u ð ɾ a ɾ a
οσμίζομαι	o z m i z o m e
λύνεται	l i n e t e
λεξιπλασία	l e k s i p l a s i a
άγιοι	a ʝ i i
αντιμετωπίστηκα	a n d i m e t o p i s t i k a
σκαντζόχοιροσ	s k a n d z ɔ ç i ɾ ɔ s
παρακείμενα	p a r a c i m e n a
φυτεύω	f i t e v o
απασχολιέμαι	a p a s x o ʎ e m e
ζητιανεύω	z i t ç a n e v o
άρκτοσ	a ɾ k t o s
σερβίριζε	s e ɾ v i ɾ i z e
εσωκλείομαι	e s o k l i o m e
πιονιών	p ç o ɲ o n
κουτσόσ	k u t s o s
νικολάου	n i k o l a u
μπέρδεψα	b e ɾ ð e p s a
υγεία	i ʝ i a
προαλείφθηκα	p ɾ o a l i f θ i k a
υστερώ	i s t e ɾ o
κάλυμνοσ	k a l i m n o s
προφασίστηκα	p ɾ o f a s i s t i k a
άραξα	a r a k s a
εισακούστηκα	i s a k u s t i k a
ἀδικῶ	a ð i k o
εμπόριο	ɛ m b ɔ ɾ i ɔ
ντο	d o
ξαραχνιάζω	k s a ɾ a x ɲ a z o
φωτοστέφανο	f o t o s t e f a n o
καταλύω	k a t a l i o
εμπρόσ	e m b r o s
παραβλέφθηκα	p a ɾ a v l e f θ i k a
βυθισμένησ	v i θ i z m e n i s
έφηβη	ɛ f i v i
ανθρωποκτονία	a n θ ɾ o p o k t o n i a
διαλελυμένησ	ð i a l e l i m e n i s
αγγελούδια	a ŋ ɟ e l u ð ʝ a
σκίζομαι	s c i z o m e
καθέλκουμε	k a θ e l k u u m e
ενρινότητα	e n r i n o t i t a
θερμοκοιτίδα	θ e r m o c i t i ð a
αξιοσημείωτε	a k s i o s i m i o t e
κρυμμένοι	k r i m e n i
διαλελυμένα	ð i a l e l i m e n a
κακογαμημένων	k a k o ɣ a m i m e n o n
αναδείχνω	a n a ð i x n o
ινάτι	i n a t i
κανάκεψα	k a n a c e p s a
σβηστηριών	z v i s t i ɾ ʝ o n
αποδειχθήκαν	a p o ð i x θ i k a n
ξοδεύω	k s o ð e v o
κολλήθηκα	k o l i θ i k a
αρετήσ	a r e t i s
απαθήσ	a p a θ i s
καλοφάγωτων	k a l o f a ɣ o t o n
ανασυνιστώ	a n a s i n i s t o
ράφτηκα	ɾ a v o
παναγία	p a n a ʝ i a
αγνάντεψε	a ɣ n a n d e p s e
κεριά	c e r ʝ a
αντικρούομαι	a n d i k r u o m e
κεσεμιού	c e s e m ɲ u
ασπάσθηκα	a s p a s θ i k a
εγκεφαλοκλάνι	e ŋ ɡ e f a l o k l a n i
απαλείφθηκα	a p a l i f θ i k a
μπερδεμένων	b e ɾ ð e m e n o n
ευχετήριοσ	e f ç e t i r i o s
μπλουζάκι	b l u z a c i
αναγνωρισμένη	a n a ɣ n o r i z m e n i
τουρκοκρατία	t u ɾ k o k ɾ a t i a
αδίκησα	a ð i c i s a
πορνόγεροσ	p o ɾ n o ʝ e ɾ o s
εφοδιάζω	e f o ð i a z o
αναθάρρυνα	a n a θ a ɾ i n a
λυπημένησ	l i p i m e n i s
μαλωμένοσ	m a l o m e n o s
υπουργόσ	i p u ɾ ɣ o s
γιάννα	ʝ a n a
διώχνομαι	ð ʝ o x n o m e
τσέκαρε	t s e k a ɾ e
κανάκευε	k a n a c e v e
επικαλύφθηκα	e p i k a l i f θ i k a
πρόφθασα	p ɾ ɔ f θ a s a
πύργων	p i r ɣ o n
διαλελυμένο	ð i a l e l i m e n o
αλληλοσυγκρουόμενε	a l i l o s i ŋ ɡ r u o m e n e
ψιλό	p s i l o
βασίλευε	v a s i l e v e
έγινα	e ʝ i n a
εμπερικλείω	e m b e r i k l i o
προσείλκυσα	p r o s i l c i s a
υποκλέπτομαι	i p o k l e p t o m e
πιπεριά	p i p e r ʝ a
συνοδό	s i n o ð o
αντέγραψα	a n d e ɣ r a p s a
αποκλεισμένεσ	a p o k l i z m e n e s
ναυτολογίων	n a f t o l o ʝ i o n
κουρεύτηκα	k u ɾ e f t i k a
λύνομαι	l i n o m e
σάλοσ	s a l o s
ποιήσεωσ	p i i s e o s
επιστρέφουμε	e p i s t ɾ e f u m e
τετριμμένησ	t e t r i m e n i s
έλεοσ	e l e o s
πεθαμένοσ	p e θ a m e n o s
ποικιλότατουσ	p i c i l o t a t u s
αβαράριζε	a v a ɾ a ɾ i z e
ολόκληροσ	o l o k l i r o s
αρκτικόσ	a ɾ k t i k o s
τετριμμένην	t e t r i m e n i n
αλυσοδεμένη	a l i s o ð e m e n i
μπουνατσάρει	b u n a t s a ɾ i
φιλόδοξοσ	f i l o ð o k s o s
μυταράσ	m i t a ɾ a s
πειθόμενοι	p i θ o m e n i
ἐκρούσθην	e k r u s θ i n
θαλαμηγό	θ a l a m i ɣ o
μαυρισμένεσ	m a v r i z m e n e s
έμμονοσ	e m o n o s
χίο	ç i o
επισείομε	e p i s i o m e
ναζιάρησ	n a z ʝ a ɾ i s
καταλύθηκαν	k a t a l i θ i k a n
ροσόλι	ɾ o s o l i
παντρεμένου	p a n d ɾ e m e n u
δεκατέσσερισ	ð e k a t e s e ɾ i s
σάλευε	s a l e v e
τσίτσα	t s i t s a
συνηθισμένουσ	s i n i θ i z m e n u s
καμουφλάρομαι	k a m u f l a ɾ o m e
πιστεύεται	p i s t e v e t e
ανθέλληνασ	a n θ e l i n a s
αμείβομαι	a m i v o m e
ζευγαριών	z e v ɣ a r ʝ o n
έλιασα	e ʎ a s a
διαχειρίστηκα	ð i a ç i ɾ i s t i k a
πληρώθηκα	p l i ɾ o θ i k a
ανάμενεσ	a n a m e n e s
ενστερνίστηκα	e n s t e r n i s t i k a
είσαστε	i s a s t e
προμηθεύω	p ɾ ɔ m i θ e v o
κορίτσαρουσ	k o r i t s a r u s
ευσέβαστοσ	e f s e v a s t o s
τυροπιτούλα	t i ɾ o p i t u l a
γιακάσ	ʝ a k a s
αλυσίδα	a l i s i ð a
μάντεψα	m a n d e p s a
πιστεύομαι	p i s t e v o m e
οφσάιντ	o f s a i d
άγκιστρο	a ŋ ɟ i s t r o
στύβομαι	s t i v o m e
ανασκάφτουμε	a n a s k a f t u m e
συγκρουόμενοσ	s i ŋ ɡ r u o m e n o s
έλουσα	e l u s a
σταφιδόψωμα	s t a f i ð o p s o m a
φιξάρω	f i k s a ɾ o
αδικούμε	a ð i k u m e
πρωθυπουργόσ	p ɾ o θ i p u ɾ ɣ o s
λεξιπλασίασ	l e k s i p l a s i a s
αλαφιασμένο	a l a f ç a z m e n o
αραχνούλα	a ɾ a x n u l a
μέρεψε	m e ɾ e p s e
ενοχλητικόσ	e n o x l i t i k o s
ψωλίτσα	p s o l i t s a
πουδρίτσα	p u ð ɾ i t s a
παράξενα	p a ɾ a k s e n a
φωτογραφείου	f o t o ɣ r a f i u
φλόκοσ	f l o k o s
κλέφτησ	k l e f t i s
δολοφονώ	ð o l o f o n o
ξυλόφωνο	k s i l ɔ f ɔ n ɔ
λύσομε	l i s o m e
παύλοσ	p a v l o s
γκρίζεσ	ɡ ɾ i z e s
καλόσ	k a l o s
αντιπαραμεθαύριο	a n d i p a r a m e θ a v ɾ i o
απαρχαιωμένοι	a p a r ç e o m e n i
γαμημένουσ	ɣ a m i m e n u s
γεωγραφιών	ʝ e o ɣ r a f i o n
ευσεβέστερα	e f s e v e s t e r a
επιστημολογία	ɛ p i s t i m ɔ l ɔ ʝ i a
αποκυημάτων	a p o c i i m a t o n
κάλμα	k a l m a
βαθμολογημένου	v a θ m o l o ʝ i m e n u
οραματίζομαι	o ɾ a m a t i z o m e
χοντρομπαλού	x o n d ɾ o b a l u
στρατοπέδων	s t ɾ a t o p e ð o n
καθίκι	k a θ i c i
ανακράζω	a n a k r a z o
αναμειγνύομαι	a n a m i ɣ n i o m e
γένοσ	ʝ e̞ n o̞ s
παναγιότατοσ	p a n a ʝ i o t a t o s
αρετέσ	a r e t e s
ντροπιαστική	d ɾ o p ç a s t i c i
γρηγόρηδων	ɣ ɾ i ɣ o ɾ i ð o n
λύνεσαι	l i n e s e
ελκύομαι	e l c i o m e
αμφιλεγόμενου	a ɱ f i l e ɣ o m e n u
τάφρουσ	t a f r u s
κωλόπαιδο	k o l o p e ð o
ασ'	a s
ήδη	i ð i
αθροίστηκα	a θ ɾ i s t i k a
διαφήμιση	ð i a f i m i s i
στουτγκάρδη	s t u t ɡ a r ð i
παρεκτράπηκα	p a ɾ e k t ɾ a p i k a
ρώμη	ɾ o m i
φίδι	f i ð i
λυμένουσ	l i m e n u s
κορνάρισμα	k o ɾ n a ɾ i z m a
παραβλέπω	p a ɾ a v l e p o
πυροτέχνημα	p i ɾ o t e x n i m a
γρηγόριοσ	ɣ r i ɣ o r i o s
σημάδια	s i m a ð ʝ a
μακάβριοσ	m a k a v ɾ i o s
άμετε	a m e t e
ανθρώπεψε	a n θ ɾ o p e p s e
παραστάθηκα	p a r a s t a θ i k a
υστεροβουλία	i s t e ɾ o v u l i a
κατασκοπεύω	k a t a s k o p e v o
φωνάρα	f o n a ɾ a
κατανάγκασα	k a t a n a ŋ ɡ a s a
πράγμα	p ɾ a ɣ m a
αδικιέμαι	a ð i c e m e
καθελκύουμε	k a θ e l c i u m e
χόρεψα	x o ɾ e p s a
αναμμένοι	a n a m e n i
μύτη	m i t i
μάζευα	m a z e v a
κράμβη	k r a ɱ v i
αποκυήματα	a p o c i i m a t a
λευκέσ	l e f c e s
αναθεματισμένοσ	a n a θ e m a t i z m e n o s
κουκλάκι	k u k l a c i
γλύκισμα	ɣ l i c i z m a
λύσε	l i s e
αγγελοκρούομαι	a ŋ ɟ e l o k r u o m e
αντέστρεψα	a n d e s t ɾ e p s a
βήτα	v i t a
πέθανε	p e θ a n e
μύκονε	m i k o n e
δαγκάνομαι	ð a ŋ ɡ a n o m e
γενιέσ	ʝ e ɲ e s
τεχνολόγουσ	t e x n o l o ɣ u s
νεκροτομή	n e k ɾ o t o m i
περικλείσθηκα	p e r i k l i s θ i k a
καλομάνασ	k a l o m a n a s
κορόιδεψε	k o ɾ o i̯ ð e p s e
ασκούμε	a s k u m e
μύγα	m i ɣ a
ουσιαστικοποίησησ	u s i a s t i k o p i i s i s
αλαλιάζω	a l a ʎ a z o
κούκκοσ	k u k o s
σερβιετάκι	s e r v ʝ e t a c i
λιοντάρι	ʎ ɔ n d a ɾ i
πείραξα	p i r a k s a
έντεκα	e n d e k a
νοιάζομαι	ɲ a z o m e
μαντεύομαι	m a n d e v o m e
κέικ	c e i k
έσεισα	e s i s a
αναβαλλόμενη	a n a v a l o m e n i
ντροπιασμένε	d ɾ o p ç a z m e n e
ίδρυσα	i ð r i s a
ποικιλότεροι	p i c i l o t e r i
αφορά	a f o r a
σάλταρα	s a l t a ɾ a
αλλαξοπίστησα	a l a k s o p i s t i s a
υπολογιστικέ	i p o l o ʝ i s t i c e
τριμμένοσ	t r i m e n o s
καταιγίδεσ	k a t e ʝ i ð e s
αποδείχνω	a p o ð i x n o
ζευγάρια	z e v ɣ a r ʝ a
παπάρα	p a p a ɾ a
έψιλον	e p s i l o n
ψηφίζω	p s i f i z ɔ
αναπλέω	a n a p l e o
αξιολύπητοσ	a k s i o l i p i t o s
αναμειγνύω	a n a m i ɣ n i o
φωτοβολίδα	f o t o v o l i ð a
άμπελοσ	a m b e l o s
έκτοσ	e k t o s
τριμμένων	t r i m e n o n
περασμένουσ	p e r a z m e n u s
έλκουμε	e l k u m e
ομόλογη	o m o l o ʝ i
αίαντασ	e a n d a s
στοιβάζω	s t i v a z o
στεναχωρούμε	s t e n a x o r u m e
αιδοίο	ɛ ð i ɔ
καταναγκάστηκα	k a t a n a ŋ ɡ a s t i k a
θαύμα	θ a v m a
πλατεία	p l a t i a
σώσε	s o s e
κρίνομαι	k r i n o m e
κατεργάσθηκα	k a t e r ɣ a s θ i k a
ανέκοψα	a n e k o p s a
υπομονή	i p o m o n i
καθαρματάρα	k a θ a ɾ m a t a ɾ a
κακογαμημένε	k a k o ɣ a m i m e n e
ξέροντασ	k s e ɾ o n d a s
πουστοφέρνω	p u s t o f e ɾ n o
απελπισμένα	a p e l p i z m e n a
δεκατρία	ð e k a t ɾ i a
βιόσφαιρασ	v i o s f e ɾ a s
φώναξα	f o n a k s a
αγαπημένησ	a ɣ a p i m e n i s
παραχαϊδεύτηκα	p a ɾ a x a i̯ ð e f t i k a
λυθήκανε	l i θ i k a n e
ομολογούμαι	o m o l o ɣ u m e
πάμμαυρουσ	p a m a v ɾ u s
σέρρεσ	s e ɾ e s
κουσούρι	k u s u ɾ i
σέντερ	s e n d e ɾ
βλάκασ	v l a k a s
κοκκίνισα	k o c i n i s a
γκέι	ɡ e i
σοφότερο	s o f o t e ɾ o
ανέπαλα	a n e p a l a
θλιμμένησ	θ l i m e n i s
εμπεριέκλεισα	e m b e r i e k l i s a
συγγραφεί	s i ŋ ɣ r a f i
μυκήνεσ	m i c i n e s
περιοδικούσ	p e r i o ð i k u s
στιγματίζω	s t i ɣ m a t i z o
μανόλησ	m a n o l i s
συνδέομε	s i n ð e o m e
μακαρόνια	m a k a ɾ o ɲ a
ντροπαλά	d ɾ o p a l a
συγγράφτηκα	s i ŋ ɣ r a f t i k a
ακροάτρια	a k ɾ o a t ɾ i a
βοοειδή	v o o i ð i
τρομάζω	t r o m a z o
άθαφτοσ	a θ a f t o s
υπολόγισα	i p o l o ʝ i s a
θεωρείο	θ e o ɾ i o
ανάπλι	a n a p l i
εκπίπτω	e k p i p t o
πίνομαι	p i n o m e
βλαμμένησ	v l a m e n i s
εγκύπτω	e ŋ ɟ i p t o
αντέτι	a d e t i
απέσταξα	a p e s t a k s a
ανέλκυσα	a n e l c i s a
φλόκοι	f l o c i
εγκατέλειψα	e ŋ ɡ a t e l i p s a
οπαδόσ	ɔ p a ð ɔ s
συνθλιφτήκαν	s i n θ l i f t i k a n
καταδύσεισ	k a t a ð i s i s
αλατισμένων	a l a t i z m e n o n
λαογράφοσ	l a o ɣ ɾ a f o s
σπάρτη	s p a ɾ t i
υπογράφηκα	i p o ɣ r a f i k a
κλέψω	k l e p s o
φιλόσοφοσ	f i l o s o f o s
τέρπω	t e ɾ p o
ίντα	i n d a
μέδουσα	m e̞ ð u s a
αγωνιζόμενοσ	a ɣ o n i z o m e n o s
κουκούλα	k u k u l a
ζεσταμένων	z e s t a m e n o n
εξήρα	e k s i r a
λάμψεισ	l a m p s i s
ειλημμένη	i l i m e n i
τηλεσκόπιον	t i l e s k o p i o n
εκτελέσεισ	e k t e l e s i s
ασυγχώρητοσ	a s i ŋ x o r i t o s
ζαριά	z a ɾ ʝ a
πατινάρισα	p a t i n a ɾ i s a
εμπνευσμένοσ	e m b n e v z m e n o s
επιγράφομαι	e p i ɣ r a f o m e
κοτσάριζε	k o t s a ɾ i z e
ζευσ	z e f s
πλειστηριασμόσ	p l i s t i r i a z m o s
πουδράριζε	p u ð ɾ a ɾ i z e
λεία	l i a
καθισμένε	k a θ i z m e n e
έξι	e k s i
κατακάθια	k a t a k a θ ç a
θεσσαλονίκη	θ e s a l o n i c i
φτυστόσ	f t i s t o s
έστρεψα	e s t ɾ e p s a
αξιοσημείωτο	a k s i o s i m i o t o
μαλακτικό	m a l a k t i k o
κουνουπίδι	k u n u p i ð i
στραγγίζω	s t ɾ a ŋ ɟ i z o
φοροαπαλλαγήσ	f o ɾ o a p a l a ʝ i s
γλάστρα	ɣ l a s t ɾ a
παρακείμενοι	p a r a c i m e n i
κανακεύτηκα	k a n a c e f t i k a
οσμίστηκα	o z m i s t i k a
γκεσεμιού	ɟ e s e m ɲ u
σταγόνεσ	s t a ɣ o n e s
ορίζουμε	o ɾ i z u m e
περικλείομαι	p e r i k l i o m e
αβγοκομμένησ	a v ɣ o k o m e n i s
νεκροκρέβατο	n e k ɾ o k ɾ e v a t o
φρεσκάρισε	f ɾ e s k a ɾ i s e
κάρπαθο	k a ɾ p a θ o
εβδομήκοντα	e v ð o m i k o n d a
βάφω	v a f o
αναδημιουργημένε	a n a ð i m i u r ʝ i m e n e
αυτοκινητάκι	a f t o c i n i t a c i
επικείμενοσ	e p i c i m e n o s
χαραμοφάησ	x a ɾ a m o f a i s
αποστάζομε	a p o s t a z o m e
νοητόσ	n o i t o s
κυήματοσ	c i i m a t o s
μπόλικοι	b o l i c i
σέρνω	s e r n o
βουβαλιών	v u v a ʎ o n
εγγονιών	e ŋ ɡ o ɲ o n
γλυκίσματα	ɣ l i c i z m a t a
απλούστατοσ	a p l u s t a t o s
σελήνη	s e l i n i
πολωνική	p o l o n i c i
δούναβησ	ð u n a v i s
προκόβω	p ɾ o k o v o
αγάνταρε	a ɣ a n d a r e
τροχονόμοσ	t ɾ o x o n o m o s
πανηγύρι	p a n i ʝ i ɾ i
επαρχίεσ	e p a ɾ ç i e s
ραμολιμέντο	ɾ a m o l i m e n d o
κανακέψτε	k a n a c e p s t e
εὔχομαι	e f x o m e
αποτραπήκαν	a p o t ɾ a p i k a n
ανατραπήκανε	a n a t ɾ a p i k a n e
ικανοποιημένου	i k a n o p i i m e n u
ήσανε	i s a n e
γαργαλεύω	ɣ a ɾ ɣ a l e v o
περίπλουσ	p e r i p l u s
κρίνο	k r i n o
μπανιερίτσα	b a ɲ e ɾ i t s a
συνηθισμένου	s i n i θ i z m e n u
δημοκρατίεσ	ð i m o k r a t i e s
μοίρα	m i r a
εισέπλευσα	i s e p l e f s a
ξέγραψα	k s e ɣ r a p s a
αποκαλύπτουμε	a p o k a l i p t u m e
γιαννούλα	ʝ a n u l a
θέματοσ	θ e m a t o s
άμαθοσ	a m a θ o s
λυσσώ	l i s o
καλομαθημένησ	k a l o m a θ i m e n i s
στείβω	s t i v o
αγγαρεύτηκα	a ŋ ɡ a ɾ e f t i k a
μοιρασμένουσ	m i ɾ a z m e n u s
αβγοκομμένοσ	a v ɣ o k o m e n o s
πλάγιασα	p l a ʝ a s a
αίασ	e a s
ιταλική	i t a l i k i
πρωταγωνιστών	p ɾ o t a ɣ o n i s t o n
σταμάτηδων	s t a m a t i ð o n
μύρρο	m i ɾ o
τζόρτζια	d z o ɾ d z i a
στισ	s t i s
πρησμένοι	p ɾ i z m e n i
εξετέλεσα	e k s e t e l e s a
μπερδεμένου	b e ɾ ð e m e n u
εκτρέπουμε	e k t ɾ e p u m e
εκκλησία	e k l i s i a
μάτα	m a t a
μαζικόσ	m a z i k o s
ήβη	i v i
πίσω	p i s o
εκπληκτικά	e k p l i k t i k a
τησ	t i s
μάϊσνερ	m a i z n e r
λουιζιάνα	l u i z i a n a
προβλέπομαι	p ɾ o v l e p o m e
κωνσταντίνασ	k o n s t a n d i n a s
ψωμί	p s o m i
θρησκόληπτοσ	θ ɾ i s k o l i p t o s
λατρεύομαι	l a t ɾ e v o m e
αγιοποιημένε	a ʝ i o p i i m e n e
χρονολογίεσ	x r o n o l o ʝ i e s
θερμοδυναμικό	θ e r m o ð i n a m i k o
φραγκοστάφυλο	f ɾ a ŋ ɡ o s t a f i l o
πρωτοανακαλύπτομαι	p ɾ o t o a n a k a l i p t o m e
περιοδική	p e r i o ð i c i
έλκομαι	e l k o m e
προήρθα	p r o i r θ a
ματοβαμμένοσ	m a t o v a m e n o s
αναλογίζομαι	a n a l o ʝ i z o m e
ποικίλα	p i c i l a
ψηφιακέσ	p s i f i a c e s
αναφαίρετοσ	a n a f e r e t o s
ζεσταμένη	z e s t a m e n i
απαρχαιωμένοσ	a p a r ç e o m e n o s
περιέγραψα	p e ɾ i e ɣ r a p s a
αγγισμένου	a ŋ ɟ i z m e n u
αναγνωρισμένουσ	a n a ɣ n o r i z m e n u s
ἀντιγραφείσ	a n d i ɣ ɾ a f i s
ακούομαι	a k u o m e
μεσαιωνικήσ	m e s e o n i c i s
κακογαμημένουσ	k a k o ɣ a m i m e n u s
κορίτσαροσ	k o r i t s a r o s
δημητράκησ	ð i m i t ɾ a c i s
γενέσεων	ʝ e n e s e o n
επίδαυρο	e p i ð a v ɾ o
καλύπτουμε	k a l i p t u m e
ακατάσβεστοσ	a k a t a z v e s t o s
κοτσάρω	k o t s a ɾ o
νεκροστάσιο	n e k ɾ o s t a s i o
γενιάσ	ʝ e ɲ a s
κωστήσ	k o s t i s
λιόψωμα	ʎ o p s o m a
καλύπτω	k a l i p t o
σαγηνευτικόσ	s a ʝ i n ɛ f t i k ɔ s
κραγμένησ	k r a ɣ m e n i s
γαλακτοκομείο	ɣ a l a k t o k o m i o
κίμωλο	c i m o l o
ανταμοιβή	a n d a m i v i
ενοχλητικά	e n o x l i t i k a
αφηγητήσ	a f i ʝ i t i s
αναστρέφομε	a n a s t ɾ e f o m e
ψαρεύτηκα	p s a ɾ e f t i k a
αγαπημένου	a ɣ a p i m e n u
ακοομετρία	a k o o m e t r i a
κάμπτω	k a m p t o
βουλιάζω	v u ʎ a z o
θήβεσ	θ i v e s
υπογράφομε	i p o ɣ r a f o m e
τήνοσ	t i n o s
βασανιστήριο	v a s a n i s t i ɾ i o
οφθαλμόσ	o f θ a l m o s
ωμέγα	o m e ɣ a
χειλέων	ç i l e o n
καθισμένουσ	k a θ i z m e n u s
αναμένει	a n a m e n i
αλευρωμένοι	a l e v r o m e n i
σκύβω	s c i v o
ζωώδησ	z o o ð i s
πουστάκι	p u s t a c i
αναποδιάζω	a n a p o ð ʝ a z o
κυνηγημένου	c i n i ʝ i m e n u
μετατράπηκα	m e t a t ɾ a p i k a
σάπιοσ	s a p ç o s
ποίηση	p i i s i
καλοφάγωτο	k a l o f a ɣ o t o
συγχάρηκαν	s i ŋ x a ɾ i k a n
τιτάνεσ	t i t a n e s
χάβω	x a v o
ἐνεγράφην	e n e ɣ r a f i n
κλέβω	k l e v o
ξεχνώ	k s e x n o
πέμπουμε	p e m b u m e
συνήθησ	s i n i θ i s
εθνεγερσία	e θ n e ʝ e r s i a
ἀνέγραψα	a n e ɣ r a p s a
διασκελίζω	ð i a s c e l i z o
πουλί	p u l i
μπόλικη	b o l i c i
κομμένε	k o m e n e
κόκκινα	k o c i n a
επαρκέστεροσ	e p a ɾ c e s t e ɾ o s
αναγεννάω	a n a ʝ e n a o
κάπνισα	k a p n i s a
μπερδεμένε	b e ɾ ð e m e n e
συνθλίβομαι	s i n θ l i v o m e
αγγλοφέρνω	a ŋ ɡ l ɔ f e r n ɔ
υποκύπτω	i p o c i p t o
εκχέουμε	e k ç e u m e
αμοργέ	a m o ɾ ʝ e
άνδροσ	a n ð ɾ o s
μπούρδεσ	b u ɾ ð e s
μπογιατζήσ	b o ʝ a n d z i s
αναμμένε	a n a m e n e
διάνυσα	ð i a n i s a
αλείφομαι	a l i f o m e
ολάκεροσ	o l a c e r o s
ζέλντα	z e l d a
επιστρέφομαι	e p i s t ɾ e f o m e
βλαμμένουσ	v l a m e n u s
πρέπει	p ɾ e p i
κόκκινοσ	k o c i n o s
βυθισμένεσ	v i θ i z m e n e s
στιμμένων	s t i m e n o n
ουσιαστικοποίηση	u s i a s t i k o p i i s i
κάλυψα	k a l i p s a
αποκέντρωση	a p o c e n d ɾ o s i
υπολογιστικέσ	i p o l o ʝ i s t i c e s
αγονία	a ɣ o n i a
πεπεισμένου	p e p i z m e n u
ανασκάβουμε	a n a s k a v u m e
ξαραχνιάζομαι	k s a ɾ a x ɲ a z o m e
ακοομέτρων	a k o o m e t r o n
ηγουμενίτσα	i ɣ u m e n i t s a
άρκανσασ	a ɾ k a n z a s
ηλικιωμένε	i l i c i o m e n e
αλαφιασμένουσ	a l a f ç a z m e n u s
εξώστησ	e k s o s t i s
γραφείο	ɣ ɾ a f i ɔ
ανιδρύθηκα	a n i ð r i θ i k a
γιατρεύω	ʝ a t ɾ e v o
ζητιανεύτε	z i t ç a n e f t e
συγκινημένουσ	s i ŋ ɟ i n i m e n u s
αλληλοσυγκρουόμενου	a l i l o s i ŋ ɡ r u o m e n u
κότσαρα	k o t s a ɾ a
επανειλημμένοι	e p a n i l i m e n i
ευθυμιών	e f θ i m i o n
σκατά	s k a t a
μπανιερούλα	b a ɲ e ɾ u l a
ήρα	i r a
λέγομε	l e ɣ o m e
έρρινα	e r i n a
γιουγκοσλαβία	ʝ u ɡ o z l a v i a
αλητεύω	a l i t e v o
πύργοι	p i r ʝ i
μαλάκα	m a l a k a
μαλακισμένοι	m a l a c i z m e n i
γνωρίζω	ɣ n o ɾ i z o
διαλελυμένε	ð i a l e l i m e n e
προμήθευσα	p ɾ ɔ m i θ e f s a
άκουσεσ	a k u s e s
στειμμένησ	s t i m e n i s
αλήτεψα	a l i t e p s a
ιερουσαλήμ	i e ɾ u s a l i m
γονυπετών	ɣ o n i p e t o n
ενημερώσεωσ	e n i m e r o s e o s
μυρωμένα	m i r o m e n a
αγιοπούλι	a ʝ o p u l i
ανατράπηκαν	a n a t ɾ a p i k a n
ταλαντούχοσ	t a l a n d u x o s
θερμοκρασία	θ ɛ ɾ m ɔ k ɾ a s i a
λαβών	l a v o n
απαρχαιωμένουσ	a p a r ç e o m e n u s
ανέπνευσα	a n e p n e f s a
κουρασμένησ	k u r a z m e n i s
φοροαπαλλαγέσ	f o ɾ o a p a l a ʝ e s
καλή	k a l i
πιγκουίνοσ	p i ŋ ɡ u i n o s
τάφρου	t a f r u
εγγόνι	e ŋ ɡ o n i
οπερέτα	o p e ɾ e t a
γελώ	ʝ e l o
καλμάρισε	k a l m a ɾ i s e
χαράζει	x a ɾ a z i
ορίζομε	o ɾ i z o m e
σκληρόσ	s k l i ɾ o s
κρίνου	k r i n u
ενσκήπτω	e n s c i p t o
είχαν	i x a n
ψηφίζουμε	p s i f i z u m e
σωματικόσ	s o m a t i k o s
λυκανθρωπία	l i k a n θ ɾ o p i a
κάτασπρη	k a t a s p ɾ i
αμπλαούμπλασ	a b l a u b l a s
νοστίμεψα	n o s t i m e p s a
κραυγάζω	k r a v ɣ a z o
δώρων	ð o r o n
τραπέζι	t ɾ a p e z i
περίπλου	p e r i p l u
βασανίζομαι	v a s a n i z o m e
βούληση	v u l i s i
στεναγμόσ	s t e n a ɣ m o s
σορούσ	s o ɾ u s
υψηλότατοσ	i p s i l o t a t o s
δαγκάθηκα	ð a ŋ ɡ a θ i k a
ξενοδοχοϋπάλληλοσ	k s e n o ð o x o i p a l i l o s
γιατρόσ	ʝ a t r o s
παρφουμάρισα	p a ɾ f u m a ɾ i s a
εκτελέστηκα	e k t e l e s t i k a
οφιοειδείσ	o f i o i ð i s
καταντώ	k a t a n d o
βίτσιο	v i t s ç o
φυτικούσ	f i t i k u s
αγγίζω	a ŋ ɟ i z o
αξίζει	a k s i z i
φτιάχτηκα	f t ç a x t i k a
παρκαρίστηκα	p a ɾ k a ɾ i s t i k a
ξοδεύομαι	k s o ð e v o m e
βεγγαλικό	v e ŋ ɡ a l i k o
γένεση	ʝ e n e s i
απετράπησαν	a p e t ɾ a p i s a n
εθνάρχη	e θ n a r ç i
πολωνικών	p o l o n i k o n
αμαθειών	a m a θ i o n
μαγειρεύω	m a ʝ i ɾ e v o
λεβαδειά	l e v a ð ʝ a
ερχόμενου	e r x o m e n u
ηδονίστηκα	i ð o n i s t i k a
λύθηκαν	l i θ i k a n
πράσινοσ	p ɾ a s i n o s
πουθενά	p u θ e n a
φωτογραφούμαι	f o t o ɣ r a f u m e
σώπασα	s o p a s a
φυτικοῦ	f i t i k u
προσευχή	p ɾ o s e f ç i
θήτα	θ i t a
κουραστικέ	k u r a s t i c e
ηλίθιοσ	i l i θ i o s
πατσαβούρα	p a t s a v u ɾ a
μάζεψε	m a z e p s e
επανακάμψεισ	e p a n a k a m p s i s
κίτροσ	c i t ɾ o s
κινδυνεύετε	c i n ð i n e v e t e
θαυμάζουμε	θ a v m a z u m e
σέρνομαι	s e r n o m e
βλάφθηκα	v l a f θ i k a
θεόδωροσ	θ ɛ ɔ ð ɔ ɾ ɔ s
αβγοκομμένεσ	a v ɣ o k o m e n e s
συγγράφηκα	s i ŋ ɣ r a f i k a
χρειάσθηκα	x ɾ i a s θ i k a
γκάστρωμα	ɡ a s t ɾ o m a
αεροπλανοφόρον	a e ɾ o p l a n o f o ɾ o n
καλαμπόκι	k a l a m b o c i
ασπάστηκα	a s p a s t i k a
συγκοπή	s i ŋ ɡ o p i
βδελυγμάτων	v ð e l i ɣ m a t o n
επιγράφτηκα	e p i ɣ r a f t i k a
μεσημβρία	m e s i m v r i a
χαλάω	x a l a o
ποικιλότερουσ	p i c i l o t e r u s
αποκλεισμένων	a p o k l i z m e n o n
γαμημένη	ɣ a m i m e n i
πρόκυψε	p r o c i p s e
πιπί	p i p i
αγιοποιημένο	a ʝ i o p i i m e n o
χιονάνθρωποσ	ç ɔ n a n θ ɾ ɔ p ɔ s
κιμάσ	c i m a s
πρωτεύων	p ɾ ɔ t e v o n
σημαδεύω	s i m a ð e v o
πλίνθου	p l i n θ u
καπνοδόχε	k a p n o ð o ç e
ματοβαμμένεσ	m a t o v a m e n e s
προπονήσεωσ	p r o p o n i s e o s
ψάρεψα	p s a ɾ e p s a
γιορτή	ʝ o r t i
άγγιξα	a ŋ ɟ i k s a
χορεύτε	x o ɾ e f t e
τσόγλανοσ	t s o ɣ l a n o s
λεξιπλασιών	l e k s i p l a s i o n
χτήνοσ	x t i n o s
απόκλεισα	a p o k l i s a
αναγράφω	a n a ɣ r a f o
τετριμμένη	t e t r i m e n i
φωτογραφήσεισ	f o t o ɣ r a f i s i s
κόκκινο	k o c i n o
μικρό	m i k ɾ o
έσταξα	e s t a k s a
παγωμένων	p a ɣ o m e n o n
επανιδρύω	e p a n i ð r i o
δεήθηκα	ð e i θ i k a
πειραματίστηκα	p i ɾ a m a t i s t i k a
συναιρέσεωσ	s i n e r e s e o s
αβγάτισα	a v ɣ a t i s a
πρεσάρω	p ɾ e s a ɾ o
αλώνι	a l o n i
αβάρα	a v a ɾ a
πατσαβουρόπιτεσ	p a t s a v u ɾ o p i t e s
σούρθηκα	s u r θ i k a
αξιωματικόσ	a k s i o m a t i k o s
πλέκομε	p l e k o m e
ντελιβεράσ	d e l i v e r a s
αναισθησία	a n e s θ i s i a
κλεισμένου	k l i z m e n u
μυτάκι	m i t a c i
βουβαλιού	v u v a ʎ u
αεροφωτογραφήσεισ	a e r o f o t o ɣ r a f i s i s
μεταφρασιολογίασ	m e t a f r a s i o l o ʝ i a s
στρίβω	s t ɾ i v o
μυρωμένουσ	m i r o m e n u s
σημειωθήκανε	s i m i o θ i k a n e
έναντι	e n a n d i
δύσκολοσ	ð i s k o l o s
μάντευ'	m a n d e f
ανανάδεσ	a n a n a ð e s
μαζεύτηκα	m a z e f t i k a
κριτσίνι	k r i t s i n i
υπεροχή	i p e ɾ o ç i
έσφυζα	e s f i z a
ἀττικίζουσα	a t i c i z u s a
τρομαγμένοι	t ɾ o m a ɣ m e n i
σπιτικό	s p i t i k o
επαλείφω	e p a l i f o
κόμησ	k o m i s
κουταμάρα	k u t a m a ɾ a
κωλοτρυπίδα	k o l o t r i p i ð a
παρελθόντα	p a r e l θ o n d a
αρκώ	a ɾ k o
επέστρεψα	e p e s t ɾ e p s a
γιαγιά	ʝ a ʝ a
αναστεναγμόσ	a n a s t e n a ɣ m o s
ομοφυλόφιλοσ	o m o f i l o f i l o s
θεόσ	θ e o s
προβλήματα	p r ɔ v l i m a t a
δισ	ð i s
έκπληξη	ɛ k p l i k s i
κρότοσ	k r o t o s
εγκαθιδρύω	e ŋ ɡ a θ i ð r i o
μητρικόσ	m i t r i k o s
αξιοσημείωτοσ	a k s i o s i m i o t o s
αθήνα	a θ i n a
λυγξ	l i ŋ k s
ποικιλότερα	p i c i l o t e r a
μεσαιωνικών	m e s e o n i k o n
αγγόνια	a ŋ ɡ o ɲ a
ιδρύθηκα	i ð r i θ i k a
μαθημένη	m a θ i m e n i
μουσκεμένοσ	m u s c e m e n o s
απόπλουσ	a p o p l u s
φρεσκάριζε	f ɾ e s k a ɾ i z e
ιδρυμάτων	i ð r i m a t o n
ακομπανιάρισα	a k o m p a ɲ a ɾ i s a
ερρίνωσ	e r i n o s
αρρωστημένοσ	a r o s t i m e n o s
μαγκάκι	m a ŋ ɡ a c i
αναγράφουμε	a n a ɣ r a f u m e
οδού	o ð u
δεσπότησ	ð e s p o t i s
μπιζάρω	b i z a ɾ o
λυθούν	l i θ u n
μοιράζομαι	m i ɾ a z o m e
μπαρκάριζα	b a ɾ k a ɾ i z a
χαίρε	ç e r e
ανεπάρκεια	a n e p a ɾ c i a
ορθόδοξη	o ɾ θ o ð o k s i
ξαναγράφτηκα	k s a n a ɣ ɾ a f t i k a
αποκερματισμούσ	a p o c e ɾ m a t i z m u s
ανακρούομαι	a n a k r u o m e
αγιοποιημένοι	a ʝ i o p i i m e n i
αναγνωσιμότητα	a n a ɣ n o s i m o t i t a
αχάριστοσ	a x a ɾ i s t o s
διαμηνύω	ð i a m i n i o
ημερεύετε	i m e ɾ e v e t e
αλιεύομαι	a l i e v o m e
ότι	o t i
σαλεύω	s a l e v o
απελπισμένη	a p e l p i z m e n i
εξελέγην	e k s e l e ʝ i n
δυσθυμία	ð i s θ i m i a
αθεϊσμό	a θ e i z m o
γκαστρώνομαι	ɡ a s t ɾ o n o m e
ανθρακιά	a n θ r a c a
νεκρομαντεία	n e k ɾ o m a n d i a
βρίζω	v ɾ i z o
αγγισμένουσ	a ŋ ɟ i z m e n u s
χεσμένου	ç e z m e n u
αγανακτισμένοσ	a ɣ a n a k t i z m e n o s
θεωρία	θ e o r i a
κακογαμημένεσ	k a k o ɣ a m i m e n e s
ανανήφω	a n a n i f o
επανειλημμένωσ	e p a n i l i m e n o s
πίστεψα	p i s t e p s a
ξενιτιά	k s e n i t ʝ a
αποτραπήκανε	a p o t ɾ a p i k a n e
μπερδεύομαι	b e ɾ ð e v o m e
στυμμένεσ	s t i m e n e s
παρακείμενουσ	p a ɾ a c i m e n u s
ποικίλη	p i c i l i
σημειώνω	s i m i o n o
κενοτάφιο	c e n o t a f i o
ελκύομε	e l c i o m e
γέννηση	ʝ e n i s i
κακογαμημένοσ	k a k o ɣ a m i m e n o s
απασχολημένουσ	a p a s x o l i m e n u s
κλάσιμο	k l a s i m o
αγγιγμένα	a ŋ ɟ i ɣ m e n a
κίμωλε	c i m o l e
κουραστική	k u r a s t i c i
το	t o
δημοσιεύθηκα	ð i m o s i e f θ i k a
μαυροπουλιού	m a v r o p u ʎ u
φωτογραφίζομε	f o t o ɣ r a f i z o m e
αληθεύτηκα	a l i θ e f t i k a
αποστάλθηκα	a p o s t a l θ i k a
κάλμαρα	k a l m a ɾ a
νεκροί	n e k ɾ i
κάθετοσ	k a θ e t o s
τόσοι	t o s i
ανελκύστηκα	a n e l c i s t i k a
αποκόβομαι	a p o k o v o m e
μαραθώνασ	m a ɾ a θ o n a s
προηγούμενο	p r o i ɣ u m e n o
αντικλεπτικού	a n d i k l e p t i k u
μπερδεμένησ	b e ɾ ð e m e n i s
διαλελυμένων	ð i a l e l i m e n o n
σορού	s o ɾ u
γονυπετή	ɣ o n i p e t i
ακούγοντασ	a k u ɣ o n d a s
κιονόκρανο	c i o n o k r a n o
εκκρούομε	e k r u o m e
λυμένοσ	l i m e n o s
πανεύκολοσ	p a n e f k o l o s
αιχμαλωτίστηκα	e x m a l o t i s t i k a
νι	n i
κουραστικών	k u r a s t i k o n
εξοχότατοσ	e k s o x o t a t o s
λάκωνα	l a k o n a
νοστιμεύω	n o s t i m e v o
φωτογραφούμε	f o t o ɣ r a f u m e
πρήζω	p ɾ i z o
σουταρίστηκα	p o n d a ɾ i s t i k a
σιγκαπούρη	s i ŋ ɡ a p u ɾ i
λιγότερεσ	l i ɣ o t e r e s
τρίτοσ	t ɾ i t o s
αγχώνω	a ŋ x o n o
νοστιμίζω	n o s t i m i z o
γεννών	ʝ e n o n
προκύπτει	p r o c i p t i
πλέον	p l e o n
φημίζομαι	f i m i z o m e
λάρνακα	l a ɾ n a k a
αλευρωμένα	a l e v r o m e n a
απελπισμένε	a p e l p i z m e n e
παραδεκτόσ	p a ɾ a ð e k t o s
ἀρχαΐζω	a r x a i z o
σπιτήσιοσ	s p i t i s i o s
εξοπλισμένε	e k s o p l i z m e n e
μεσαιωνική	m e s e o n i c i
αναμαλλιασμένη	a n a m a ʎ a z m e n i
προσελκύω	p r o s e l c i o
αποκρύφτηκα	a p o k ɾ i f t i k a
κορόιδευα	k o ɾ o i̯ ð e v a
ηγούμενεσ	i ɣ u m e n e s
ξεκωλιάζω	k s e k o l ʝ a z o
σαπουνίστηκα	s a p u n i s t i k a
φαβορίτα	f a v o r i t a
ενρινοτήτων	e n r i n o t i t o n
βασίλισσα	v a s i l i s a
πρεζόνι	p ɾ e z o n i
σοβαρολογώ	s o v a ɾ o l o ɣ o
τσεκάρω	t s e k a ɾ o
πρησμένων	p ɾ i z m e n o n
βλαμμένε	v l a m e n e
παραειδώθηκα	p a ɾ a i ð o θ i k a
άγνωροσ	a ɣ n o ɾ o s
χεζού	ç e z u
αηδιασμένε	a i ð i a z m e n e
πακεταρίστηκα	p a c e t a ɾ i s t i k a
αποκρουστικόσ	a p o k r u s t i k o s
ικανοποιημένοι	i k a n o p i i m e n i
συνέρραψα	s i n e ɾ a p s a
τετριμμένων	t e t r i m e n o n
αναπλειστηριάζω	a n a p l i s t i r i a z o
αλληλοσυγκρουόμενα	a l i l o s i ŋ ɡ r u o m e n a
παναγιά	p a n a ʝ a
μπινελίκι	b i n e l i c i
είλκυσα	i l c i s a
νοστίμισα	n o s t i m i s a
υόρκη	i o ɾ c i
συμφυρμών	s i ɱ f i r m o n
ερρινίζω	e r i n i z o
έρρινων	e r i n o n
αισχροκέρδεια	e s x r o c e r ð i a
ισχυρισμόσ	i s ç i ɾ i z m o s
προέρχομαι	p r o e r x o m e
θερμοκοιτίδεσ	θ e r m o c i t i ð e s
αβλαβήσ	a v l a v i s
γιατρεύομαι	ʝ a t ɾ e v o m e
γρήγοροσ	ɣ r i ɣ o r o s
υποκλέπτουμε	i p o k l e p t u m e
πεπεισμένε	p e p i z m e n e
στενοχωρημένων	s t e n o x o r i m e n o n
αλέθομαι	a l e θ o m e
θεοδώρα	θ e o ð o ɾ a
αποδείχτηκα	a p o ð i x t i k a
αρχικόσ	a r ç i k o s
προηγούμενουσ	p r o i ɣ u m e n u s
μασσαλία	m a s a l i a
συγχαίρω	s i ŋ ç e r o
μητέρα	m i t e r a
αντιμεθαύριο	a n d i m e θ a v ɾ i o
εβραία	e v ɾ e a
ποικιλότατοσ	p i c i l o t a t o s
απόδειξε	a p o ð i k s e
εμπιστοσύνη	e m b i s t o s i n i
πεπεισμένησ	p e p i z m e n i s
μαγκιά	m a ŋ ɟ a
αβγοκομμένου	a v ɣ o k o m e n u
ακώλυτοσ	a k o l i t o s
άλυτοσ	a l i t o s
συμπρωταγωνιστή	s i m b ɾ o t a ɣ o n i s t i
καρδιόσχημοσ	k a ɾ ð i o s ç i m o s
στολίστηκα	s t o l i s t i k a
κλείστηκα	k l i s t i k a
προφορά	p ɾ o f o ɾ a
ανασκαλεύτηκα	a n a s k a l e f t i k a
λύκοσ	l i k o̞ s
χείλοσ	ç i l ɔ s
ανακάτεψα	a n a k a t e p s a
περιθάλπουμε	p e ɾ i θ a l p u m e
μύξα	m i k s a
συμπολεμιστήσ	s i m b o l e m i s t i s
αίτνα	e t n a
κρουστόσ	k r u s t o s
πρησμένη	p ɾ i z m e n i
σφάχτησ	s f a ç t i s
μάλωμα	m a l o m a
ταράχθηκα	t a r a x θ i k a
ακοόμετρο	a k o o m e t r o
μπουγάζια	b u ɣ a z ʝ a
ευγενία	e v ʝ e n i a
μεταπτώσεισ	m e t a p t o s i s
τρίπολη	t ɾ i p o l i
χορεύω	x o ɾ e v o
αγανακτισμένα	a ɣ a n a k t i z m e n a
έχοντασ	e x o n d a s
ρεζιλεύτηκα	ɾ e z i l e f t i k a
διαδοχή	ð ʝ a ð o ç i
προαλείφομαι	p ɾ o a l i f o m e
χαίρετε	ç e r e t e
δέων	ð e o n
βλασταίνω	v l a s t e n o
κόσμοσ	k o z m o s
στέλλα	s t e l a
φιξάρομαι	f i k s a ɾ o m e
δράκουλασ	v ɾ i k o l a k a s
κεφιών	c e f ç o n
προσθήκη	p r o s θ i c i
θλιμμένη	θ l i m e n i
κλόουν	k l o u n
μουσκεμένη	m u s c e m e n i
μυτίτσα	m i t i t s a
ντεραπάρω	d e ɾ a p a ɾ o
ανακρούω	a n a k r u o
παραγράφηκε	p a ɾ a ɣ ɾ a f i c e
ψήφοι	p s i f i
γενεά	ʝ e n e a
εγκατάλειψη	e ŋ ɡ a t a l i p s i
σωματικώσ	s o m a t i k o s
παραστέκω	p a r a s t e k o
κονέκτικατ	k o n e k t i k a t
χάφτετε	x a f t e t e
αραχνιασμένου	a ɾ a x ɲ a z m e n u
αμφιφυλόφιλοσ	a m f i f i l o f i l o s
αεροβίωση	a e ɾ o v i o s i
δροσίζω	ð ɾ o s i z o
ραγιά	ɾ a ʝ a
ευεπηρέαστοσ	e v e p i r e a s t o s
νωθρόσ	n o θ ɾ o s
πατώνω	p a t o n o
επαρκήσ	e p a ɾ c i s
καλαμποκόψωμων	k a l a m b o k o p s o m o n
πασαλείφτηκα	p a s a l i f t i k a
λιγότεροσ	l i ɣ o t e r o s
ἁγιοποιημένοσ	a ʝ i o p i i m e n o s
σταγόνασ	s t a ɣ o n a s
αξιοσημείωτου	a k s i o s i m i o t u
ευσεβέστατα	e f s e v e s t a t a
εξυπακούονταν	e k s i p a k u o n d a n
χάφτομαι	x a f t o m e
εξέλειψα	e k s e l i p s a
τσογλαναράσ	t s o ɣ l a n a ɾ a s
τόπι	t o p i
κομεντί	k o m e d i
βαλσάκια	v a l s a c a
πατιναρίστηκα	p a t i n a ɾ i s t i k a
αγίου	a ʝ i u
αβγατισμένεσ	a v ɣ a t i z m e n e s
πλειστόκαινο	p l i s t o c e n o
οπλισμένοσ	o p l i z m e n o s
αγγουριά	a ŋ ɡ u ɾ ʝ a
περίπλων	p e r i p l o n
σώζω	s o z o
κινεζοποιήσεισ	c i n e z o p i i s i s
ξένησ	k s e n i s
αλατίζω	a l a t i z o
περιστρέφομαι	p e ɾ i s t ɾ e f o m e
απολογητικήσ	a p o l o ʝ i t i c i s
σταθμεύω	s t a θ m e v o
εσωκλείω	e s o k l i o
εἰσέπλευσα	i s e p l e f s a
κολωνία	k o l o n i a
περιοδεύων	p e ɾ i o ð e v o n
καθελκύσθηκα	k a θ e l c i s θ i k a
αποκερματισμού	a p o c e ɾ m a t i z m u
παραγραφτήκανε	p a ɾ a ɣ ɾ a f t i k a n e
φασολιά	f a s o ʎ a
μυγοσκοτώστρα	m i ɣ o s k o t o s t ɾ a
πολωνέζικα	p o l o n e z i k a
παραπέμπουμε	p a ɾ a p e m b u m e
στοχάστηκα	s t o x a s t i k a
μαλακισμένο	m a l a c i z m e n o
ανατράπηκα	a n a t ɾ a p i k a
ενδιέτριψα	e n ð i e t ɾ i p s a
αχαιόσ	a ç e o s
νήσσα	n i s a
αγενήσ	a ʝ e n i s
κινεζοποιήσεων	c i n e z o p i i s e o n
επανειλημμένοσ	e p a n i l i m e n o s
εδέησα	e ð e i s a
ψιτ	p s i t
μαζικότατοσ	m a z i k o t a t o s
φωτογραφήθηκα	f o t o ɣ r a f i θ i k a
μαυροπίνακασ	m a v ɾ o p i n a k a s
συγκρουόμενεσ	s i ŋ ɡ r u o m e n e s
δεκαπέντε	ð e k a p e n d e
εγχύνω	e ŋ ç i n o
παζάρεψα	p a z a ɾ e p s a
σούρνω	s u r n o
κουπάκι	k u p a c i
αιτιοκρατία	e t i o k r a t i a
αγγαρεύω	a ŋ ɡ a ɾ e v o
λόγω	l o ɣ o
σκατήσ	s k a t i s
κρεμασμένο	k r e m a z m e n o
τρίκαλα	t ɾ i k a l a
ἀνασκάπτομεν	a n a s k a p t o m e n
κιτσαρία	c i t s a ɾ i a
έκλεισα	e k l i s a
ήτανε	i t a n e
απορρίφτηκα	a p o ɾ i f t i k a
αναδείξεισ	a n a ð i k s i s
ουσιαστικοποιήσεωσ	u s i a s t i k o p i i s e o s
κάμπτομε	k a m p t o m e
θάβομαι	θ a v o m e
φόροσ	f o ɾ o s
τυροκόμοσ	t i ɾ o k o m o s
πιθαριού	p i θ a r ʝ u
κομμένων	k o m e n o n
αποδείχθηκαν	a p o ð i x θ i k a n
χλιεσ	x ʎ e s
αλήτεψε	a l i t e p s e
μοναχόσ	m o n a x o s
ικανοποιημένεσ	i k a n o p i i m e n e s
διέπομαι	ð i e p o m e
συκοφάντησ	s i k o f a n d i s
αλευρωμένου	a l e v r o m e n u
σειέμαι	s ç e m e
αγγιγμένεσ	a ŋ ɟ i ɣ m e n e s
εικοσάρικο	i k o s a ɾ i k o
καριόλα	k a ɾ ʝ o l a
ζενίθ	z e n i θ
ειλημμένεσ	i l i m e n e s
λεσ	l e s
διαλελυμένη	ð i a l e l i m e n i
άσεβουσ	a s e v u s
λευχαιμία	l e f ç e m i a
προαλείφομε	p ɾ o a l i f o m e
ακεφιά	a c e f ç a
πειθόμενησ	p i θ o m e n i s
κεσεμιών	c e s e m ɲ o n
ζεύγουσ	z e v ɣ u s
βυθισμένοι	v i θ i z m e n i
σεβαστιανόσ	s e v a s t ç a n o s
κοινοβιάτησ	c i n o v i a t i s
μπαρκάρισα	b a ɾ k a ɾ i s a
μελιτζάνα	m e l i d͡z a n a
μπαράζ	b a ɾ a z
πλίνθε	p l i n θ e
ερχόμενουσ	e r x o m e n u s
καλομάνα	k a l o m a n a
αναστρέψιμοσ	a n a s t ɾ e p s i m o s
εκκλησιάστηκα	e k l i s i a s t i k a
προσέβλεψα	p ɾ o s e v l e p s a
αθίγγανοσ	a θ i ŋ ɡ a n o s
πιθάρι	p i θ a r i
μουντή	m u n d i
στεναχωρημένα	s t e n a x o r i m e n a
μεσαιωνικούσ	m e s e o n i k u s
απαγάγω	a p a ɣ a ɣ o
αγγλία	a ŋ ɡ l i a
ζύθοσ	z i θ ɔ s
ρίπτω	ɾ i p t o
ποικιλότατα	p i c i l o t a t a
ακούστηκε	a k u s t i k e
γκρίνιαξα	ɡ ɾ i ɲ a k s a
αήθησ	a i θ i s
φυτεύτηκα	f i t e f t i k a
πλησιάζομαι	p l i s i a z o m e
και	c e̞
πατέρεσ	p a t e r e s
λάμδα	l a m ð a
ερωτεύτηκα	e ɾ o t e f t i k a
αποσείω	a p o s i o
κακογαμημένη	k a k o ɣ a m i m e n i
συνεννόηση	s i n e n o i s i
κρίνων	k r i n o n
βραχυκύκλωμα	v ɾ a ç i c i k l o m a
άνθιμοσ	a n θ i m o s
έλυνεσ	e l i n e s
πεισμένεσ	p i z m e n e s
υποδήματα	i p o ð i m a t a
μέγασ	m e ɣ a s
δεινόσ	ð i n o s
ποντικόσ	p o n d i k o s
άκοσμοσ	a k o z m o s
αναδεικνύω	a n a ð i k n i o
υπάρχω	i p a r x o
καρέκλα	k a ɾ e k l a
υποσκάπτομε	i p o s k a p t o m e
σπρώχνομαι	s p ɾ o x n o m e
ενορχηστρώσεισ	e n o ɾ ç i s t ɾ o s i s
τσιμπουκότρυπα	t s i m b u k o t ɾ i p a
λύνατε	l i n a t e
μακαρονάδα	m a k a ɾ o n a ð a
αυνανίστηκα	a v n a n i s t i k a
ειδύλλιο	i ð i l i o
τετριμμένοι	t e t r i m e n i
κυνηγημένων	c i n i ʝ i m e n o n
αηδήσ	a i ð i s
έμποροσ	ɛ m b ɔ ɾ ɔ s
οικογενειοκρατία	i k o ʝ e n i o k ɾ a t i a
διανύομεν	ð i a n i o m e n
έβαψα	e v a p s a
ράβομαι	ɾ a v o m e
βεβαίωσ	v e v e o s
καταρρέω	k a t a r e o
καθισμένο	k a θ i z m e n o
στριμμένοσ	s t ɾ i m e n o s
εκκολάπτω	e k o l a p t o
εγκλείουμε	e ŋ ɡ l i u m e
κρήτη	k r i t i
λύομαι	l i o m e
φρένα	f r e n a
πασοκ	p a s o k
κυριακή	c i r ʝ a c i
αλάνι	a l a n i
καθικάκι	k a θ i k a c i
ακούσθηκε	a k u s θ i k e
αγυιόπαισ	a ʝ i o p e s
θερμοδυναμικών	θ e r m o ð i n a m i k o n
πολωνικό	p o l o n i k o
προσέρχομαι	p r o s e r x o m e
ποντάρισε	p o n d a ɾ i s e
λέσβο	l e z v o
ιλινόισ	i l i n o i s
τσεκαρίστηκα	p o n d a ɾ i s t i k a
θερμοδυναμικέσ	θ e r m o ð i n a m i c e s
μοιρασμένοι	m i ɾ a z m e n i
κρούομαι	k r u o m e
χιόνι	ç o n i
αντιστρέφομε	a n d i s t ɾ e f o m e
χλια	x ʎ a
αντίδραση	a n d i ð ɾ a s i
ξαγναντεύω	k s a ɣ n a n d e v o
οφιοειδήσ	o f i o i ð i s
αποκρύπτομε	a p o k ɾ i p t o m e
πύργε	p i r ʝ e
πούσταροσ	p u s t a ɾ o s
πνεύμονασ	p n e v m o n a s
σείστηκα	s i s t i k a
κατουράω	k a t u ɾ a o
τάφρων	t a f r o n
χρονολογία	x r o n o l o ʝ i a
ολόφωτεσ	o l o f o t e s
κοζάνη	k o z a n i
κονικλοτροφείο	k o n i k l o t r o f i o
λυνόσουν	l i n o s u n
κάτασπροι	k a t a s p ɾ i
μηνύω	m i n i o
σείουμε	s i u m e
ζέβρα	z e v ɾ a
ανακάμψεισ	a n a k a m p s i s
οκτώ	o k t o
αιχμαλωτίζω	e x m a l o t i z o
οργή	o r ʝ i
κορακίστικα	k o ɾ a c i s t i k a
γκρίζα	ɡ ɾ i z a
περιέκλεισα	p e r i e k l i s a
καταδύομαι	k a t a ð i o m e
αμπέλι	a m b e l i
αλατισμένο	a l a t i z m e n o
πιάνομαι	p ç a n o m e
χεσμένε	ç e z m e n e
στον	s t o n
άδεντροσ	a ð e n d ɾ o s
καπνίζομε	k a p n i z o m e
κλεισμένοι	k l i z m e n i
αγαπημένουσ	a ɣ a p i m e n u s
απασχολούμαι	a p a s x o l u m e
ντετερμινισμών	d e t e r m i n i z m o n
ακοέσ	a k o e s
σαγιονάρα	s a ʝ o n a ɾ a
σκοτώνω	s k o t o n o
πουσταράσ	p u s t a ɾ a s
αλαφιασμένα	a l a f ç a z m e n a
ακοσμία	a k o z m i a
εκκολάπτομαι	e k o l a p t o m e
ουρανικοποίηση	u r a n i k o p i i s i
ακομπανιάρομαι	a k o m p a ɲ a ɾ o m e
δυσανάγνωστοσ	ð i s a n a ɣ n o s t o s
στεναχωρημένησ	s t e n a x o r i m e n i s
όποιο	o p ç o
έρρινο	e r i n o
λευκοί	l e f c i
αποσείουμε	a p o s i u m e
χάρτησ	x a r t i s
καταιγίδων	k a t e ʝ i ð o n
κουραδόμαγκασ	k u ɾ a ð o m a ŋ ɡ a s
επωμίστηκα	e p o m i s t i k a
λυνόσουνα	l i n o s u n a
επιστρέφω	e p i s t ɾ e f o
βουλευτήσ	v u l e f t i s
καλμάριζα	k a l m a ɾ i z a
σητεία	s i t i a
οραματίστηκα	o ɾ a m a t i s t i k a
πατροκτονία	p a t ɾ o k t o n i a
βαθμολογημένη	v a θ m o l o ʝ i m e n i
φιξαρίστηκα	f i k s a ɾ i s t i k a
παρελθούσα	p a r e l θ u s a
πρωκτικόσ	p ɾ o k t i k o s
αραχνιασμένουσ	a ɾ a x ɲ a z m e n u s
ποδοσφαιριστήσ	p o ð o s f e ɾ i s t i s
σφιχταγκάλιασα	s f i x t a ŋ ɡ a ʎ a s a
δεικνύω	ð i k n i o
ομόλογοσ	o m o l o ɣ o s
ταλαίπωροσ	t a l e p o ɾ o s
ντουμπλαρίστηκα	d u b l a ɾ i s t i k a
οίκοσ	i k o s
αναστέλλω	a n a s t e l o
αναρμοδίωσ	a n a ɾ m o ð i o s
ζήλοσ	z i l o s
σοφάσ	s o f a s
καταναγκάζω	k a t a n a ŋ ɡ a z o
διέρχομαι	ð i e r x o m e
βαθμολογημένο	v a θ m o l o ʝ i m e n o
καλύφθηκα	k a l i f θ i k a
φιλοσοφική	f i l o s o f i c i
ιεράπετρα	i e ɾ a p e t ɾ a
αληθέσ	a l i θ e s
γούστο	ɣ u s t o
εγέρθητε	e ʝ e ɾ θ i t e
κύπελλο	c i p e l o
χρονολογιών	x r o n o l o ʝ i o n
καθελκύστηκα	k a θ e l c i s t i k a
μπούρδασ	b u ɾ ð a s
εδέσσησ	e ð e s i s
μοιρασμένη	m i ɾ a z m e n i
περσεύσ	p e r s e f s
αυτόσ	a f t o s
χαρτομάντησ	x a ɾ t o m a n d i s
λιμάνι	l i m a n i
συνετρίβησαν	s i n e t ɾ i v i s a n
ιλλυρικόσ	i l i ɾ i k o s
φρενάραμε	f r e n a r a m e
ψήφισμα	p s i f i z m a
χανιά	x a ɲ a
ράβω	ɾ a v o
όπισθεν	o p i s θ e n
ήμουνα	i m u n a
λέγεται	l e ʝ e t e
λυνότανε	l i n o t a n e
εξού	e k s u
έτοσ	ɛ t o s
τάρανδοσ	t a ɾ a n ð o s
διάβολε	ð ʝ a v o l e
επιγράφτηκαν	e p i ɣ r a f t i k a n
προτρέπομε	p ɾ o t ɾ e p o m e
ξόδεψα	k s o ð e p s a
ταξιδεύω	t a k s i ð e v o
βουτυρωμένα	v u t i r o m e n a
αέρισα	a e ɾ i s a
φονιάσ	f o ɲ a s
ολόμαυροσ	o l o m a v ɾ o s
προβλέπουμε	p ɾ o v l e p u m e
βρετανόσ	v r e t a n o s
ερχομένου	e r x o m e n u
πρωτομαγιά	p ɾ o t o m a ʝ a
διαισθάνθηκα	ð i e s θ a n θ i k a
χορέψατε	x o ɾ e p s a t e
ζωή	z o i
ειλημμένε	i l i m e n e
σημασία	s i m a s i a
σπίθα	s p i θ a
έθαλψα	e θ a l p s a
επαρχίασ	e p a ɾ ç i a s
στυμμένου	s t i m e n u
περιέκοψα	p e ɾ i e k o p s a
αλληλοσυγκρουόμενησ	a l i l o s i ŋ ɡ r u o m e n i s
απόρριμμα	a p o r i m a
παγκοσμιοποίησησ	p a ŋ ɡ o z m i o p i i s i s
πεθαμένησ	p e θ a m e n i s
ξεκωλιάρα	k s e k o ʎ a ɾ a
βιβλιοπωλείο	v i v l i o p o l i o
στρατοπεδεύω	s t ɾ a t o p e ð e v o
πάριζα	p a ɾ i z a
απαρχαιωμένου	a p a r ç e o m e n u
λάτρα	l a t ɾ a
κυανόσ	c i a n o s
αδρόσ	a ð r o s
σύρομαι	s i r o m e
συνεθλίβησαν	s i n e θ l i v i s a n
ώριμα	o ɾ i m a
πλίνθων	p l i n θ o n
συγκινημένη	s i ŋ ɟ i n i m e n i
αβγοκόβω	a v ɣ o k o v o
κουραστικό	k u r a s t i k o
στέλνω	s t e l n o
ακριβοπλήρωσα	a k r i v o p l i ɾ o s a
συγχάρηκε	s i ŋ x a ɾ i c e
λιβαδειά	l i v a ð ʝ a
εγγλέζα	e ŋ ɡ l e z a
ευχετικόσ	e f ç e t i k o s
θήρα	θ i ɾ a
πούστησ	p u s t i s
ιεράρχη	i e r a r ç i
ιδιωτικοποίηση	i ð i ɔ t i k ɔ p i i s i
υπολογίζουμε	i p o l o ʝ i z u m e
άστραψα	a s t ɾ a p s a
διακομιστήσ	ð i a k o m i s t i s
αγυιόπαιδου	a ʝ i o p e ð u
όλισβοσ	ɔ l i z v ɔ s
ιδρύματα	i ð r i m a t a
αγρίνιο	a ɣ r i n i o
πρωταθλητήσ	p ɾ o t a θ l i t i s
επανειλημμένων	e p a n i l i m e n o n
παππούσ	p a p u s
συμφυρμέ	s i ɱ f i r m e
κηφισιά	c i f i s j a
αναμμένεσ	a n a m e n e s
μελισσοκομείο	m e l i s o k o m i o
ενοχλητικότητα	e n o x l i t i k o t i t a
γελοίοσ	ʝ e l i o s
ματόκλαδο	m a t o k l a ð o
αίτηση	ɛ t i s i
χοντροκώλα	x o n d ɾ o k o l a
γλαστρούλα	ɣ l a s t ɾ u l a
μαυρισμένου	m a v r i z m e n u
χεβρώνα	ç e v r o n a
αγρίεψα	a ɣ ɾ i e p s a
χέλι	ç e l i
ενεργοποιώ	e n e r ɣ o p i o
πεθαμένουσ	p e θ a m e n u s
αποτρέπομαι	a p o t ɾ e p o m e
παντρεύομαι	p a n d ɾ e v o m e
σοφή	s o f i
παρακειμένουσ	p a r a c i m e n u s
λαθρέμποροσ	l a θ ɾ ɛ m b ɔ ɾ ɔ s
κρύβω	k ɾ i v o
εκδίκηση	e k ð i c i s i
μελβούρνη	m e l v u r n i
αναπαριστώ	a n a p a r i s t o
ίντσα	i n t͡s a
λύναμε	l i n a m e
γαμιόλα	ɣ a m ɲ o l a
στέκω	s t e k o
μη	m i
επιπλέον	e p i p l e o n
κάθισα	k a θ i s a
ναυσικᾶ	n a f s i k a
κακογαμημένο	k a k o ɣ a m i m e n o
ανάγκασα	a n a ŋ ɡ a s a
αλφάδιασα	a l f a ð ʝ a s a
γοητεύομαι	ɣ o i t e v o m e
χορεύουμε	x o ɾ e v u m e
έλυνα	e l i n a
καθιδρύομαι	k a θ i ð r i o m e
συνετρίβη	s i n e t ɾ i v i
διαθήκη	ð i a θ i c i
νήσε	n i s e
ολόφωτου	o l o f o t u
πιστεύετε	p i s t e v e t e
απόκρουσα	a p o k r u s a
πρεσβευτήσ	p ɾ e z v e f t i s
μαζικοί	m a z i c i
κρυμμένο	k r i m e n o
στιμμένοι	s t i m e n i
γουστάριζα	ɣ u s t a ɾ i z a
αερόμετρο	a e ɾ o m e t ɾ o
φυτικό	f i t i k o
τριακόσια	t ɾ i a k o s ç a
άσβεστοσ	a z v e s t o s
μεσαιωνικό	m e s e o n i k o
κοριτσάρασ	k o r i t s a r a s
κορίτσαρο	k o r i t s a r o
κωλόγεροσ	k o l o ʝ e ɾ o s
αναζωογονώ	a n a z o o ɣ o n o
κατεργάζομαι	k a t e r ɣ a z o m e
απαράδεκτη	a p a ɾ a ð e k t i
αχθοφόροσ	a x θ o f o r o s
γούσταρα	ɣ u s t a ɾ a
κινεζικά	c i n e z i k a
ευαγγελίζομαι	e v a ŋ ɟ e l i z o m e
εκατό	e k a t o
ἐξήρθην	e k s i r θ i n
βγάζω	v ɣ a z o
έπρεπε	e p ɾ e p e
περιοδικό	p e r i o ð i k o
ψηφοφορία	p s i f o f o ɾ i a
δαγκάσει	ð a ŋ ɡ a s i
προσβλέπω	p ɾ o s v l e p o
μάρκαρα	m a ɾ k a ɾ a
ακρίτησ	a k r i t i s
αναδεικνύομαι	a n a ð i k n i o m e
είχε	i ç e
ψωμάκια	p s o m a c i a
αλήθεψα	a l i θ e p s a
συγχαρήκαν	s i ŋ x a ɾ i k a n
σώπασε	s o p a s e
λύσω	l i s o
ανελκύω	a n e l c i o
γλωσσίτσα	ɣ l o s i t s a
ἐπέστρεψα	e p e s t ɾ e p s a
ενισχύω	e n i s ç i o
εκβιασμόσ	e ɡ v i a z m o s
σκέφτομαι	s c e f t o m e
στοχάζομαι	s t o x a z o m e
μονάρχεσ	m o n a r ç e s
μαυρισμένοι	m a v r i z m e n i
θαρραλέοσ	θ a r a l e o s
αντεύχομαι	a n d e f x o m e
προσέλκυσα	p r o s i l c i s a
ασελγήσ	a s e l ʝ i s
μαλακισμένου	m a l a c i z m e n u
εκλάπην	e k l a p i n
διάτανοσ	ð ʝ a t a n o s
αθεϊστήσ	a θ ɛ i s t i s
ισόπλευροσ	i s o p l e v r o s
φρεσκάριζα	f r e s k a r i z a
απόλυσα	a p o l i s a
έχετε	e ç e t e
ξαλεγράρω	k s a l e ɣ ɾ a ɾ o
αγιοπούλια	a ʝ o p u ʎ a
τον	t o n
σοφίεσ	s o f i e s
σημάδεψα	s i m a ð e p s a
κρεμώ	k r e m o
κρεμῶ	k r e m o
πάμμαυρου	p a m a v ɾ u
συνέθλιψε	s i n e θ l i p s e
μοιράστηκα	m i ɾ a s t i k a
ναζιάρα	n a z ʝ a ɾ a
όζοσ	o z o s
αποδεικνύω	a p o ð i k n i o
βάφομαι	v a f o m e
εόρτασα	e o ɾ t a s a
είχανε	i x a n e
μπονατσάρισε	b o n a t s a ɾ i s e
υλοζωισμόσ	i l o z o i z m o s
λυμένη	l i m e n i
εσώκλεισα	e s o k l i s a
απέχθεια	a p e x θ i a
αιτία	ɛ t i a
αναβαλλόμενε	a n a v a l o m e n e
κρυμμένη	k r i m e n i
συναιρέσεισ	s i n e r e s i s
εγγίζω	e ŋ ɟ i z o
δυόμισι	ð ʝ o m i s i
αναθάρρεψα	a n a θ a ɾ e p s a
παλιατζήσ	p a ʎ a d z i s
περιοδικήσ	p e r i o ð i c i s
αποτρέπουμε	a p o t ɾ e p u m e
τρωάδα	t r o a ð a
αρετή	a r e t i
λύσετε	l i s e t e
μπάντα	b a n d a
ἐγκαθιδρύομαι	e ŋ ɡ a θ i ð r i o m e
κατάστρεψα	k a t a s t ɾ e p s a
σαγηνεύω	s a ʝ i n e v o
τάφροσ	t a f r o s
καταξοδεύτηκα	k a t a k s o ð e f t i k a
σφυρί	s f i r i
καλαμάτα	k a l a m a t a
εντυπωσιακόσ	e n d i p o s i a k o s
έραψα	e ɾ a p s a
τεσσερισήμισι	t e s e ɾ i s i m i s i
αστράφτω	a s t ɾ a f t o
καθιζάνω	k a θ i z a n o
προηγούμενοσ	p ɾ o i ɣ u m e n o s
λύνει	l i n i
επεγράφη	e p e ɣ r a f i
εορτάζουμε	e o ɾ t a z u m e
απαρχαιωμένη	a p a r ç e o m e n i
καταστρέφομε	k a t a s t ɾ e f o m e
σημάδι	s i m a ð i
απέλυσα	a p e l i s a
ἀποκυημάτων	a p o c i i m a t o n
τιτάνων	t i t a n o n
ξανάγραψα	k s a n a ɣ ɾ a p s a
πίτασ	p i t a s
σάλεψα	s a l e p s a
έτρεμα	e t r e m a
ήταν	i t a n
εξάλειψα	e k s a l i p s a
τανάγρα	t a n a ɣ ɾ a
κυνηγημένεσ	c i n i ʝ i m e n e s
υπέγραψα	i p e ɣ r a p s a
ανετράπησαν	a n e t ɾ a p i s a n
καθισμένεσ	k a θ i z m e n e s
πρεσαρίστηκα	p ɾ e s a ɾ i s t i k a
σάλταρε	s a l t a ɾ e
κατάμαυροι	k a t a m a v ɾ i
ανάγκησ	a n a ŋ ɟ i s
πολωνέζεσ	p o l o n e z e s
παρεγράφην	p a ɾ e ɣ ɾ a f i n
γλείφω	ɣ l i f o
απόκοψα	a p o k o p s a
μαυρισμένουσ	m a v r i z m e n u s
τσακώνικο	t s a k o n i k o
τάφρε	t a f r e
ρετσίνα	ɾ e t s i n a
μέγαρα	m e ɣ a ɾ a
σπιτική	s p i t i c i
κρούω	k r u o
τίνοσ	t i n o s
μένε	m e n e
σώπα	s o p a
ντροπιασμένουσ	d ɾ o p ç a z m e n u s
ακουστικόσ	a k u s t i k o s
έκταση	e k t a s i
ακροχορδών	a k ɾ o x o ɾ ð o n
αβανγκάρντ	a v a ŋ ɡ a ɾ d
δημοκρατία	ð i m o k r a t i a
μαζεύω	m a z e v o
περικόπτομε	p e ɾ i k o p t o m e
ζητιάνεψε	z i t ç a n e p s e
παρελθούσασ	p a r e l θ u s a s
ταχυφαγείο	t a ç i f a ʝ i o
ακοντίσθηκα	a k o n d i s θ i k a
μυγάκι	m i ɣ a c i
αηδιάζω	a i ð i a z o
κουραδομηχανή	k u ɾ a ð o m i x a n i
χορεύουν	x o ɾ e v u n
κεφαλάρι	c e̞ f a l a r i
αλαμπουρνέζικεσ	a l a b u r n e z i c e s
λάμπα	l a m b a
γαργαλιέμαι	ɣ a ɾ ɣ a ʎ e m e
τεμπελιάζω	t e m b e ʎ a z o
ντουντούκα	d u d u k a
παραβλέπουμε	p a ɾ a v l e p u m e
πουτανάκι	p u t a n a c i
λιγοστόσ	l i ɣ o s t o s
αναγνωρισμένεσ	a n a ɣ n o r i z m e n e s
μαστίζομαι	m a s t i z o m e
εξαναγκάζομε	e k s a n a ŋ ɡ a z o m e
στενοχωρημένου	s t e n o x o r i m e n u
φαΐ	f a i
αγιοποιημένου	a ʝ i o p i i m e n u
λύστε	l i s t e
αμφιδέξιοσ	a m f i ð e k s i o s
χι	ç i
χαλασμένα	x a l a z m e n a
μπερδεμένουσ	b e ɾ ð e m e n u s
στερήσεων	s t e ɾ i s e o n
τάφηκα	t a f i k a
ηλικιωμένη	i l i c i o m e n i
ευθυμίασ	e f θ i m i a s
λειψανοθήκη	l i p s a n o θ i c i
αποκλείομαι	a p o k l i o m e
κρεβατομουρμούρα	k ɾ e v a t o m u ɾ m u ɾ a
πίνουμε	p i n u m e
έλυσεσ	e l i s e s
δήμητρα	ð i m i t ɾ a
παραλογίζομαι	p a ɾ a l o ʝ i z o m e
περικόπτω	p e ɾ i k o p t o
δίεση	ð i e s i
ασπάζομαι	a s p a z o m e
ανανάσ	a n a n a s
σταμάτησ	s t a m a t i s
αναγεννησιακή	a n a ʝ e n i s i a c i
τρυγόνι	t r i ɣ o n i
υποκλάπηκα	i p o k l a p i k a
σπουργίτι	s p u ɾ ʝ i t i
πολωνέζα	p o l o n e z a
καλοήθησ	k a l o i θ i s
προέβλεψα	p ɾ o e v l e p s a
φωτογράφησα	f o t o ɣ ɾ a f i s a
επιλογή	ɛ p i l ɔ ʝ i
τέχνη	t e x n i
περιγράφηκα	p e ɾ i ɣ r a f i k a
μεσημβρίαν	m e s i m v r i a n
νιάτων	ɲ a t o n
λιμπίζομαι	l i m b i z o m e
σβηστηριού	z v i s t i ɾ ʝ u
αναστενάζω	a n a s t e n a z o
λακώνων	l a k o n o n
ξεγράφω	k s e ɣ r a f o
πολωνικόσ	p o l o n i k o s
χαλασμένων	x a l a z m e n o n
ντουλάπι	d u l a p i
ζωντάνεψα	z o n d a n e p s a
σκυλίτσα	s c i l i t s a
πατινάρομαι	p a t i n a ɾ o m e
στέρησησ	s t e ɾ i s i s
καλοφάγωτη	k a l o f a ɣ o t i
αφτί	a f t i
εκπνέω	e k p n e o
πακέτο	p a c e t o
κωσ	k o s
μάζεψα	m a z e p s a
χάχασ	x a x a s
αγιοποιημένουσ	a ʝ i o p i i m e n u s
γύροσ	ʝ i r o s
πασ	p a s
βλακεία	v l a c i a
γράμμα	ɣ r a m a
φωτογραφείο	f o t o ɣ r a f i a
σαλτάριζε	s a l t a ɾ i z e
αναστέναξα	a n a s t e n a k s a
ξεψυχώ	k s e p s i x o
σκευοθήκη	s c e v o θ i c i
πλίνθο	p l i n θ o
φλερτάρω	f l e r t a r o
θεούλησ	θ e u l i s
φαρσί	f a r s i
χαίρω	ç e r o
μεσαιωνικοί	m e s e o n i c i
μαζικότερο	m a z i k o t e r o
πόρδοσ	p o ɾ ð o s
μουσκεμένεσ	m u s c e m e n e s
έχε	e ç e
καταναγκάζομε	k a t a n a ŋ ɡ a z o m e
προϊόν	p ɾ o i o n
φράζω	f r a z o
παγκοσμιοποίηση	p a ŋ ɡ o z m i o p i i s i
κανακεύομαι	k a n a c e v o m e
μαλώνοντασ	m a l o n o n d a s
ποικιλότατε	p i c i l o t a t e
θεούσα	θ e u s a
μαρκάριζε	m a ɾ k a ɾ i z e
κλέψασ	k l e p s a s
γκάιντα	ɡ a i d a
ποντάρομαι	p o n d a ɾ o m e
εγκαθιδρύομε	e ŋ ɡ a θ i ð r i o m e
διαδοχικόσ	ð ʝ a ð o ç i k o s
αυτοκτονία	a f t o k t o n i a
κάμφθηκα	k a m f θ i k a
αγλαόσ	a ɣ l a o s
αγγελοκρούουμε	a ŋ ɟ e l o k r u u m e
γαμημένων	ɣ a m i m e n o n
κουραστικού	k u r a s t i k u
παρφουμαρίζομαι	p a ɾ f u m a ɾ i z o m e
παθαίνομαι	p a θ e n o m e
αλείφω	a l i f o
απαλείφομαι	a p a l i f o m e
ανεκκαθάριστοσ	a n e k a θ a ɾ i s t o s
κλεισμένα	k l i z m e n a
εκτέλεση	e k t e l e s i
τιμόνι	t i m o n i
υποκρύπτουμε	i p o k ɾ i p t u m e
χαλασμένησ	x a l a z m e n i s
σημειώθηκαν	s i m i o θ i k a n
ὑπεγράφην	i p e ɣ r a f i n
πετράκησ	p e t ɾ a c i s
ώσπου	o s p u
αποκλείουμε	a p o k l i u m e
ανιδρύουμε	a n i ð r i u m e
επετράπην	e p e t ɾ a p i n
στολίζω	s t o l i z o
απόκρυψα	a p o k ɾ i p s a
έχουν	e x u n
ίδρυμα	i ð r i m a
συγγράφομαι	s i ŋ ɣ r a f o m e
ηγούμενο	i ɣ u m e n o
καταπλέω	k a t a p l e o
φονεύω	f o n e v o
στυμμένε	s t i m e n e
λευκόσ	l e f k o s
άγγελοσ	a ŋ ɟ e l o s
κυριολεκτικά	c i ɾ i o l e k t i k a
δάγκασα	ð a ŋ ɡ a s a
ψηφοφορίασ	p s i f o f o ɾ i a s
ντροπή	d ɾ o p i
τυροκομία	t i ɾ o k o m i a
ερρινότητα	e r i n o t i t a
αποκλείστηκε	a p o k l i s t i c e
εξοπλισμένων	e k s o p l i z m e n o n
παρεστιγμένοι	p a ɾ e s t i ɣ m e n i
μπαρκάρισε	b a ɾ k a ɾ i s e
ακομπανιαρίστηκα	a k o m p a ɲ a ɾ i s t i k a
καλομαθημένουσ	k a l o m a θ i m e n u s
εισπνέομε	i s p n e o m e
στενοχωρημένα	s t e n o x o r i m e n a
χαλασμένεσ	x a l a z m e n e s
λευκήσ	l e f c i s
ιδιαιτέρωσ	i ð i e t e ɾ o s
καπνίζω	k a p n i z o
αλήθεια	a l i θ ç a
απόρριψα	a p o ɾ i p s a
απόπλου	a p o p l u
μπερδεύτηκα	b e ɾ ð e f t i k a
δράκαινα	ð ɾ a c e n a
σφουγγοκωλάριοσ	s f u ŋ ɡ o k o l a ɾ i o s
έκαμψα	e k a m p s a
ερρινότησ	e r i n o t i s
επαμφοτέριζα	e p a ɱ f o t e ɾ i z a
σφαλιαρίτσα	s f a ʎ a ɾ i t s a
γεννώ	ʝ e n o
είδωλο	i ð o̞ l o̞
αποστάξεισ	a p o s t a k s i s
ταχυδρόμοσ	t a ç i ð ɾ o m o s
διήθηση	ð i i θ i s i
λικεράκι	l i c e ɾ a c i
διώχνω	ð ʝ o x n o
ερχομένη	e r x o m e n i
αμνηστεύθηκα	a m n i s t e f θ i k a
μαθημένοσ	m a θ i m e n o s
έδρεψα	e ð ɾ e p s a
επήλθα	e p i l θ a
καθαρματάκι	k a θ a ɾ m a t a c i
κακογαμημένησ	k a k o ɣ a m i m e n i s
γέννησισ	ʝ e n i s i s
πλησίασα	p l i s i a s a
υπογράφουμε	i p o ɣ r a f u m e
γαλόνι	ɣ a l o n i
εύχομαι	e f x o m e
κοτσάρισε	k o t s a ɾ i s e
στερούμαι	s t e ɾ u m e
φακόσ	f a k o s
ακοόμετρα	a k o o m e t r a
προφήτευσα	p ɾ ɔ f i t e f s a
ακοντίζω	a k o n d i z o
σαλτάριζα	s a l t a ɾ i z a
υδρόβιοσ	i ð r o v i o s
κεκλεισμένα	c e k l i z m e n a
αξιοθρήνητοσ	a k s i o θ ɾ i n i t o s
εργάζομαι	e ɾ ɣ a z o m e
στιμμένε	s t i m e n e
ανεπαισθήτωσ	a n e p e s θ i t o s
ανάμενα	a n a m e n a
ποικίλουσ	p i c i l u s
ψήφοσ	p s i f o s
αστυφύλακασ	a s t i f i l a k a s
ανεγράφην	a n e ɣ r a f i n
σαγηνεύθηκα	s a ʝ i n e f θ i k a
χεσμένησ	ç e z m e n i s
κόπτω	k o p t o
πίθουσ	p i θ u s
έπνευσα	e p n e f s a
πειθόμενεσ	p i θ o m e n e s
ισπανία	i s p a n i a
φούμαρου	f u m a ɾ u
περιοδικά	p e r i o ð i k a
αιγόκερωσ	e ɣ o c e ɾ o s
κιμωλία	c i m o l i a
κορίτσαροι	k o r i t s a r i
ορθογραφία	o ɾ θ o ɣ ɾ a f i a
ιεραρχών	i e r a r x o n
ορίζω	o ɾ i z o
ουδαμού	u ð a m u
έλληνα	e l i n a
ήμεθα	i m e θ a
φλώρινα	f l o ɾ i n a
δαμάζομαι	ð a m a z o m e
μερίδα	m e ɾ i ð a
ψαρεύομαι	p s a ɾ e v o m e
πανέμορφοσ	p a n e m o ɾ f o s
διαπνέομε	ð i a p n e o m e
σερβίριζα	s e ɾ v i ɾ i z a
ἀποκυήματοσ	a p o c i i m a t o s
βρισιά	v ɾ i s ç a
περασμένοσ	p e r a z m e n o s
φτου	f t u
κοσμάκησ	k o z m a c i s
γεωγραφίεσ	ʝ e o ɣ r a f i e s
έξη	e k s i
παζαρεύτηκα	p a z a ɾ e f t i k a
κερί	c e r r i
πορτοκαλόπιτασ	p o ɾ t o k a l o p i t a s
τετάρτη	t e t a ɾ t i
τρελαίνομαι	t ɾ e l e n o m e
φυτικόν	f i t i k o n
ολόασπροσ	o l o a s p ɾ o s
κοτσάριζα	k o t s a ɾ i z a
εφαπτομένη	e f a p t o m e n i
σοφό	s o f o
εμμανουήλ	e m a n u i l
αγγιγμένων	a ŋ ɟ i ɣ m e n o n
αξιοζήλευτοσ	a k s i o z i l e f t o s
αντιμετώπισα	a n d i m e t o p i s a
πειράζομαι	p i r a z o m e
τόση	t o s i
βασιλέασ	v a s i l e a s
συγγραφέων	s i ŋ ɣ r a f e o n
συνηθισμένησ	s i n i θ i z m e n i s
πομφόλυγεσ	p o ɱ f o l i ʝ e s
εξοπλισμένη	e k s o p l i z m e n i
ηδονίζομαι	i ð o n i z o m e
μουντοί	m u n d i
εγκαταλείφτηκα	e ŋ ɡ a t a l i f t i k a
ερχόμενα	e r x o m e n a
κάλλιο	k a ʎ o
αξιοσημείωτοι	a k s i o s i m i o t i
πρόεδροσ	p ɾ o e ð ɾ o s
έκλειψη	e k l i p s i
λευκών	l e f k o n
προϊών	p ɾ o i o n
αλατισμένη	a l a t i z m e n i
παυλάκησ	p a v l a c i s
ποδόγυροσ	p o ð o ʝ i ɾ o s
επιβλέπω	e p i v l e p o
χαμόγελο	x a m ɔ ʝ ɛ l ɔ
σκατούλα	s k a t u l a
κοροϊδεύτε	k o ɾ o i̯ ð e f t e
κρυμμένησ	k r i m e n i s
γρίνιαξα	ɣ ɾ i ɲ a k s a
αναγκάστηκα	a n a ŋ ɡ a s t i k a
προφητεύομαι	p ɾ ɔ f i t e v o m e
δέησα	ð e i s a
περικόπηκα	p e ɾ i k o p i k a
πλατιά	p l a t ç a
αβλαβέστεροσ	a v l a v e s t e r o s
χωριάτησ	x o ɾ ʝ a t i s
πίστεψε	p i s t e p s e
μπερδεμένοι	b e ɾ ð e m e n i
αγανόσ	a ɣ a n o s
λάκων	l a k o n
τιτάνασ	t i t a n a s
συνετρίβην	s i n e t ɾ i v i n
περιόδων	p e r i o ð o n
ψημένων	p s i m e n o n
πάντρεψα	p a n d ɾ e p s a
παπάρασ	p a p a ɾ a s
γκρίζε	ɡ ɾ i z ɛ
καθισμένων	k a θ i z m e n o n
αποκομίζω	a p o k o m i z o
ζεσταμένο	z e s t a m e n o
άγιοσ	a ʝ i o s
ανακάτωσα	a n a k a t o s a
κιθάρα	c i θ a r a
βάλανοσ	v a l a n o s
μάλαμα	m a l a m a
απασχολημένε	a p a s x o l i m e n e
συγκόπτουμε	s i ŋ ɡ o p t u m e
επανειλημμένου	e p a n i l i m e n u
άδικη	a ð i c i
γκαστρωμένεσ	ɡ a s t r o m e n e s
τεχνολογίεσ	t e x n o l o ʝ i e s
καταλυθήκαν	k a t a l i θ i k a n
ξάσπρισα	k s a s p r i s a
αποκόβουμε	a p o k o v u m e
στεναχωρημένουσ	s t e n a x o r i m e n u s
ὑπέγραψα	i p e ɣ r a p s a
αντιγραφείσ	a n d i ɣ r a f i s
ντέλαγουερ	d e l a ɣ u e ɾ
μι	m iː
παρακάμπτομαι	p a ɾ a k a m p t o m e
ανακρούομε	a n a k r u o m e
επιγράφτηκε	e p i ɣ r a f t i c e
εγχέομαι	e ŋ ç e o m e
κατέγραψα	k a t e ɣ r a p s a
ἀγορά	a ɣ o ɾ a
ήτα	i t a
στύβω	s t i v o
ουαλία	u a l i a
λυπημένου	l i p i m e n u
ακαδημία	a k a ð i m i a
φούμαρο	f u m a ɾ o
ζητώ	z i t o
ευχή	e f ç i
κατέπλευσα	k a t e p l e f s a
παμφάγοσ	p a ɱ f a ɣ o s
κινέζικα	c i n e z i k a
ευσεβείσ	e f s e v i s
δεύτεροσ	ð e f t e ɾ o s
μαυρισμένο	m a v r i z m e n o
γιατρεύτηκα	ʝ a t ɾ e f t i k a
κορασίδα	k o ɾ a s i ð a
κρεμασμένησ	k r e m a z m e n i s
αναθεματισμένο	a n a θ e m a t i z m e n o
επιγράφηκα	e p i ɣ r a f i k a
λύομεν	l i o m e n
γιάτρεψα	ʝ a t ɾ e p s a
ολόλευκοσ	o l o l e f k o s
σερβίρισε	s e ɾ v i ɾ i s e
κατελύθησαν	k a t e l i θ i s a n
υψηλοτάτη	i p s i l o t a t i
ολόφωτο	o l o f o t o
μαντεία	m a n d i a
πάμμαυροσ	p a m a v ɾ o s
ἐνέγραψα	e n e ɣ r a p s a
συρράπτομε	s i ɾ a p t o m e
μπλιαχ	b l i a x
προκοπή	p ɾ o k o p i
υποθάλπουμε	i p o θ a l p u m e
ακαταδεξιά	a k a t a ð e k s ç a
καταγραφτείσ	k a t a ɣ r a f t i s
μάτια	m a t ç a
αναβόσβησα	a n a v o z v i s a
απόσεισα	a p o s i s a
φούμαρων	f u m a ɾ o n
κυριακάτικοσ	c i r ʝ a k a t i k o s
χίοι	ç i i
αποστάχθηκα	a p o s t a x θ i k a
περσέασ	p e r s e a s
μπερδεμένα	b e ɾ ð e m e n a
σημαδιών	s i m a ð ʝ o n
ανέπαφοσ	a n e p a f o s
αλατισμένα	a l a t i z m e n a
χαράλαμποσ	x a ɾ a l a m b o s
περικλείομε	p e r i k l i o m e
ξέγραφα	k s e ɣ r a f a
ασκώ	a s k o
αποκλεισμένοι	a p o k l i z m e n i
ανετράπην	a n e t ɾ a p i n
υπολογιστικού	i p o l o ʝ i s t i k u
μάδυτοσ	m a ð i t o s
συσκέπτομαι	s i s c e p t o m e
δαγκαθεί	ð a ŋ ɡ a θ i
κοτσάρισα	k o t s a ɾ i s a
αλληλοσυγκρούομαι	a l i l o s i ŋ ɡ r u o m e
συνδέσεισ	s i n ð e s i s
κλήση	k l i s i
μοιάζω	m ɲ a z o
ψηφιακέ	p s i f i a c e
δελφοί	ð e l f i
επισείομαι	e p i s i o m e
σέβομαι	s e v o m e
πρησμένουσ	p ɾ i z m e n u s
χίων	ç i o n
μινεσότα	m i n e s o t a
απαιτήθηκα	a p e t i θ i k a
δημαρχεία	ð i m a ɾ ç i a
ενέκυψα	e n e c i p s a
καινοφανείσ	c e n o f a n i s
αηδιασμένεσ	a i ð i a z m e n e s
τρομοκρατία	t ɾ o m o k ɾ a t i a
έωσ	e o s
περικόβομαι	p e ɾ i k o v o m e
ευαγγελίσθηκα	e v a ŋ ɟ e l i s θ i k a
κάγκουρασ	k a ŋ ɡ u ɾ a s
κουκουλοφόροσ	k u k u l o f o ɾ o s
καρπάθου	k a ɾ p a θ u
ανασκάφθηκα	a n a s k a f θ i k a
τρίζω	t r i z o
όπλο	o p l o
πλήρωσα	p l i ɾ o s a
αναθεματισμένησ	a n a θ e m a t i z m e n i s
οδό	o ð o
έντερο	e n d e ɾ o
φοροαπαλλαγή	f o ɾ o a p a l a ʝ i
αλαφιασμένοι	a l a f ç a z m e n i
αλατισμένουσ	a l a t i z m e n u s
ερρίνωση	e r i n o s i
ανακαινίστηκα	a n a c e n i s t i k a
σουτάρομαι	s u t a ɾ o m e
εμπνευσμένε	e m b n e v z m e n e
έπεισα	e p i s a
γαμημένου	ɣ a m i m e n u
πομφόλυγασ	p o ɱ f o l i ɣ a s
απορρίπτω	a p o ɾ i p t o
υπνοβάτησ	i p n o v a t i s
πικάπ	p i k a p
κιόλασ	c o l a s
στησ	s t i s
πρέβεζα	p ɾ e v e z a
εννεακόσια	e n e a k o s ç a
εναντίον	e n a n d i o n
μητρική	m i t r i c i
ενδιαφέρουσασ	e n ð j a f e r u s a s
αγγιγμένο	a ŋ ɟ i ɣ m e n o
ζαμπονοτυρόπιτα	z a m b o n o t i ɾ o p i t a
τέλι	t e l i
ποικίλωσ	p i c i l o s
στυμμένα	s t i m e n a
κρεμασμένεσ	k r e m a z m e n e s
ανακύψεισ	a n a c i p s i s
υπογράφω	i p o ɣ ɾ a f o
λυπημένα	l i p i m e n a
χοντρόσ	x o n d ɾ o s
ανακατώθηκα	a n a k a t o θ i k a
πάρκινσον	p a ɾ c i n s o n
αβγοκομμένων	a v ɣ o k o m e n o n
καθισμένου	k a θ i z m e n u
φυτικαί	f i t i c e
αγκυλίων	a ŋ ɟ i l i o n
αντικρούσθηκα	a n d i k r u s θ i k a
μαόνι	m a o n i
ποικίλου	p i c i l u
αναθάρρησα	a n a θ a ɾ i s a
πάμμαυρη	p a m a v ɾ i
πίθε	p i θ e
αργοσαλεύω	a ɾ ɣ o s a l e v o
παιδοβούβαλο	p e ð o v u v a l o
πεπεισμένεσ	p e p i z m e n e s
σαγηνεύτηκα	s a ʝ i n e f t i k a
φυτικήν	f i t i c i n
κινδύνεψε	c i n ð i n e p s e
ζωτικόσ	z o t i k o s
αμήν	a m i n
προσήλθα	p r o s i l θ a
υπογράφτηκα	i p o ɣ r a f t i k a
νταραβερίζομαι	d a ɾ a v e ɾ i z o m e
γαμάτα	ɣ a m a t a
τριάντα	t r i a n d a
ἔφραξα	e f r a k s a
μυτιλήνη	m i t i l i n i
ακοόγραμμα	a k o o ɣ r a m a
κακογαμημένου	k a k o ɣ a m i m e n u
αλκάλιο	a l k a l i o
βασιλοκτονία	v a s i l o k t o n i a
ἤγγισα	i ŋ ɟ i s a
προβλέπομε	p ɾ o v l e p o m e
ετάφην	e t a f i n
ποικιλότερο	p i c i l o t e r o
στα	s t a
κιβωτόσ	c i v o t o s
τίνασ	t i n a s
αθεϊσμών	a θ e i z m o n
των	t o n
γκρίζων	ɡ ɾ i z o n
οριστικά	o ɾ i s t i k a
κύημα	c i i m a
βόρειοσ	v o ɾ i o s
δαγκώνομαι	ð a ŋ ɡ o n o m e
ελαφραίνω	e l a f ɾ e n o
αξιοσημείωτα	a k s i o s i m i o t a
ξεσκάτισμα	k s e s k a t i z m a
καταξοδιάζω	k a t a k s o ð ʝ a z o
ανέκρουσα	a n e k r u s a
χορέψανε	x o ɾ e p s a n e
αεροφωτογραφίζουμε	a e r o f o t o ɣ r a f i z u m e
εισπνέω	i s p n e o
ισχύω	i s ç i o
δολοφόνισσα	ð o l o f o n i s a
αγαπημένο	a ɣ a p i m e n o
αναφορά	a n a f o ɾ a
πετάγομαι	p e t a ɣ o m e
καταγράφω	k a t a ɣ r a f o
ξενέρωτοσ	k s e n e ɾ o t o s
περισπωμένησ	p e r i s p o m e n i s
τήνε	t i n e
μαθημένοι	m a θ i m e n i
χαράχτηκα	x a ɾ a x t i k a
γαϊδαράκοσ	ɣ a i ð a ɾ a k o s
αγκαζάρω	a ŋ ɡ a z a ɾ o
καλομαθημένων	k a l o m a θ i m e n o n
ενοχλώ	e n o x l o
αναδημιουργημένεσ	a n a ð i m i u r ʝ i m e n e s
κατέφτασα	k a t e f t a s a
γκρίζο	ɡ ɾ i z o
χιονίζει	ç o n i z i
αχιλλέασ	a ç i l e a s
γκρεμόσ	ɡ r e m o s
αναδημιουργημένα	a n a ð i m i u r ʝ i m e n a
μοιρασμένοσ	m i ɾ a z m e n o s
κουτσομπόλεψε	k u t s o b o l e p s e
πουδραρίζομαι	p u ð ɾ a ɾ i z o m e
επόμενοσ	e p o m e n o s
αντέστε	a d e s t e
ικανοποιημένουσ	i k a n o p i i m e n u s
κυνηγημένη	c i n i ʝ i m e n i
σταφιδόψωμο	s t a f i ð o p s o m o
ψημένο	p s i m e n o
αποκόπτουμε	a p o k o p t u m e
αμνηστεύομαι	a m n i s t e v o m e
άκουσα	a k u s a
ψόφοσ	p s o f o s
τσαμπουκάσ	t s a m b u k a s
κουραστικέσ	k u r a s t i c e s
πιονιού	p ç o ɲ u
περιγράφτηκα	p e ɾ i ɣ r a f t i k a
γλείφτηκα	ɣ l i f t i k a
ποικιλότερεσ	p i c i l o t e r e s
κρέασ	k r e̞ a s
μποϊκοτάρομαι	b o i k o t a ɾ o m e
υγιεινή	i ʝ i i n i
κωσταντήσ	k o s t a n d i s
κουρασμένουσ	k u r a z m e n u s
φωτογραφίσεισ	f o t o ɣ r a f i s i s
φαντάζομαι	f a n d a z o m e
κακόσ	k a k o s
χίουσ	ç i u s
κατάμαυροσ	k a t a m a v ɾ o s
κουρασμένων	k u r a z m e n o n
γαζία	ɣ a z i a
προμηθεύτηκα	p ɾ ɔ m i θ e f t i k a
σουτάριζα	s u t a ɾ i z a
πλέκουμε	p l e k u m e
μια	m ɲ a
παρακείμενεσ	p a ɾ a c i m e n e s
πεθαμένη	p e θ a m e n i
παγωμένε	p a ɣ o m e n e
δήμοσ	ð i m o s
αβαράριζα	a v a ɾ a ɾ i z a
χάλυβασ	x a l i v a s
εκλαίρ	e k l e ɾ
ποικιλότεροσ	p i c i l o t e r o s
τάμεσησ	t a m e s i s
αρχή	a r ç i
αναθεματισμένοι	a n a θ e m a t i z m e n i
αναγκάζουμε	a n a ŋ ɡ a z u m e
τράπηκα	t ɾ a p i k a
ανοησία	a n o i s i a
επανόρθωση	e p a n o r θ o s i
σαββατοκύριακο	s a v a t ɔ c i ɾ ʝ a k ɔ
ηδονοβλεψίασ	i ð o n o v l e p s i a s
οδέ	o ð e
φασούλια	f a s u ʎ a
εργαλειοθήκη	e r ɣ a l i o θ i c i
ακόνισα	a k o n i s a
ξένια	k s e ɲ a
στενοχωριέμαι	s t e n o x o r ʝ e m e
κομμένουσ	k o m e n u s
ελάφι	e l a f i
κουτσομπολιό	k u t s o b o ʎ o
φωτογράφισα	f o t o ɣ r a f i s a
κωλομέρι	k o l o m e ɾ i
υπολογισμένε	i p o l o ʝ i z m e n e
μαρκαρίστηκα	m a ɾ k a ɾ i s t i k a
τιτάνα	t i t a n a
παράκαμψε	p a ɾ a k a m p s e
ξι	k s i
κλάδοσ	k l a ð o s
ντεντέκτιβ	d e d e k t i v
πεθερόσ	p e θ e ɾ o s
εκπέμπω	e k p e m b o
πειθαναγκάζουμε	p i θ a n a ŋ ɡ a z u m e
μαζικούσ	m a z i k u s
χορεύομε	x o ɾ e v o m e
διαισθάνομαι	ð i e s θ a n o m e
μουσκεμένου	m u s c e m e n u
μποϊκοτάρισα	b o i k o t a ɾ i s a
τσακώνικοσ	t s a k o n i k o s
μπερδεμένεσ	b e ɾ ð e m e n e s
δυσκολεύτηκα	ð i s k o l e f t i k a
τισ	t i s
μετατρέπομαι	m e t a t ɾ e p o m e
ζητιάνευε	z i t ç a n e v e
επικαλύπτω	e p i k a l i p t o
αριβάρισα	a ɾ i v a ɾ i s a
αναγνωρισμένοσ	a n a ɣ n o r i z m e n o s
βουτυρωμένη	v u t i r o m e n i
παρφουμαρίζω	p a ɾ f u m a ɾ i z o
κρεμασμένα	k r e m a z m e n a
μαζικότατο	m a z i k o t a t o
κοτέτσι	k o t e t s i
αποκλείσθηκα	a p o k l i s θ i k a
στενοχωρημένοι	s t e n o x o r i m e n i
σαλτάρισα	s a l t a ɾ i s a
βδομάδα	v ð o m a ð a
κουρεύομαι	k u ɾ e v o m e
κτηνοβασία	k t i n o v a s i a
οικογένεια	i k ɔ ʝ ɛ n i a
στέκομαι	s t e k o m e
ενορχήστρωση	e n o ɾ ç i s t ɾ o s i
αποδείχθηκα	a p o ð i x θ i k a
φρέσκαρα	f r e s k a r a
μεγαλειοτάτη	m e ɣ a l i o t a t i
κούλουρη	k u l u ɾ i
φολίδα	f o l i ð a
κατελύθη	k a t e l i θ i
αληθεύομαι	a l i θ e v o m e
μπουνατσάριζε	b u n a t s a ɾ i z e
δημοκρατιών	ð i m o k r a t i o n
αγορέσ	a ɣ o r e s
αδελφόσ	a ð ɛ l f ɔ s
σηκωμάρα	s i k o m a ɾ a
πιροσκί	p i r o s k i
αναδημιουργημένοσ	a n a ð i m i u r ʝ i m e n o s
αδελφοκτονία	a ð e l f o k t o n i a
συριζα	s i ɾ i z a
εξοπλισμένεσ	e k s o p l i z m e n e s
αλαμπουρνέζικησ	a l a b u r n e z i c i s
κόβω	k o v o
ερχόμενησ	e r x o m e n i s
φαντάζω	f a n d a z o
γκεσεμιών	ɟ e s e m ɲ o n
λουτράκι	l u t ɾ a c i
καμπούρησ	k a m b u ɾ i s
προφασίζομαι	p ɾ o f a s i z o m e
αγλαϊσμένοσ	a ɣ l a i z m e n o s
αλυσοδεμένεσ	a l i s o ð e m e n e s
κροτώ	k ɾ o t o
εμπνέουμε	e m b n e u m e
αλείβω	a l i v o
στειρώνω	s t i ɾ o n o
εκχύνομαι	e k ç i n o m e
διαπληκτίσθηκα	ð i a p l i k t i s θ i k a
αλευρωμένο	a l e v r o m e n o
αμοιβαιότητα	a m i v e o t i t a
αληθών	a l i θ o n
ντετερμινισμόσ	d e t e r m i n i z m o s
εμπιστεύομαι	e m b i s t e v o m e
ακατάδεκτοσ	a k a t a ð e k t o s
πεολειχία	p e o l i ç i a
κινδυνέψει	c i n ð i n e p s i
αμοιβάδα	a m i v a ð a
λόξιγκασ	l o k s i ŋ ɡ a s
ακομπανιάρω	a k o m p a ɲ a ɾ o
κυριακάτικα	c i r ʝ a k a t i k a
χόρεψαν	x o ɾ e p s a n
φυτικήσ	f i t i c i s
αισχροκερδώ	e s x r o c e r ð o
μήλο	m i l o
αλληλοσυγκρούστηκα	a l i l o s i ŋ ɡ r u s t i k a
επισείουμε	e p i s i u m e
ανασυγκροτώ	a n a s i ŋ ɡ ɾ o t o
πιθανότητα	p i θ a n o t i t a
βάφτηκα	v a f t i k a
αναβαθμολογήσεισ	a n a v a θ m o l o ʝ i s i s
εκτελέσθηκα	e k t e l e s θ i k a
ακοομέτρου	a k o o m e t r u
ερυθρόσ	e r i θ r o s
ψωλάκι	p s o l a c i
γκαστρωμένου	ɡ a s t r o m e n u
ηράκλειο	i r a k l i o
υπολογιστικούσ	i p o l o ʝ i s t i k u s
ντρέπομαι	d ɾ e p o m e
ψάχνομαι	p s a x n o m e
δυσκολία	ð i s k o l i a
πόνταρα	p o n d a ɾ a
υπολογιστικό	i p o l o ʝ i s t i k o
ποδοσφαίρων	p o ð o s f e r o n
καρεκλοκένταυροσ	k a ɾ e k l o c e n d a v ɾ o s
ιδρύω	i ð r i o
ζακύνθου	z a c i n θ u
αγγελμένοσ	a ŋ ɟ e l m e n o s
βαθμολογημένε	v a θ m o l o ʝ i m e n e
επαμφοτερίζω	e p a ɱ f o t e ɾ i z o
φτάνω	f t a n o
προηγούμενοι	p r o i ɣ u m e n i
αβάνα	a v a n a
σκοντάβω	s k o n d a v o
σφαλιάρα	s f a ʎ a ɾ a
παγκοσμιοποιήσεισ	p a ŋ ɡ o z m i o p i i s i s
ραμαζάνι	ɾ a m a z a n i
ιδρύματοσ	i ð r i m a t o s
πουτάνα	p u t a n a
κινεζοποίησησ	c i n e z o p i i s i s
μαζικότερησ	m a z i k o t e r i s
συντρίφτηκαν	s i n d r i f t i k a n
μήνυμα	m i n i m a
περισπωμένεσ	p e r i s p o m e n e s
προσοχή	p ɾ o s o ç i
εξυπακούεται	e k s i p a k u e t e
αναρμόδια	a n a ɾ m o ð i a
συντριπτικόσ	s i n d r i p t i k o s
παντρεμένα	p a n d ɾ e m e n a
ξαλεγράρισα	k s a l e ɣ ɾ a ɾ i s a
αποκλεισμένε	a p o k l i z m e n e
εισακούομε	i s a k u o m e
υιοθετούμαι	i o θ e t u m e
κρούομε	k r u o m e
βαθμολογημένων	v a θ m o l o ʝ i m e n o n
μουντόσ	m u n d o s
υπολογιστική	i p o l o ʝ i s t i c i
αναγνωρισμένου	a n a ɣ n o r i z m e n u
πρωτοανακαλύφτηκα	p ɾ o t o a n a k a l i f t i k a
ολιγόκαινοσ	o l i ɣ o c e n o s
αλληλοσυγκρουόμενοσ	a l i l o s i ŋ ɡ r u o m e n o s
ξεσπιτώνω	k s e s p i t o n o
φράζομαι	f r a z o m e
ηγουμένουσ	i ɣ u m e n u s
νοιάζει	ɲ a z i
παρακείμενοσ	p a ɾ a c i m e n o s
έτριψα	e t r i p s a
γκρινιάζω	ɡ ɾ i ɲ a z o
παρεγράφησαν	p a ɾ e ɣ ɾ a f i s a n
διαχειρίζομαι	ð i a ç i ɾ i z o m e
επαρχιών	e p a ɾ ç i o n
αισχρόσ	e s x r o s
πρησμένου	p ɾ i z m e n u
απέκρυψα	a p e k ɾ i p s a
πρωτόγονοσ	p ɾ o t o ɣ o n o s
παρκαδόροσ	p a ɾ k a ð o ɾ o s
αντιμετωπίζομαι	a n d i m e t o p i z o m e
τεχνολογιών	t e x n o l o ʝ i o n
εγχέουμε	e ŋ ç e u m e
μαθημένο	m a θ i m e n o
ἀπασχολῶ	a p a s x o l o
γοητεύω	ɣ o i t e v o
ντετέκτιβ	d e t e k t i v
υποδιαστολή	i p o ð i a s t o l i
λευκότεροσ	l e f k o t e r o s
κετσέ	k e t s e
ψηφίο	p s i f i o
ανταμείβομαι	a n d a m i v o m e
σελίνι	s e l i n i
μωρόσ	m o ɾ o s
εκτρέπω	e k t ɾ e p o
ροδακίνου	r o ð a c i n u
σταγών	s t a ɣ o n
γκάριξα	ɡ a r i k s a
σκυλολόι	s c i l o l o
συνεδέθην	s i n e ð e θ i n
έρρινησ	e r i n i s
περιέθαλψα	p e ɾ i e θ a l p s a
πληθυντικόσ	p l i θ i n d i k ɔ s
σβηστήρα	z v i s t i ɾ a
επαναλαμβάνω	e p a n a l a ɱ v a n o
κύπρο	c i p ɾ o
κόρινθε	k o ɾ i n θ e
αναδύομαι	a n a ð i o m e
κινδύνευε	c i n ð i n e v e
φτύστηκα	f t i s t i k a
πιλοτάρισε	p i l o t a ɾ i s e
στεναχωρώ	s t e n a x o r o
απόστασα	a p o s t a s a
περιστράφηκα	p e ɾ i s t ɾ a f i k a
χειρότεροσ	ç i ɾ o t e ɾ o s
τρίβω	t r i v o
λευκό	l e f k o
κούκοσ	k u k o s
αρχικά	a r ç i k a
κυνηγόσ	c i n i ɣ o s
ιεροδουλία	i e ɾ o ð u l i a
υπέροχα	i p e ɾ o x a
παρέπαια	p a ɾ e p e a
σύκο	s i k o
λυμένα	l i m e n a
τυρόπιτα	t i ɾ o p i t a
στοργή	s t o r ʝ i
ερρινότητεσ	e r i n o t i t e s
σβήστρα	z v i s t ɾ a
ομοβροντία	o m o v ɾ o n d i a
μίσιγκαν	m i s i ɡ a n
οδοί	o ð i
ἱκέτευσα	i c e t e f s a
μαζικότατησ	m a z i k o t a t i s
επερχόμενοσ	e p e ɾ x o m e n o s
εβδομήντα	e v ð o m i n d a
φούμαρε	f u m a ɾ e
εθναρχών	e θ n a r x o n
μαθαίνω	m a θ e n o
νοστιμεύτηκα	n o s t i m e f t i k a
πλακομούνι	p l a k o m u n i
λικέρ	l i c e ɾ
χαρχαλεύω	x a ɾ x a l e v o
κραγμένα	k r a ɣ m e n a
χορταίνω	x o ɾ t e n o
επανιδρύομε	e p a n i ð r i o m e
προσελκύομε	p r o s e l c i o m e
τριάκοντα	t ɾ i a k o n d a
απελπισμένοι	a p e l p i z m e n i
παραγραφήκανε	p a ɾ a ɣ ɾ a f i k a n e
λακωνίασ	l a k o n i a s
μετατρέπω	m e t a t ɾ e p o
απογοητεύτηκα	a p o ɣ o i t e f t i k a
ταυ	t a f
κλαρινογαμπρόσ	k l a ɾ i n o ɣ a m b ɾ o s
ξένοι	k s e n i
αλφαδιάζω	a l f a ð ʝ a z o
αποσυνδέω	a p o s i n ð e o
εισπνεύσθηκα	i s p n e f s θ i k a
συναίρεσησ	s i n e r e s i s
αβεβαίωσ	a v e v e o s
εμπνευσμένο	e m b n e v z m e n o
ηλιόλουστοσ	i ʎ ɔ l u s t ɔ s
σερβίρω	s e ɾ v i ɾ o
πριγκίπισσα	p ɾ i ŋ ɟ i p i s a
αγγίστηκα	a ŋ ɟ i s t i k a
φωτογραφίζομαι	f o t o ɣ r a f i z o m e
επανειλημμένα	e p a n i l i m e n a
φθάνω	f θ a n o
στεναχωρημένοσ	s t e n a x o r i m e n o s
διέχυσα	ð i e ç i s a
αναγεννιέμαι	a n a ʝ e ɲ e m e
βουλιάχτε	v u ʎ a x t e
προηγουμένησ	p r o i ɣ u m e n i s
μολογώ	m o l o ɣ o
αγαθοεργία	a ɣ a θ ɔ ɛ ɾ ʝ i a
ατάλαντοσ	a t a l a n d o s
θεσσαλονικιώτικοσ	θ e s a l o n i c ʝ o t i k o s
σερβιετούλα	s e r v i e t u l a
εμπνέομε	e m b n e o m e
όρισα	o ɾ i s a
αϊόβα	a i o v a
ακροαματικότητα	a k ɾ o a m a t i k o t i t a
βουτυρωμένησ	v u t i r o m e n i s
πολωνικοί	p o l o n i c i
αγάμητοσ	a ɣ a m i t o s
αξιόπιστοσ	a k s i o p i s t o s
ευσέβεια	e f s e v i a
δημήτρησ	ð i m i t ɾ i s
αγγελούδι	a ŋ ɟ e l u ð i
σωπαίνω	s o p e n o
λίποσ	l i p o s
καλομοίρηδων	k a l o m i r i ð o n
μπαγκέτα	b a ɟ e t a
ψήφων	p s i f o n
συμφυρμόσ	s i ɱ f i r m o s
ερχόμενοι	e r x o m e n i
ξενιτειά	k s e n i t ʝ a
υποθάλπομε	i p o θ a l p o m e
γκόμενα	ɡ o m e n a
ψι	p s i
καλοκαιριάτικα	k a l o c e ɾ ʝ a t i k a
καπνίζουμε	k a p n i z u m e
εκτελεστικόσ	e k t e l e s t i k o s
ευχήθηκα	e f ç i θ i k a
τριμμένησ	t r i m e n i s
βουτυρωμένου	v u t i r o m e n u
σουτ	s u t
πόροι	p o r i
τετριμμένου	t e t r i m e n u
κουτσομπόλησ	k u t s o b o l i s
αιγίνησ	e ʝ i n i s
ανακαίνισα	a n a c e n i s a
λυμένοι	l i m e n i
ανταμείβω	a n d a m i v o
συγκίνηση	s i ŋ ɟ i n i s i
περιέστρεψα	p e ɾ i e s t ɾ e p s a
διαπληκτίστηκα	ð i a p l i k t i s t i k a
τρυγόνων	t r i ɣ o n o n
κλάδεψα	k l a ð e p s a
καθελκύω	k a θ e l c i o
χεσμένο	ç e z m e n o
αγκυλώνω	a ŋ ɟ i l o n o
