तमंचा	t̪ ə m ə ɲ t͡ʃ ɑː
धोबिन	d̪ ʱ oː b ɪ n
अड़ाना	ə ɽ ɑː n ɑː
बुटवल	b ʊ ʈ ʋ ə l
डाकघर	ɖ ɑː k ɡ ʱ ə ɾ
समन्वय	s ə m ə n ʋ ə j
आरंभिक	ɑː ɾ ə m b ʱ ɪ k
मिथ्या	m ɪ t̪ʰ j ɑː
पैदाइश	p ɛː d̪ ɑː ɪ ʃ
मौसमीपन	m ɔː s m iː p ə n
दबाव	d̪ ə b ɑː ʋ
लहर	l ɛː ʱ ɾ
छक्का	t͡ʃʰ ə k k ɑː
दलित	d̪ ə l ɪ t̪
उपबोली	ʊ p b oː l iː
आयरलैंड	ɑː j ə ɾ l ɛː n ɖ
माँगना	m ɑ̃ː ɡ n ɑː
अलविदा	ə l ʋ ɪ d̪ ɑː
कलह	k ə l ə ʱ
सजाना	s ə d͡ʒ ɑː n ɑː
लसन	l ə s ə n
लोकप्रियता	l oː k ə p ɾ iː j ə t̪ ɑː
कुकी	k ʊ k iː
बायाँ	b ɑː j ɑ̃ː
ठाणे	ʈʰ ɑː n eː
फूफा	pʰ uː pʰ ɑː
कपड़ा	k ə p ɽ ɑː
अतः	ə t̪ əʰ
बयानबाज़ी	b ə j ɑː n b ɑː z iː
दोषमुक्ति	d̪ o ʂ m ʊ k t̪ i
निर्घोष	n ɪ ɾ ɡ ʱ oː ʃ
गतिमान	ɡ ə t̪ ɪ m ɑː n
विभूति	ʋ ɪ b ʱ uː t̪ iː
अप्रचलित	ə p ɾ ə t͡ʃ ə l ɪ t̪
बाधा	b ɑː d̪ ʱ ɑː
नुमाइंदा	n ʊ m ɑː ɪ n d̪ ɑː
एतबार	eː t̪ b ɑː ɾ
धातुकर्म	d̪ ʱ ɑː t̪ ʊ k ə ɾ m
लोकतांत्रिक	l oː k t̪ ɑː n t̪ ɾ ɪ k
संसदीय	s ə n s ə d̪ iː j
कई	k ə iː
चरमपंथी	t͡ʃ ə ɾ ə m p ə n t̪ʰ iː
चुनौती	t͡ʃ ʊ n ɔː t̪ iː
कर्म	k ə ɾ m
सरलीकृत	s ə ɾ l iː k ɾ ɪ t̪
लेख	l eː kʰ
तिरसठ	t̪ ɪ ɾ s ə ʈʰ
टोक्यो	ʈ oː k j oː
ऐश	ɛː ʃ
यशायाह	j ə ʃ ɑː j ɑː ʱ
खूँटी	kʰ ũː ʈ iː
निष्कासन	n ɪ ʃ k ɑː s ə n
अनगढ़	ə n ɡ ə ɽ ʱ
अम्बर	ə m b ə ɾ
अंधविश्वास	ə n d̪ ʱ ʋ ɪ ʃ ʋ ɑː s
संघीय	s ə ŋ ɡ ʱ iː j
अनुवाद	ə n ʊ ʋ ɑː d̪
कलमा	k ə l m ɑː
शिवालय	ʃ ɪ ʋ ɑː l ə j
मौलाना	m ɔː l ɑː n ɑː
पाशुपत	p ɑː ʃ ʊ p ə t̪
हर्ष	ɦ ə ɾ ʃ
क्षेत्र	k ʃ eː t̪ ɾ
अकड़ना	ə k ə ɽ n ɑː
राज्यानुसार	ɾ ɑː d͡ʒ j ɑː n ʊ s ɑː ɾ
ब्रिस्बेन	b ɾ ɪ s b eː n
इब्तिदा	ɪ b t̪ ɪ d̪ ɑː
अभियोग	ə b ʱ iː j oː ɡ
हँसाना	ɦ ə̃ s ɑː n ɑː
कहना	k ɛː ʱ n ɑː
इक्यावन	ɪ k j ɑː ʋ ə n
प्रमाण	p ɾ ə m ɑː n
भूतनी	b ʱ uː t̪ n iː
इकावन	ɪ k ɑː ʋ ə n
सप्ताहांत	s ə p t̪ ɑː ɦ ɑː n t̪
गायब	ɡ ɑː j ə b
मंजन	m ə ɲ d͡ʒ ə n
भाखा	b ʱ ɑː kʰ ɑː
अगरतला	ə ɡ ə ɾ t̪ ə l ɑː
सोता	s oː t̪ ɑː
बलपूर्वक	b ə l p uː ɾ ʋ ə k
रिहा	ɾ ɪ ɦ ɑː
शरीर	ʃ ə ɾ iː ɾ
शिद्दत	ʃ ɪ d̪ d̪ ə t̪
प्रतीति	p ɾ ə t̪ iː t̪ iː
बंदर	b ə n d̪ ə ɾ
काजल	k ɑː d͡ʒ ə l
रूपरेखा	ɾ uː p ɾ eː kʰ ɑː
मूल्यांकन	m uː l j ɑː ŋ k ə n
अजूबा	ə d͡ʒ uː b ɑː
बसंत	b ə s ə n t̪
प्रतिशत	p ɾ ə t̪ ɪ ʃ ə t̪
जी	d͡ʒ iː
ओकाई	o k aː iː
हृदयरोग	ɦ ɾ ɪ d̪ ə j ɾ oː ɡ
इकसठ	ɪ k s ə ʈʰ
भूनना	b ʱ uː n n ɑː
खींचतान	kʰ iː ɲ t͡ʃ t̪ ɑː n
बाँसुरी	b ɑ̃ː s ʊ ɾ iː
पाई	p ɑː iː
अंताक्षरी	ə n t̪ ɑː k ʃ ə ɾ iː
झलना	d͡ʒ ʱ ə l n ɑː
चिढ़ाना	t͡ʃ ɪ ɽ ʱ ɑː n ɑː
प्रतिज्ञा	p ɾ ə t̪ ɪ ɡ j ɑː
शब्दार्थ	ʃ ə b d̪ ɑː ɾ t̪ʰ
संगीत	s ə ŋ ɡ iː t̪
शैवाल	ʃ ɛː ʋ ɑː l
बिताना	b ɪ t̪ ɑː n ɑː
बाकू	b ɑː k uː
पलस्तर	p ə l ə s t̪ ə ɾ
उत्तरदायी	ʊ t̪ t̪ ə ɾ d̪ ɑː j iː
चर्चित	t͡ʃ ə ɾ t͡ʃ ɪ t̪
पिज़्ज़ा	p ɪ z z ɑː
आछा	ɑː t͡ʃʰ ɑː
बिहारी	b ɪ ɦ ɑː ɾ iː
परजन	p ə ɾ d͡ʒ ə n
उल्लेखनीय	ʊ l l eː kʰ n iː j
भीषण	b ʱ iː ʃ ə n
मानसूनी	m ɑː n s uː n iː
पत्थरबाज़	p ə t̪ t̪ʰ ə ɾ b ɑː z
नेम	n eː m
बटालियन	b ə ʈ ɑː l iː j ə n
अमान्य	ə m ɑː n j
मज़दूर	m ə z d̪ uː ɾ
काष्ठशर्करा	k ɑː ʃ ʈʰ ʃ ə ɾ k ə ɾ ɑː
शिष्य	ʃ ɪ ʃ j
उल्लेख	ʊ l l eː kʰ
दंत्य	d̪ ə n t̪ j
तीखा	t̪ iː kʰ ɑː
भावुक	b ʱ ɑː ʋ ʊ k
लड़ाका	l ə ɽ ɑː k ɑː
हवलदार	ɦ ə ʋ ə l d̪ ɑː ɾ
कोशिकीय	k oː ʃ ɪ k iː j
छप्पन	t͡ʃʰ ə p p ə n
पुलिंदा	p ʊ l ɪ n d̪ ɑː
महागठबंधन	m ə ɦ ɑː ɡ ə ʈʰ b ə n d̪ ʱ ə n
उरुग्वे	ʊ ɾ ʊ ɡ ʋ eː
मझधार	m ə d͡ʒ ʱ d̪ ʱ ɑː ɾ
छलकना	t͡ʃʰ ə l ə k n ɑː
विश्वासपात्र	ʋ ɪ ʃ ʋ ɑː s p ɑː t̪ ɾ
पुरुष	p ʊ ɾ ʊ ʃ
दर्दनाक	d̪ ə ɾ d̪ n ɑː k
लीची	l iː t͡ʃ iː
आंशिक	ɑː n ʃ ɪ k
मतदान	m ə t̪ d̪ ɑː n
अखरना	ə kʰ ə ɾ n ɑː
बुझाना	b ʊ d͡ʒ ʱ ɑː n ɑː
अक्तूबर	ə k t̪ uː b ə ɾ
काजू	k ɑː d͡ʒ uː
घटाना	ɡ ʱ ə ʈ ɑː n ɑː
ज़ुल्म	z ʊ l m
मौन	m ɔː n
नौबत	n ɔː b ə t̪
लीडरी	l iː ɖ ə ɾ iː
टूट	ʈ uː ʈ
कुतरना	k ʊ t̪ ə ɾ n ɑː
सामी	s ɑː m iː
रटना	ɾ ə ʈ n ɑː
शिक्षार्थी	ʃ ɪ k ʃ ɑː ɾ t̪ʰ iː
प्यादा	p j ɑː d̪ ɑː
पखेरू	p ə kʰ eː ɾ uː
यथा	j ə t̪ʰ ɑː
दीन	d̪ iː n
अहिच्छत्र	ə ɦ ɪ t͡ʃ t͡ʃʰ ə t̪ ɾ
माँस	m ɑ̃ː s
दिलचस्पी	d̪ ɪ l t͡ʃ ə s p iː
झाँसी	d͡ʒ ʱ ɑ̃ː s iː
अधीन	ə d̪ ʱ iː n
अटकाव	ə ʈ k ɑː ʋ
बिरादर	b ɪ ɾ ɑː d̪ ə ɾ
तीसरा	t̪ iː s ɾ ɑː
स्वतः	s ʋ ə t̪ əʰ
ढोकला	ɖ ʱ oː k l ɑː
नींबू	n iː m b uː
निलंबित	n ɪ l ə m b ɪ t̪
मृतक	m ɾ ɪ t̪ ə k
पेश	p eː ʃ
विद्युतीय	ʋ ɪ d̪ j ʊ t̪ iː j
चल	t͡ʃ ə l
असाधारण	ə s ɑː d̪ ʱ ɑː ɾ ə n
लीलना	l iː l n ɑː
शुद्ध	ʃ ʊ d̪ d̪ ʱ
समझाना	s ə m d͡ʒ ʱ ɑː n ɑː
तरस्विनी	t̪ ə ɾ ə s ʋ ɪ n iː
पारिवारिक	p ɑː ɾ ɪ ʋ ɑː ɾ ɪ k
अग्न्याशय	ə ɡ n j ɑː ʃ ə j
द्वार	d̪ ʋ aː r
दूज	d̪ uː d͡ʒ
चमगादड़	t͡ʃ ə m ɡ ɑː d̪ ə ɽ
सांबर	s ɑː m b ə ɾ
कूटनीतिज्ञ	k uː ʈ n iː t̪ ɪ ɡ j
मुहब्बत	m ʊ ɦ ə b b ə t̪
अवाई	ə ʋ ɑː iː
अरविंद	ə ɾ ʋ ɪ n d̪
कोयला	k oː j ə l ɑː
अस्थि	ə s t̪ʰ iː
पचपन	p ə t͡ʃ p ə n
टपकना	ʈ ə p ə k n ɑː
कुहनी	k ʊ ʱ n iː
अंदाज़	ə n̪ d̪ a z
बकुची	b ə k ʊ t͡ʃ iː
पुण्यतिथि	p ʊ n j ə t̪ ɪ t̪ʰ iː
मसूड़ा	m ə s uː ɽ ɑː
भरत	b ʱ ə ɾ ə t̪
ताकना	t̪ ɑː k n ɑː
दबदबा	d̪ ə b d̪ ə b ɑː
रस्सी	ɾ ə s s iː
आक्रमण	ɑː k ɾ ə m ə n
देशी	d̪ eː ʃ iː
हैवानियत	ɦ ɛː ʋ ɑː n iː j ə t̪
गुआम	ɡ ʊ ɑː m
बीजांड	b iː d͡ʒ ɑː n ɖ
बैंगनी	b ɛː ŋ ɡ n iː
बदल	b ə d̪ ə l
निजात	n ɪ d͡ʒ ɑː t̪
आकर्षी	ɑː k ə ɾ ʃ iː
वितर्क	ʋ ɪ t̪ ə ɾ k
नेता	n eː t̪ ɑː
उक्त	ʊ k t̪
सीधा	s iː d̪ ʱ ɑː
निगमन	n ɪ ɡ ə m ə n
हस्तशिल्प	ɦ ə s t̪ ə ʃ ɪ l p
तिरासी	t̪ ɪ ɾ ɑː s iː
सिरा	s ɪ ɾ ɑː
बोटी	b oː ʈ iː
बुड्ढा	b ʊ ɖ ɖ ʱ ɑː
स़िफ़र	s ɪ f ə ɾ
बाह्य	b ɑː ʱ j
बांटना	b ɑː n ʈ n ɑː
जुर्म	d͡ʒ ʊ ɾ m
प्रावधान	p ɾ ɑː ʋ d̪ ʱ ɑː n
सज्जन	s ə d͡ʒ d͡ʒ ə n
संपर्क	s ə m p ə ɾ k
अंतरिक्ष	ə n t̪ ɾ ɪ k ʃ
लालटेन	l ɑː l ʈ eː n
सर्वोदय	s ə ɾ ʋ oː d̪ ə j
गगनचुंबी	ɡ ə ɡ ə n t͡ʃ ʊ m b iː
एजेंट	eː d͡ʒ eː n ʈ
खपत	kʰ ə p ə t̪
गुओमिंदांग	ɡ ʊ oː m ɪ n d̪ ɑː ŋ ɡ
तापक्रम	t̪ ɑː p ə k ɾ ə m
तमिल	t̪ ə m ɪ l
नियुक्त	n iː j ʊ k t̪
लज्जित	l ə d͡ʒ d͡ʒ ɪ t̪
एमएलए	eː m ‿ eː l ‿ eː
गोलमाल	ɡ oː l m ɑː l
काँटा	k ɑ̃ː ʈ ɑː
निर्देशक	n ɪ ɾ d̪ eː ʃ ə k
निर्णायक	n ɪ ɾ n ɑː j ə k
शाश्वत	ʃ ɑː ʃ ʋ ə t̪
अंशकालिक	ə n ʃ k ɑː l ɪ k
शिकायत	ʃ ɪ k ɑː j ə t̪
रोपना	ɾ oː p n ɑː
शौहर	ʃ ɔː ɦ ə ɾ
इच्छा	ɪ t͡ʃ t͡ʃʰ ɑː
नॉर्वे	n ɔː ɾ ʋ eː
जिसका	d͡ʒ ɪ s k ɑː
मन	m ə n
शीर्षासन	ʃ iː ɾ ʃ ɑː s ə n
बढ़ोतरी	b ə ɽ ʱ oː t̪ ə ɾ iː
विश्वप्रसिद्ध	ʋ ɪ ʃ ʋ ə p ɾ ə s ɪ d̪ d̪ ʱ
डोली	ɖ oː l iː
भावुकता	b ʱ ɑː ʋ ʊ k t̪ ɑː
वर्णित	ʋ ə ɾ n ɪ t̪
समाचार	s ə m ɑː t͡ʃ ɑː ɾ
अस्तबल	ə s t̪ ə b ə l
हौवा	ɦ ɔː ʋ ɑː
जुआरी	d͡ʒ ʊ ɑː ɾ iː
शर्माना	ʃ ə ɾ m ɑː n ɑː
उजड्ड	ʊ d͡ʒ ə ɖ ɖ
तो	t̪ oː
कर्तृत्व	k ə ɾ t̪ ɾ ɪ t̪ ʋ
भावनगर	b ʱ ɑː ʋ n ə ɡ ə ɾ
अयोग्यता	ə j oː ɡ j ə t̪ ɑː
तकिया	t̪ ə k iː j ɑː
व्यवस्था	ʋ j ə ʋ ə s t̪ʰ ɑː
कीड़ा	k iː ɽ ɑː
बदलाव	b ə d̪ l ɑː ʋ
विस्मय	ʋ ɪ s m ə j
आत्मविश्वास	ɑː t̪ m ə ʋ ɪ ʃ ʋ ɑː s
पीपल	p iː p ə l
घी	ɡ ʱ iː
बन्दूक	b ə n d̪ uː k
बांझ	b ɑː ɲ d͡ʒ ʱ
हरित	ɦ ə ɾ ɪ t̪
वड़ोदरा	ʋ ə ɽ oː d̪ ɾ ɑː
सिफ़ारत	s ɪ f ɑː ɾ ə t̪
गोल	ɡ oː l
ताजपोशी	t̪ ɑː d͡ʒ p oː ʃ iː
तुम्हें	t̪ ʊ m ɦ ẽ
जननी	d͡ʒ ə n n iː
मुराद	m ʊ ɾ ɑː d̪
कूड़ा	k uː ɽ ɑː
लगता	l ə ɡ t̪ ɑː
दोस्त	d̪ oː s t̪
प्रतिक्रियावादी	p ɾ ə t̪ ɪ k ɾ iː j ɑː ʋ ɑː d̪ iː
घायल	ɡ ʱ ɑː j ə l
महसूस	m ə ʱ s uː s
रासो	ɾ ɑː s oː
बढ़ना	b ə ɽ ʱ n ɑː
हँसली	ɦ ə̃ s l iː
ग्वारपाठा	ɡ ʋ ɑː ɾ p ɑː ʈʰ ɑː
बहुपयोगी	b ə ɦ ʊ p j oː ɡ iː
छाछ	t͡ʃʰ ɑː t͡ʃʰ
खोका	kʰ oː k ɑː
ढाल	ɖ ʱ ɑː l
कैलिफ़ोर्निया	k ɛː l ɪ f oː ɾ n iː j ɑː
सुरंग	s ʊ ɾ ə ŋ ɡ
विश्वविख्यात	ʋ ɪ ʃ ʋ ə ʋ ɪ kʰ j ɑː t̪
इत्मीनान	ɪ t̪ m iː n ɑː n
औरत	ɔː ɾ ə t̪
मजलिस	m ə d͡ʒ l ɪ s
कूड़ेदान	k uː ɽ eː d̪ ɑː n
वंशवाद	ʋ ə n ʃ ʋ ɑː d̪
चपेट	t͡ʃ ə p eː ʈ
धनादेश	d̪ ʱ ə n ɑː d̪ eː ʃ
बम्बई	b ə m b ə iː
उत्तर	ʊ t̪ t̪ ə ɾ
बुंदेलखंड	b ʊ n d̪ eː l kʰ ə n ɖ
गवाह	ɡ ə ʋ ɑː ʱ
मनोवैज्ञानिक	m ə n oː ʋ ɛː ɡ j ɑː n ɪ k
ज़ेवर	z eː ʋ ə ɾ
सांसद	s ɑː n s ə d̪
परिचित	p ə ɾ ɪ t͡ʃ ɪ t̪
सत्तासी	s ə t̪ t̪ ɑː s iː
अमरूद	ə m ɾ uː d̪
यहूदी	j ə ɦ uː d̪ iː
सारंगी	s ɑː ɾ ə ŋ ɡ iː
पटकना	p ə ʈ ə k n ɑː
तलक	t̪ ə l ə k
पहचानकर्ता	p ɛː ʱ t͡ʃ ɑː n k ə ɾ t̪ ɑː
ज़िला	z ɪ l ɑː
घोषक	ɡ ʱ oː ʃ ə k
नमूना	n ə m uː n ɑː
सम्राट	s ə m ɾ ɑː ʈ
भूगोल	b ʱ uː ɡ oː l
बर्दाश्त	b ə ɾ d̪ ɑː ʃ t̪
मालदार	m ɑː l d̪ ɑː ɾ
शहादत	ʃ ə ɦ ɑː d̪ ə t̪
कम	k ə m
रोगी	ɾ oː ɡ iː
यहीं	j ə ɦ ĩː
भड़कना	b ʱ ə ɽ ə k n ɑː
मिश्र	m ɪ ʃ ɾ
नियत	n iː j ə t̪
रीट्वीट	ɾ iː ʈ ʋ iː ʈ
श्मशान	ʃ m ə ʃ ɑː n
साप्ताहिक	s ɑː p t̪ ɑː ɦ ɪ k
मर्दाना	m ə ɾ d̪ ɑː n ɑː
कॅन्सर	k æː n s ə ɾ
मोची	m oː t͡ʃ iː
मांजा	m ɑː ɲ d͡ʒ ɑː
प्रागैतिहासिक	p ɾ ɑː ɡ ɛː t̪ ɪ ɦ ɑː s ɪ k
लाड़काना	l ɑː ɽ k ɑː n ɑː
अनुरोध	ə n ʊ ɾ oː d̪ ʱ
बीड़ा	b iː ɽ ɑː
युद्धकाल	j ʊ d̪ d̪ ʱ k ɑː l
कुम्हड़ा	k ʊ m ɦ ə ɽ ɑː
दाएँ	d̪ ɑː ẽ
पनाहगाह	p ə n ɑː ʱ ɡ ɑː ʱ
शहरी	ʃ ɛː ʱ ɾ iː
बुज़दिल	b ʊ z d̪ ɪ l
प्रत्याशा	p ɾ ə t̪ j ɑː ʃ ɑː
जुलूस	d͡ʒ ʊ l uː s
मार्गदर्शन	m ɑː ɾ ɡ d̪ ə ɾ ʃ ə n
लगे	l ə ɡ eː
अर्जित	ə ɾ d͡ʒ ɪ t̪
बचपन	b ə t͡ʃ p ə n
अक्षरारंभ	ə k ʃ ə ɾ ɑː ɾ ə m b ʱ
लुभाना	l ʊ b ʱ ɑː n ɑː
अर्धांगिनी	ə ɾ d̪ ʱ ɑː ŋ ɡ ɪ n iː
साद	s ɑː d̪
मायका	m ɑː j k ɑː
पैदावार	p ɛː d̪ ɑː ʋ ɑː ɾ
फुदकना	pʰ ʊ d̪ ə k n ɑː
मुदाख़लत	m ʊ d̪ ɑː kʰ ə l ə t̪
शो	ʃ oː
मे	m eː
कुल्हड़	k ʊ l ɦ ə ɽ
अनुसंधान	ə n ʊ s ə n d̪ ʱ ɑː n
अग्निपरीक्षा	ə ɡ n ɪ p ə ɾ iː k ʃ ɑː
हलाल	ɦ ə l ɑː l
काँच	k ɑ̃ː t͡ʃ
आकलन	ɑː k ə l ə n
श्रेष्ठ	ʃ ɾ eː ʃ ʈʰ
विपन्नता	ʋ ɪ p ə n n t̪ ɑː
कपोत	k ə p oː t̪
मण्डुक	m ə n ɖ ʊ k
समसामयिक	s ə m s ɑː m j ɪ k
धमाका	d̪ ʱ ə m ɑː k ɑː
असहमति	ə s ɛː ʱ m ə t̪ iː
सामग्री	s ɑː m ə ɡ ɾ iː
यात्री	j ɑː t̪ ɾ iː
शहज़ादा	ʃ ɛː ʱ z ɑː d̪ ɑː
कोशकला	k oː ʃ k ə l ɑː
आबदस्त	ɑː b d̪ ə s t̪
सन्नाटा	s ə n n ɑː ʈ ɑː
लिथुआनिया	l i t̪ʰ u aː n i j aː
फ़र्श	f ə ɾ ʃ
रिपोर्ट	ɾ ɪ p oː ɾ ʈ
शब्दाडंबर	ʃ ə b d̪ ɑː ɖ ə m b ə ɾ
तालिब	t̪ ɑː l ɪ b
बुद्धिजीवी	b ʊ d̪ d̪ ʱ ɪ d͡ʒ iː ʋ iː
थप्पड़	t̪ʰ ə p p ə ɽ
कुदाल	k ʊ d̪ ɑː l
जहन्नुम	d͡ʒ ɛː ʱ n n ʊ m
वन	ʋ ə n
प्रतिनिधित्व	p ɾ ə t̪ ɪ n ɪ d̪ ʱ ɪ t̪ ʋ
जैगुआर	d͡ʒ ɛː ɡ ʊ ɑː ɾ
जमशेदपुर	d͡ʒ ə m ʃ eː d̪ p ʊ ɾ
जलना	d͡ʒ ə l n ɑː
झुकना	d͡ʒ ʱ ʊ k n ɑː
उपपत्ति	ʊ p p ə t̪ t̪ iː
आरक्षण	ɑː ɾ ə k ʃ ə n
सन्देह	s ə n d̪ eː ʱ
रिक्शावाला	ɾ ɪ k ʃ ɑː ʋ ɑː l ɑː
सहरा	s ɛː ʱ ɾ ɑː
मुहाफ़ज़ाह	m ʊ ɦ ɑː f z ɑː ʱ
देहाती	d̪ eː ɦ ɑː t̪ iː
दंश	d̪ ə n ʃ
अनुनय	ə n ʊ n ə j
अनुगृहीत	ə n ʊ ɡ ɾ ɪ ɦ iː t̪
चोटी	t͡ʃ oː ʈ iː
मेयर	m eː j ə ɾ
आशय	ɑː ʃ ə j
भोला	b ʱ oː l ɑː
मनोनीत	m ə n oː n iː t̪
अपरिमेय	ə p ə ɾ ɪ m eː j
तानना	t̪ ɑː n n ɑː
सींग	s iː ŋ ɡ
परिवारवाद	p ə ɾ ɪ ʋ ɑː ɾ ʋ ɑː d̪
सत्ताईस	s ə t̪ t̪ ɑː iː s
दरवेश	d̪ ə ɾ ʋ eː ʃ
दिन	d̪ ɪ n
ब्रुनेई	b ɾ ʊ n eː iː
एक	eː k
बाल	b ɑː l
सुपुर्द	s ʊ p ʊ ɾ d̪
ग्वाटेमाला	ɡ ʋ ɑː ʈ eː m ɑː l ɑː
वर्गहीन	ʋ ə ɾ ɡ ɦ iː n
नवनी	n ə ʋ n iː
पेरू	p eː ɾ uː
फ़र्ज़ी	f ə ɾ z iː
निरीक्षक	n ɪ ɾ iː k ʃ ə k
लहरा	l ɛː ʱ ɾ ɑː
नर्तक	n ə ɾ t̪ ə k
मैला	m ɛː l ɑː
निज	n ɪ d͡ʒ
सक्रिय	s ə k ɾ ɪ j
तुरन्त	t̪ ʊ ɾ ə n t̪
जाँचना	d͡ʒ ɑ̃ː t͡ʃ n ɑː
कश्ती	k ə ʃ t̪ iː
समतल	s ə m t̪ ə l
जाहिल	d͡ʒ ɑː ɦ ɪ l
गुड़	ɡ ʊ ɽ
मां	m ɑ̃ː
पुष्कलावती	p ʊ ʃ k ə l ɑː ʋ ə t̪ iː
आपस	ɑː p ə s
नूर	n uː ɾ
ठहाका	ʈʰ ə ɦ ɑː k ɑː
अबाबील	ə b ɑː b iː l
सियाप्पा	s iː j ɑː p p ɑː
भाग	b ʱ ɑː ɡ
सैन्य	s ɛː n j
ब्राज़िल	b ɾ ɑː z ɪ l
निर्देशांक	n ɪ ɾ d̪ eː ʃ ɑː ŋ k
पुरस्कार	p ʊ ɾ ə s k ɑː ɾ
मग्न	m ə ɡ n
अवहट्ठ	ə ʋ ɦ ə ʈ ʈʰ
बीच	b iː t͡ʃ
उसका	ʊ s k ɑː
हिंदुत्व	ɦ ɪ n d̪ ʊ t̪ ʋ
स्खलन	s kʰ ə l ə n̪
अंकुर	ə ŋ k ʊ ɾ
नदारद	n ə d̪ ɑː ɾ ə d̪
हवालात	ɦ ə ʋ ɑː l ɑː t̪
अरथी	ə ɾ t̪ʰ iː
मना	m ə n ɑː
हरा	ɦ ə ɾ ɑː
गिनतारा	ɡ ɪ n t̪ ɑː ɾ ɑː
स्मृति	s m ɾ ɪ t̪ iː
उद्योगी	ʊ d̪ j oː ɡ iː
लतीफ़ा	l ə t̪ iː f ɑː
बासठ	b ɑː s ə ʈʰ
उपस्थिति	ʊ p ə s t̪ʰ ɪ t̪ iː
ईमानदार	iː m ɑː n d̪ ɑː ɾ
अलमारी	ə l m ɑː ɾ iː
अदालती	ə d̪ ɑː l ə t̪ iː
शुभेच्छु	ʃ ʊ b ʱ eː t͡ʃ t͡ʃʰ uː
अमोघ	ə m oː ɡ ʱ
विशेषता	ʋ ɪ ʃ eː ʃ t̪ ɑː
पृथ्वी	p ɾ ɪ t̪ʰ ʋ iː
खुर	kʰ ʊ ɾ
जनमतसंग्रह	d͡ʒ ə n m ə t̪ s ə ŋ ɡ ɾ ə ʱ
भक्तपुर	b ʱ ə k t̪ ə p ʊ ɾ
विशेषज्ञ	ʋ ɪ ʃ eː ʃ ə ɡ j
खुदरा	kʰ ʊ d̪ ɾ ɑː
खोया	kʰ oː j ɑː
सम्राज्ञी	s ə m ɾ ɑː ɡ j iː
मध्ययुग	m ə d̪ ʱ j ə j ʊ ɡ
असंगत	ə s ə ŋ ɡ ə t̪
बहुपद	b ə ɦ ʊ p ə d̪
रियासत	ɾ iː j ɑː s ə t̪
चरना	t͡ʃ ə ɾ n ɑː
स्वार्थी	s ʋ ɑː ɾ t̪ʰ iː
जुदाई	d͡ʒ ʊ d̪ ɑː iː
यार	j ɑː ɾ
गिरा	ɡ ɪ ɾ ɑː
सुख	s ʊ kʰ
इतालवी	ɪ t̪ ɑː l ʋ iː
अमीरी	ə m iː ɾ iː
सोनार	s oː n ɑː ɾ
तोती	t̪ oː t̪ iː
भेदभाव	b ʱ eː d̪ b ʱ ɑː ʋ
हैदर	ɦ ɛː d̪ ə ɾ
चांसलर	t͡ʃ ɑː n s l ə ɾ
चाहना	t͡ʃ ɑː ʱ n ɑː
संदल	s ə n d̪ ə l
गे	ɡ eː
शताब्दी	ʃ ə t̪ ɑː b d̪ iː
हवा	ɦ ə ʋ ɑː
जमीयत	d͡ʒ ə m iː j ə t̪
मुकुट	m ʊ k ʊ ʈ
तजुर्बा	t̪ ə d͡ʒ ʊ ɾ b ɑː
जमाव	d͡ʒ ə m ɑː ʋ
कुप्पी	k ʊ p p iː
वा	ʋ ɑː
धर्मशास्त्र	d̪ ʱ ə ɾ m ə ʃ ɑː s t̪ ɾ
बॉलीवुड	b ɔː l iː ʋ ʊ ɖ
सराफ़ा	s ə ɾ ɑː f ɑː
अछना	ə t͡ʃʰ n ɑː
निकास	n ɪ k ɑː s
व्यंजक	ʋ j ə ɲ d͡ʒ ə k
उत्तराखंड	ʊ t̪ t̪ ə ɾ ɑː kʰ ə n ɖ
उत्तोलक	ʊ t̪ t̪ oː l ə k
मालिन	m ɑː l ɪ n
विसर्जन	ʋ ɪ s ə ɾ d͡ʒ ə n
झारखण्ड	d͡ʒ ʱ ɑː ɾ kʰ ə n ɖ
कैसा	k ɛː s ɑː
बीघा	b iː ɡ ʱ ɑː
रेडॉन	ɾ eː ɖ ɔː n
पिता	p ɪ t̪ ɑː
प्रताप	p ɾ ə t̪ ɑː p
स्वेच्छा	s ʋ eː t͡ʃ t͡ʃʰ ɑː
एहसान	eː ʱ s ɑː n
अम्लीय	ə m l iː j
लुटेरा	l ʊ ʈ eː ɾ ɑː
फ़रमाइश	f ə ɾ m ɑː ɪ ʃ
अशक्त	ə ʃ ə k t̪
मुहाजिर	m ʊ ɦ ɑː d͡ʒ ɪ ɾ
पर्थ	p ə ɾ t̪ʰ
आशियाना	ɑː ʃ iː j ɑː n ɑː
पटाखा	p ə ʈ ɑː kʰ ɑː
आंतरिक	ɑː n t̪ ɾ ɪ k
छावनी	t͡ʃʰ ɑː ʋ n iː
मीचना	m iː t͡ʃ n ɑː
तहलका	t̪ ɛː ʱ l k ɑː
की	k iː
जहन्नम	d͡ʒ ɛː ʱ n n ə m
भ्रमण	b ʱ ɾ ə m ə n
साउथहैंपटन	s ɑː ʊ t̪ʰ ɦ ɛː m p ʈ ə n
श्रीकाकुलम	ʃ ɾ iː k ɑː k ʊ l ə m
पीरू	p iː ɾ uː
चंद	t͡ʃ ə n d̪
सर्प	s ə ɾ p
मुँहतोड़	m ʊ̃ ʱ t̪ oː ɽ
मदमत्त	m ə d̪ m ə t̪ t̪
हाज़िर	ɦ ɑː z ɪ ɾ
अराजकवाद	ə ɾ ɑː d͡ʒ ə k ʋ ɑː d̪
अश्वमेध	ə ʃ ʋ ə m eː d̪ ʱ
बैतनिय्याह	b ɛ t̪ ə n i jː a ɦ
अछूता	ə t͡ʃʰ uː t̪ ɑː
विभक्ति	ʋ ɪ b ʱ ə k t̪ iː
पंजीकरण	p ə ɲ d͡ʒ iː k ə ɾ ə n
आत्मसमर्पण	ɑː t̪ m s ə m ə ɾ p ə n
दौर	d̪ ɔː ɾ
अभियंत्रिकी	ə b ʱ iː j ə n t̪ ɾ ɪ k iː
मखानी	m ə kʰ ɑː n iː
कलाई	k ə l ɑː iː
तेवर	t̪ eː ʋ ə ɾ
जगह	d͡ʒ ə ɡ ɑː
नासरत	n ɑː s ə ɾ ə t̪
पाकिस्तान	p ɑː k ɪ s t̪ ɑː n
लिंग	l ɪ ŋ ɡ
आविष्कार	ɑː ʋ ɪ ʃ k ɑː ɾ
कामवाली	k ɑː m ʋ ɑː l iː
मुहतरम	m ʊ ɦ ə t̪ ɾ ə m
साझेदार	s ɑː d͡ʒ ʱ eː d̪ ɑː ɾ
तराशा	t̪ ə ɾ ɑː ʃ ɑː
बँटवारा	b ə̃ ʈ ʋ ɑː ɾ ɑː
चार	t͡ʃ ɑː ɾ
मौद्रिक	m ɔː d̪ ɾ ɪ k
नीचा	n iː t͡ʃ ɑː
वाष्पन	ʋ ɑː ʃ p ə n
चिपकू	t͡ʃ ɪ p k uː
महिमा	m ə ɦ ɪ m ɑː
षट्कोण	ʃ ə ʈ k oː n
कष्टसाध्य	k ə ʃ ʈ s ɑː d̪ ʱ j
बालिका	b ɑː l ɪ k ɑː
क्रियापद	k ɾ iː j ɑː p ə d̪
छोटा	t͡ʃʰ oː ʈ ɑː
निहारना	n ɪ ɦ ɑː ɾ n ɑː
होना	ɦ oː n ɑː
मूंग	m uː ŋ ɡ
अपलक	ə p ə l ə k
कक्ष	k ə k ʃ
महबूबा	m ɛː ʱ b uː b ɑː
निःशुल्क	n ɪʰ ʃ ʊ l k
सम्मानजनक	s ə m m ɑː n d͡ʒ ə n ə k
व्यंजनाक्षर	ʋ j ə ɲ d͡ʒ ə n ɑː k ʃ ə ɾ
गुणधर्म	ɡ ʊ n d̪ ʱ ə ɾ m
कठुआ	k ə ʈʰ ʊ ɑː
सम्मति	s ə m m ə t̪ iː
अड़सठ	ə ɽ s ə ʈʰ
हलब	ɦ ə l ə b
पृष्ठभूमि	p ɾ ɪ ʃ ʈʰ b ʱ uː m iː
घर	ɡ ʱ ə ɾ
महत्वाकांक्षा	m ɛː ʱ t̪ ʋ ɑː k ɑː ŋ k ʃ ɑː
संसिद्धि	s ə n s ɪ d̪ d̪ ʱ iː
घबराना	ɡ ʱ ə b ɾ ɑː n ɑː
भरोसेमंद	b ʱ ə ɾ oː s eː m ə n d̪
कितना	k ɪ t̪ n ɑː
स्वर	s ʋ ə ɾ
सर्द	s ə ɾ d̪
झोंकना	d͡ʒ ʱ oː ŋ k n ɑː
अलगाव	ə l ɡ ɑː ʋ
किंवदंती	k ĩ ʋ d̪ ə n t̪ iː
सुलेमान	s ʊ l eː m ɑː n
चालक	t͡ʃ ɑː l ə k
दमन	d̪ ə m ə n
सच्चरित्र	s ə t͡ʃ t͡ʃ ə ɾ ɪ t̪ ɾ
तरकारी	t̪ ə ɾ k ɑː ɾ iː
यूनिकोड	j uː n ɪ k oː ɖ
मेहमानदारी	m eː ʱ m ɑː n d̪ ɑː ɾ iː
उल्टी	ʊ l ʈ iː
विरुद्ध	ʋ ɪ ɾ ʊ d̪ d̪ ʱ
अटल	ə ʈ ə l
अंगोला	ə ŋ ɡ oː l ɑː
अभिनेत्री	ə b ʱ ɪ n eː t̪ ɾ iː
अकारथ	ə k ɑː ɾ ə t̪ʰ
गुबरैला	ɡ ʊ b ɾ ɛː l ɑː
नेटवर्क	n eː ʈ ʋ ə ɾ k
बिजलीघर	b ɪ d͡ʒ l iː ɡ ʱ ə ɾ
खसरा	kʰ ə s ɾ ɑː
फ़ानी	f ɑː n iː
आबला	ɑː b l ɑː
पनस	p ə n ə s
डीयू	ɖ iː j uː
जाम	d͡ʒ ɑː m
अंतिम	ə n t̪ ɪ m
सर्वत्र	s ə ɾ ʋ ə t̪ ɾ
दर्पण	d̪ ə ɾ p ə n
सौंपना	s ɔː m p n ɑː
सोना	s oː n ɑː
निकम्मापन	n ɪ k ə m m ɑː p ə n
दिलेरी	d̪ ɪ l eː ɾ iː
बड़	b ə ɽ
भोजपुरी	b ʱ oː d͡ʒ p ʊ ɾ iː
कल्पित	k ə l p ɪ t̪
अंग्रेजी	ə ŋ ɡ ɾ eː d͡ʒ iː
गूंगा	ɡ uː ŋ ɡ ɑː
नाच	n ɑː t͡ʃ
खोज	kʰ oː d͡ʒ
शिखर	ʃ ɪ kʰ ə ɾ
हरियाणवी	ɦ ə ɾ iː j ɑː n ʋ iː
बूँद	b ũː d̪
जीवनी	d͡ʒ iː ʋ n iː
आयुक्त	ɑː j ʊ k t̪
परिसंघ	p ə ɾ ɪ s ə ŋ ɡ ʱ
चिलवन	t͡ʃ ɪ l ʋ ə n
ढेला	ɖ ʱ eː l ɑː
उत्तम	ʊ t̪ t̪ ə m
फ्रांस	pʰ ɾ ɑː n s
शिकार	ʃ ɪ k ɑː ɾ
रक्तसंचार	ɾ ə k t̪ s ə ɲ t͡ʃ ɑː ɾ
पपीहा	p ə p iː ɦ ɑː
मेहंदी	m ɛː ʱ n d̪ iː
सरकंडा	s ə ɾ k ə n ɖ ɑː
कीचड़	k iː t͡ʃ ə ɽ
अत्यावश्यक	ə t̪ j ɑː ʋ ə ʃ j ə k
भतीजी	b ʱ ə t̪ iː d͡ʒ iː
कू	k uː
अभ्रक	ə b ʱ ɾ ə k
अल्लाह	ə l l ɑː ʱ
सोखना	s oː kʰ n ɑː
सिंहाली	s ɪ n ɦ ɑː l iː
राहत	ɾ ɑː ɦ ə t̪
तंज़	t̪ ə n z
अनुरक्षण	ə n ʊ ɾ ə k ʃ ə n
मुरीद	m ʊ ɾ iː d̪
इकलौता	ɪ k l ɔː t̪ ɑː
जादूगर	d͡ʒ ɑː d̪ uː ɡ ə ɾ
स्त्रोत	s t̪ ɾ oː t̪
खाड़ी	kʰ ɑː ɽ iː
फिल्म	pʰ ɪ l m
चढ़ना	t͡ʃ ə ɽ ʱ n ɑː
पूर्वस्नातक	p uː ɾ ʋ s n ɑː t̪ ə k
पटेल	p ə ʈ eː l
लेनिनवाद	l eː n ɪ n ʋ ɑː d̪
गुलदान	ɡ ʊ l d̪ ɑː n
हवेली	ɦ ə ʋ eː l iː
स्वतंत्रता	s ʋ ə t̪ ə n t̪ ɾ ə t̪ ɑː
अमीर	ə m iː ɾ
जनूबी	d͡ʒ ə n uː b iː
परामर्श	p ə ɾ ɑː m ə ɾ ʃ
हरिजन	ɦ ə ɾ ɪ d͡ʒ ə n
रचना	ɾ ə t͡ʃ n ɑː
ब्योंत	b j oː n t̪
प्रसाधन	p ɾ ə s ɑː d̪ ʱ ə n
ओटावा	oː ʈ ɑː ʋ ɑː
मेंह	m eː n ʱ
ही	ɦ iː
झोंका	d͡ʒ ʱ oː ŋ k ɑː
उनींदा	ʊ n iː n d̪ ɑː
संगम	s ə ŋ ɡ ə m
टनेल	ʈ ə n eː l
पुर	p ʊ ɾ
अंगीकार	ə ŋ ɡ iː k ɑː ɾ
मौसंबी	m ɔː s ə m b iː
यतीम	j ə t̪ iː m
तय	t̪ ə j
अर्धविकसित	ə ɾ d̪ ʱ ʋ ɪ k s ɪ t̪
कोह	k oː ʱ
तुफ़ंग	t̪ ʊ f ə ŋ ɡ
मारतौल	m ɑː ɾ t̪ ɔː l
देहात	d̪ eː ɦ ɑː t̪
अड़ना	ə ɽ n ɑː
इंचियोन	ɪ ɲ t͡ʃ iː j oː n
यीशु	j iː ʃ uː
रेस्तराँ	ɾ eː s t̪ ə ɾ ɑ̃ː
मालूम	m aː l uː m
से	s eː
वाकिफ	ʋ ɑː k ɪ pʰ
तुष्टीकरण	t̪ ʊ ʃ ʈ iː k ə ɾ ə n
बंधु	b ə n d̪ ʱ uː
प्रोग्राम	p ɾ oː ɡ ɾ ɑː m
झिझक	d͡ʒ ʱ ɪ d͡ʒ ʱ ə k
गंतव्य	ɡ ə n t̪ ə ʋ j
धड़कन	d̪ ʱ ə ɽ k ə n
सूद	s uː d̪
खुलेआम	kʰ ʊ l eː ɑː m
बाहर	b ɑː ɦ ə ɾ
डील	ɖ iː l
प्राध्यापक	p ɾ ɑː d̪ ʱ j ɑː p ə k
द्राक्षिरा	d̪ ɾ ɑː k ʃ ɪ ɾ ɑː
देशभक्त	d̪ eː ʃ b ʱ ə k t̪
कलंक	k ə l ə ŋ k
रिकॉर्ड	ɾ ɪ k ɔː ɾ ɖ
कैमरा	k ɛː m ɾ ɑː
इनकार	ɪ n k ɑː ɾ
मशीनी	m ə ʃ iː n iː
भांजी	b ʱ ɑː ɲ d͡ʒ iː
किरदार	k ɪ ɾ d̪ ɑː ɾ
बर्ताव	b ə ɾ t̪ ɑː ʋ
पल	p ə l
त्रासदी	t̪ ɾ ɑː s d̪ iː
उधार	ʊ d̪ ʱ ɑː ɾ
नहान	n ə ɦ ɑː n
चक्कर	t͡ʃ ə k k ə ɾ
हब्शी	ɦ ə b ʃ iː
द्विध्रुव	d̪ ʋ ɪ d̪ ʱ ɾ ʊ ʋ
भेद	b ʱ eː d̪
मानवीय	m ɑː n ə ʋ iː j
अलंकार	ə l ə ŋ k ɑː ɾ
पुड़िया	p ʊ ɽ iː j ɑː
नंगा	n ə ŋ ɡ ɑː
धनी	d̪ ʱ ə n iː
बनिज	b ə n ɪ d͡ʒ
मुलाज़िम	m ʊ l ɑː z ɪ m
समुच्चय	s ə m ʊ t͡ʃ t͡ʃ ə j
हमाहमी	ɦ ə m ɑː ɦ ə m iː
शिक्षा	ʃ ɪ k ʃ ɑː
ब्रह्मदेश	b ɾ ɛː ʱ m ə d̪ eː ʃ
इम्तहान	ɪ m t̪ ə ɦ ɑː n
पत्थर	p ə t̪ t̪ʰ ə ɾ
गैलन	ɡ ɛː l ə n
घनत्व	ɡ ʱ ə n ə t̪ ʋ
अरिहंत	ə ɾ ɪ ɦ ə n t̪
थाइलैंड	t̪ʰ ɑː ɪ l ɛː n ɖ
राजत्व	ɾ ɑː d͡ʒ ə t̪ ʋ
चकाचौंध	t͡ʃ ə k ɑː t͡ʃ ɔː n d̪ ʱ
गलना	ɡ ə l n ɑː
लाभकारक	l ɑː b ʱ k ɑː ɾ ə k
अंगच्छेद	ə ŋ ɡ ə t͡ʃ t͡ʃʰ eː d̪
निश्चित	n ɪ ʃ t͡ʃ ɪ t̪
मेवाड़	m eː ʋ ɑː ɽ
सर्वाधिक	s ə ɾ ʋ ɑː d̪ ʱ ɪ k
नसीहत	n ə s iː ɦ ə t̪
कॉमेडी	k ɔː m eː ɖ iː
सूरज	s uː ɾ ə d͡ʒ
कहानीकार	k ə ɦ ɑː n iː k ɑː ɾ
कोहनी	k oː ʱ n iː
रेल	ɾ eː l
कार्यान्वित	k ɑː ɾ j ɑː n ʋ ɪ t̪
टैक्स	ʈ ɛː k s
बाड़ी	b ɑː ɽ iː
हिचकी	ɦ ɪ t͡ʃ k iː
बहनोई	b ɛː ʱ n oː iː
इंग्लैंड	ɪ ŋ ɡ l ɛː n ɖ
झुमका	d͡ʒ ʱ ʊ m k ɑː
मानक	m ɑː n ə k
साहित्य	s ɑː ɦ ɪ t̪ j
बारह	b ɑː ɾ ə ʱ
संजाल	s ə ɲ d͡ʒ ɑː l
प्रवक्ता	p ɾ ə ʋ ə k t̪ ɑː
रूस	ɾ uː s
ऋण	ɾ ɪ n
खोंसना	kʰ oː n s n ɑː
गमला	ɡ ə m l ɑː
भारी	b ʱ ɑː ɾ iː
सोहाग	s oː ɦ ɑː ɡ
करोड़	k ə ɾ oː ɽ
चेचेन	t͡ʃ eː t͡ʃ eː n
ममेरा	m ə m eː ɾ ɑː
झिझकना	d͡ʒ ʱ ɪ d͡ʒ ʱ ə k n ɑː
बिंदास	b ɪ n d̪ ɑː s
युक्त	j ʊ k t̪
तथा	t̪ ə t̪ʰ ɑː
चतुर्थ	t͡ʃ ə t̪ ʊ ɾ t̪ʰ
कौतुकी	k ɔː t̪ ʊ k iː
आयोजन	ɑː j oː d͡ʒ ə n
भारोपीय	b ʱ ɑː ɾ oː p iː j ᵊ
टोस्ट	ʈ oː s ʈ
मिलनसार	m ɪ l ə n s ɑː ɾ
आदेश	ɑː d̪ eː ʃ
कप्तान	k ə p t̪ ɑː n
एवज़	eː ʋ ə z
उलटी	ʊ l ʈ iː
होबार्ट	ɦ oː b ɑː ɾ ʈ
मानविकी	m ɑː n ʋ ɪ k iː
पल्लव	p ə l l ə ʋ
निर्बल	n ɪ ɾ b ə l
नवासी	n ə ʋ ɑː s iː
दुनाली	d̪ ʊ n ɑː l iː
असमंजस	ə s ə m ə ɲ d͡ʒ ə s
जेठानी	d͡ʒ eː ʈʰ ɑː n iː
तेरे	t̪ eː ɾ eː
आलेख	ɑː l eː kʰ
सकल	s ə k ə l
वेद	ʋ eː d̪
अभिदृश्यक	ə b ʱ ɪ d̪ ɾ ɪ ʃ j ə k
फाफड़ा	pʰ ɑː pʰ ɽ ɑː
शून्य	ʃ uː n j ə
पुस्तकालय	p ʊ s t̪ ə k ɑː l ə j
प्रत्यक्षीकरण	p ɾ ə t̪ j ə k ʃ iː k ɾ ə n
दर्शन	d̪ ə ɾ ʃ ə n
अफ़ीम	ə f iː m
प्रतापी	p ɾ ə t̪ ɑː p iː
शरारत	ʃ ə ɾ ɑː ɾ ə t̪
सुमन	s ʊ m ə n
कार्गो	k ɑː ɾ ɡ oː
मसीही	m ə s iː ɦ iː
आवंटित	ɑː ʋ ə n ʈ ɪ t̪
संग	s ə ŋ ɡ
इटालियन	ɪ ʈ ɑː l iː j ə n
उचकना	ʊ t͡ʃ ə k n ɑː
निकारागुआ	n ɪ k ɑː ɾ ɑː ɡ ʊ ɑː
निकोबार	n ɪ k oː b ɑː ɾ
अधोहस्ताक्षरी	ə d̪ ʱ oː ɦ ə s t̪ ɑː k ʃ ə ɾ iː
इस्पात	ɪ s p ɑː t̪
लिसान	l ɪ s ɑː n
गुदाद्वार	ɡ ʊ d̪ ɑː d̪ ʋ ɑː ɾ
राजदूत	ɾ ɑː d͡ʒ d̪ uː t̪
अथक	ə t̪ʰ ə k
चौरासी	t͡ʃ ɔː ɾ ɑː s iː
दारू	d̪ ɑː ɾ uː
मोर	m oː ɾ
छूट	t͡ʃʰ uː ʈ
चक्षुदान	t͡ʃ ə k ʃ ʊ d̪ ɑː n
मिसाइल	m ɪ s ɑː ɪ l
महाशय	m ə ɦ ɑː ʃ ə j
कितने	k ɪ t̪ n eː
नतीजतन	n ə t̪ iː d͡ʒ t̪ ə n
उभरना	ʊ b ʱ ə ɾ n ɑː
रौशनी	ɾ ɔː ʃ n iː
भटूरा	b ʱ ə ʈ uː ɾ ɑː
गुदड़ी	ɡ ʊ d̪ ɽ iː
लोगों	l oː ɡ õː
पयाम	p ə j ɑː m
विनाशक	ʋ ɪ n ɑː ʃ ə k
जेद्दा	d͡ʒ eː d̪ d̪ ɑː
भटनागर	b ʱ ə ʈ n ɑː ɡ ə ɾ
आयोग	ɑː j oː ɡ
शहमात	ʃ ɛː ʱ m ɑː t̪
लापरवाह	l ɑː p ə ɾ ʋ ɑː ʱ
सिरदर्द	s ɪ ɾ d̪ ə ɾ d̪
आत्मस्तुति	ɑː t̪ m ə s t̪ ʊ t̪ iː
चिरंजीव	t͡ʃ ɪ ɾ ə ɲ d͡ʒ iː ʋ
बिचला	b ɪ t͡ʃ l ɑː
मुसाफ़िर	m ʊ s ɑː f ɪ ɾ
अंतर्धान	ə n t̪ ə ɾ d̪ ʱ ɑː n
संकल्प	s ə ŋ k ə l p
कडपा	k ə ɖ p ɑː
फ़ीता	f iː t̪ ɑː
खुदाई	kʰ ʊ d̪ ɑː iː
परात	p ə ɾ ɑː t̪
गवाही	ɡ ə ʋ ɑː ɦ iː
इमदाद	ɪ m d̪ ɑː d̪
अंग	ə ŋ ɡ
लज्जा	l ə d͡ʒ d͡ʒ ɑː
वैदिक	ʋ ɛː d̪ ɪ k
अप्रिय	ə p ɾ ɪ j
दिहाड़ी	d̪ ɪ ɦ ɑː ɽ iː
न्यारा	n j ɑː ɾ ɑː
नकारात्मक	n ə k ɑː ɾ ɑː t̪ m ə k
किताब	k ɪ t̪ ɑː b
परवरिश	p ə ɾ ʋ ə ɾ ɪ ʃ
नौजवान	n ɔː d͡ʒ ə ʋ ɑː n
नमक	n ə m ə k
फेरी	pʰ eː ɾ iː
काफी	k ɑː pʰ iː
पुतला	p ʊ t̪ l ɑː
मैदा	m ɛː d̪ ɑː
नमाज़गाह	n ə m ɑː z ɡ ɑː ʱ
गोड़ना	ɡ oː ɽ n ɑː
प्रथमतः	p ɾ ə t̪ʰ ə m t̪ əʰ
शिकंजी	ʃ ɪ k ə ɲ d͡ʒ iː
कंकाल	k ə ŋ k ɑː l
सुबकना	s ʊ b ə k n ɑː
लिपि	l ɪ p iː
जानना	d͡ʒ ɑː n n ɑː
फ़्लोरिडा	f l oː ɾ ɪ ɖ ɑː
डरबन	ɖ ə ɾ b ə n
तृतीय	t̪ ɾ ɪ t̪ iː j
कुशासन	k ʊ ʃ ɑː s ə n
ऋणदाताओ	ɾ ɪ n d̪ ɑː t̪ ɑː oː
अनामिका	ə n ɑː m ɪ k ɑː
फ़ॉर्मूला	f ɔː ɾ m uː l ɑː
परोपकार	p ə ɾ oː p k ɑː ɾ
विधेय	ʋ ɪ d̪ ʱ eː j
आयात	ɑː j ɑː t̪
नादिरशाही	n ɑː d̪ ɪ ɾ ʃ ɑː ɦ iː
दोगुना	d̪ oː ɡ ʊ n ɑː
ल्हासा	l ɦ ɑː s ɑː
पंजा	p ə ɲ d͡ʒ ɑː
घूंट	ɡ ʱ uː n ʈ
पैंट	p ɛː n ʈ
मालिकाना	m ɑː l ɪ k ɑː n ɑː
तबदील	t̪ ə b d̪ iː l
सियालकोट	s iː j ɑː l k oː ʈ
आशिष	ɑː ʃ ɪ ʃ
तारीफ़	t̪ ɑː ɾ iː f
शाल	ʃ ɑː l
फुनगी	pʰ ʊ n ɡ iː
तंज़ीम	t̪ ə n z iː m
पूरब	p uː ɾ ə b
उलूक	ʊ l uː k
नागवार	n ɑː ɡ ə ʋ ɑː ɾ
भुगतना	b ʱ ʊ ɡ ə t̪ n ɑː
रब	ɾ ə b
मानसून	m ɑː n s uː n
व्यावहारिक	ʋ j ɑː ʋ ɦ ɑː ɾ ɪ k
विद्यालयी	ʋ ɪ d̪ j ɑː l ə j iː
तरतीब	t̪ ə ɾ t̪ iː b
कंप्यूटर	k ə m p j uː ʈ ə ɾ
पणजी	p ə n d͡ʒ iː
बंदरगाह	b ə n d̪ ə ɾ ɡ ɑː ʱ
आगमन	ɑː ɡ ə m ə n
विंदालू	ʋ ɪ n d̪ ɑː l uː
सियार	s iː j ɑː ɾ
इंटरफ़ेस	ɪ n ʈ ə ɾ f eː s
चित्रण	t͡ʃ ɪ t̪ ɾ ə n
बंटना	b ə n ʈ n ɑː
इश्तिहार	ɪ ʃ t̪ ɪ ɦ ɑː ɾ
फ़ीसद	f iː s ə d̪
आयन	ɑː j ə n
उद्घाटन	ʊ d̪ ɡ ʱ ɑː ʈ ə n
अपवित्र	ə p ə ʋ ɪ t̪ ɾ
पौर	p ɔː ɾ
कायको	k ɑː j k oː
फ़िलहाल	f ɪ l ɦ ɑː l
किरगिज़	k ɪ ɾ ɡ ɪ z
इक्कीस	ɪ k k iː s
प्रेयसी	p ɾ eː j ə s iː
शौर्य	ʃ ɔː ɾ j
चमची	t͡ʃ ə m t͡ʃ iː
सतहत्तर	s ə t̪ʰ ə t̪ t̪ ə ɾ
मारवाड़ी	m ɑː ɾ ʋ ɑː ɽ iː
लापता	l ɑː p ə t̪ ɑː
हीर	ɦ iː ɾ
इब्तिदाई	ɪ b t̪ ɪ d̪ ɑː iː
दांत	d̪ ɑː n t̪
परंतु	p ə ɾ ə n t̪ uː
ताम्र	t̪ ɑː m ɾ
अमूल्य	ə m uː l j
धूआँ	d̪ ʱ uː ɑ̃ː
मूलाधार	m uː l aː d̪ ʱ aː r
घुंडी	ɡ ʱ ʊ n ɖ iː
खोटा	kʰ oː ʈ ɑː
ज़हरीला	z ɛː ʱ ɾ iː l ɑː
बीरगंज	b iː ɾ ɡ ə ɲ d͡ʒ
तह	t̪ ə ʱ
बाबत	b ɑː b ə t̪
रोज़ा	ɾ oː z ɑː
दुष्चक्र	d̪ ʊ ʃ t͡ʃ ə k ɾ
ताक	t̪ ɑː k
उन्नीस	ʊ n n iː s
रोज़ी	ɾ oː z iː
अर्धकुशल	ə ɾ d̪ ʱ k ʊ ʃ ə l
जुग	d͡ʒ ʊ ɡ
दूसरा	d̪ uː s ɾ ɑː
परिमाप	p ə ɾ ɪ m ɑː p
बब्बर	b ə b b ə ɾ
संगीन	s ə ŋ ɡ iː n
कठिन	k ə ʈʰ ɪ n
ओशिआनिया	oː ʃ iː j ɑː n iː j ɑː
आपेक्षिक	ɑː p eː k ʃ ɪ k
चोरना	t͡ʃ oː ɾ n ɑː
पद्मावत	p ə d̪ m ɑː ʋ ə t̪
घोषित	ɡ ʱ oː ʃ ɪ t̪
हॉलैंड	ɦ ɔː l ɛː n ɖ
चेरी	t͡ʃ eː ɾ iː
बादशाह	b ɑː d̪ ʃ ɑː ʱ
अनुपजाऊ	ə n ʊ p d͡ʒ ɑː uː
बेलचा	b eː l t͡ʃ ɑː
इंडिया	ɪ n ɖ iː j ɑː
झूठी	d ʒ ʱ uː ʈʰ iː
आश्चर्य	ɑː ʃ t͡ʃ ə ɾ j
ऋतु	ɾ ɪ t̪ uː
सिनेमाघर	s ɪ n eː m ɑː ɡ ʱ ə ɾ
अन्न	ə n n ə
तरबूज़ा	t̪ ə ɾ b uː z ɑː
देर	d̪ eː ɾ
अवशोषण	ə ʋ ʃ oː ʃ ə n
अंतराल	ə n t̪ ə ɾ ɑː l
धर्मनिरपेक्षता	d̪ ʱ ə ɾ m n ɪ ɾ p eː k ʃ t̪ ɑː
असंभावित	ə s ə m b ʱ ɑː ʋ ɪ t̪
मनीऑर्डर	m ə n iː ɔː ɾ ɖ ə ɾ
मस्तक	m ə s t̪ ə k
शब्द	ʃ ə b d̪
बरेली	b ə ɾ eː l iː
खान	kʰ ɑː n
सुलाना	s ʊ l ɑː n ɑː
शिवांबु	ʃ ɪ ʋ ɑː m b uː
चबाना	t͡ʃ ə b ɑː n ɑː
मौसमी	m ɔː s m iː
भिन्नता	b ʱ ɪ n n t̪ ɑː
दिक्पात	d̪ ɪ k p ɑː t̪
मिस्टर	m ɪ s ʈ ə ɾ
अनुरूप	ə n ʊ ɾ uː p
शिशुशाला	ʃ ɪ ʃ ʊ ʃ ɑː l ɑː
जमना	d͡ʒ ə m n ɑː
अनुदान	ə n ʊ d̪ ɑː n
पुर्तगाल	p ʊ ɾ t̪ ə ɡ ɑː l
तिल्ली	t̪ ɪ l l iː
ईटानगर	iː ʈ ɑː n ə ɡ ə ɾ
आचरण	ɑː t͡ʃ ə ɾ ə n
पैराग्वे	p ɛː ɾ ɑː ɡ ʋ eː
जलवा	d͡ʒ ə l ʋ ɑː
शीरी	ʃ iː ɾ iː
निरस्त्रीकरण	n ɪ ɾ ə s t̪ ɾ iː k ɾ ə n
किफ़ायत	k ɪ f ɑː j ə t̪
कोची	k oː t͡ʃ iː
प्राणवायु	p ɾ ɑː n ʋ ɑː j uː
भँवरा	b ʱ ə̃ ʋ ɾ ɑː
सुनसान	s ʊ n s ɑː n
घटित	ɡ ʱ ə ʈ ɪ t̪
परिधि	p ə ɾ ɪ d̪ ʱ iː
मिस्त्री	m ɪ s t̪ ɾ iː
खटाई	kʰ ə ʈ aː iː
वर्णमाला	ʋ ə ɾ n m ɑː l ɑː
नजूमी	n ə d͡ʒ uː m iː
तराज़ू	t̪ ə ɾ ɑː z uː
नदी	n ə d iː
खल्लास	kʰ ə l l ɑː s
बहरापन	b ɛː ʱ ɾ ɑː p ə n
झालर	d͡ʒ ʱ ɑː l ə ɾ
कड़वा	k ə ɽ ʋ ɑː
उनतीस	ʊ n t̪ iː s
डिक्की	ɖ ɪ k k iː
प्राकृतिक	p ɾ ɑː k ɾ ɪ t̪ ɪ k
अवलोकन	ə ʋ l oː k ə n
यद्यपि	j ə d̪ j ə p iː
बनाम	b ə n ɑː m
अरगनी	ə ɾ ə ɡ n iː
बिच्छू	b ɪ t͡ʃ t͡ʃʰ uː
हज्ज	ɦ ə d͡ʒ d͡ʒ
टैंकर	ʈ ɛː ŋ k ə ɾ
हड़ताल	ɦ ə ɽ t̪ ɑː l
इकतालीस	ɪ k t̪ ɑː l iː s
सफ़ेद	s ə f eː d̪
टूर्नामेंट	ʈ uː ɾ n ɑː m eː n ʈ
ढिशूम	ɖ ʱ ɪ ʃ uː m
छंद	t͡ʃʰ ə n d̪
फर्न	pʰ ə ɾ n
चाँटा	t͡ʃ ɑ̃ː ʈ ɑː
रगड़न	ɾ ə ɡ ɽ ə n
क्षत्रिय	k ʃ ə t̪ ɾ iː j ə
तेलंगाना	t̪ eː l ə ŋ ɡ ɑː n ɑː
कूल्हा	k uː l ɦ ɑː
वज़ीर	ʋ ə z iː ɾ
नामीबिया	n ɑː m iː b iː j ɑː
प्रयोगशाला	p ɾ ə j oː ɡ ʃ ɑː l ɑː
तिरछा	t̪ ɪ ɾ t͡ʃʰ ɑː
गुर्जिस्तान	ɡ ʊ ɾ d͡ʒ ɪ s t̪ ɑː n
पक्ष	p ə k ʃ
ओडिशा	oː ɖ ɪ ʃ ɑː
निरीक्षण	n ɪ ɾ iː k ʃ ə n
जगमगाना	d͡ʒ ə ɡ m ə ɡ ɑː n ɑː
कर्तव्यपथ	k ə ɾ t̪ ə ʋ j ə p ə t̪ʰ
चिढ़ना	t͡ʃ ɪ ɽ ʱ n ɑː
गोदी	ɡ oː d̪ iː
फ़्राँस	f ɾ ɑ̃ː s
त्रिकोणमितीय	t̪ ɾ ɪ k oː n m ɪ t̪ iː j
काबीना	k ɑː b iː n ɑː
ज़िद	z ɪ d̪
संस्कारी	s ə n s k ɑː ɾ iː
देने	d̪ eː n eː
चिरस्थायी	t͡ʃ ɪ ɾ s t̪ʰ ɑː j iː
सवार	s ə ʋ ɑː ɾ
रक्त	ɾ ə k t̪
सेठ	s eː ʈʰ
बहाल	b ə ɦ ɑː l
दहना	d̪ ɛː ʱ n ɑː
अभी	ə b ʱ iː
सेंट	s eː n ʈ
टर्मिनल	ʈ ə ɾ m ɪ n ə l
बीस	b iː s
यानी	j ɑː n iː
महारत	m ə ɦ ɑː ɾ ə t̪
कमल	k ə m ə l
कल्पना	k ə l p ə n ɑː
प्राधिकारी	p ɾ ɑː d̪ ʱ ɪ k ɑː ɾ iː
मुहर्रम	m ʊ ɦ ə ɾ ɾ ə m
भ्रष्ट	b ʱ ɾ ə ʃ ʈ
प्रासंगिकता	p ɾ ɑː s ə ŋ ɡ ɪ k t̪ ɑː
वास्कट	ʋ ɑː s k ə ʈ
प्रशिक्षण	p ɾ ə ʃ ɪ k ʃ ə n
बेअक़्ल	b eː ə q ə l̪
धैर्य	d̪ ʱ ɛː ɾ j
रौशन	ɾ ɔː ʃ ə n
परिणामस्वरूप	p ə ɾ ɪ n ɑː m s ʋ ə ɾ uː p
सानी	s ɑː n iː
सरसों	s ə ɾ s õː
जिन्न	d͡ʒ ɪ n n
तर्जनी	t̪ ə ɾ d͡ʒ ə n iː
दुर्घटनाग्रस्त	d̪ ʊ ɾ ɡ ʱ ə ʈ n ɑː ɡ ɾ ə s t̪
पड़ताल	p ə ɽ t̪ ɑː l
सियापति	s iː j ɑː p ə t̪ iː
तीरंदाज़	t̪ iː ɾ ə n d̪ ɑː z
फिसलन	pʰ ɪ s l ə n
कार्डिफ़	k ɑː ɾ ɖ ɪ f
नहीं	n ə ɦ ĩː
छियालीस	t͡ʃʰ iː j ɑː l iː s
शिकस्त	ʃ ɪ k ə s t̪
छेड़छाड़	t͡ʃʰ eː ɽ t͡ʃʰ ɑː ɽ
बिना	b ɪ n ɑː
अठन्नी	ə ʈʰ ə n n iː
बल्लेबाज़	b ə l l eː b ɑː z
रक्षित	ɾ ə k ʃ ɪ t̪
हींग	ɦ iː ŋ ɡ
गश्त	ɡ ə ʃ t̪
दरी	d̪ ə ɾ iː
सहकारी	s ɛː ʱ k ɑː ɾ iː
अश्लील	ə ʃ l iː l
श्लोक	ʃ l oː k
बदतर	b ə d̪ t̪ ə ɾ
हुक्मरान	ɦ ʊ k m ɾ ɑː n
आरज़ू	ɑː ɾ z uː
रफ़ू	ɾ ə f uː
सट्टेबाज़	s ə ʈ ʈ eː b ɑː z
उपचार	ʊ p t͡ʃ ɑː ɾ
जनसंख्या	d͡ʒ ə n s ə ŋ kʰ j ɑː
अतिवादी	ə t̪ ɪ ʋ ɑː d̪ iː
अकारण	ə k ɑː ɾ ə n
रक्षा	ɾ ə k ʃ ɑː
जीभ	d͡ʒ iː b ʱ
शायरा	ʃ ɑː j ə ɾ ɑː
लुंबिनी	l ʊ m b ɪ n iː
महज़	m ɛː ʱ z
सीना	s iː n ɑː
मामू	m ɑː m uː
कमेंट	k ə m eː n ʈ
ढाका	ɖ ʱ ɑː k ɑː
औद्योगीकरण	ɔː d̪ j oː ɡ iː k ə ɾ ə n
निषेधात्मक	n ɪ ʃ eː d̪ ʱ ɑː t̪ m ə k
सलाम	s ə l ɑː m
जोहना	d͡ʒ oː ʱ n ɑː
शरमाना	ʃ ə ɾ m ɑː n ɑː
गहन	ɡ ɛː ʱ n
छिपकली	t͡ʃʰ ɪ p k ə l iː
अट्ठासी	ə ʈ ʈʰ ɑː s iː
ईमेल	iː m eː l
चूड़ी	t͡ʃ uː ɽ iː
चटगांव	t͡ʃ ə ʈ ɡ ɑ̃ː ʋ
मच्छी	m ə t͡ʃ t͡ʃʰ iː
मीरा	m iː ɾ ɑː
थू	t̪ʰ uː
प्रलय	p ɾ ə l ə j
अरारोट	ə ɾ ɑː ɾ oː ʈ
आगे	ɑː ɡ eː
स्थिर	s t̪ʰ ɪ ɾ
करेला	k ə ɾ eː l ɑː
शिल्पशाला	ʃ ɪ l p ʃ ɑː l ɑː
भजमन	b ʱ ə d͡ʒ m ə n
बारीक	b ɑː ɾ iː k
यमराज	j ə m ɾ ɑː d͡ʒ
अमन	ə m ə n
फ़सल	f ə s ə l
आवंटन	ɑː ʋ ə n ʈ ə n
नौका	n ɔː k ɑː
प्रासंगिक	p ɾ ɑː s ə ŋ ɡ ɪ k
संदेश	s ə n d̪ eː ʃ
जज़ीरा	d͡ʒ ə z iː ɾ ɑː
उड़ना	ʊ ɽ n ɑː
नवीन	n ə ʋ iː n
निहारिका	n ɪ ɦ ɑː ɾ ɪ k ɑː
स्विट्ज़रलैण्ड	s ʋ ɪ ʈ z ə ɾ l ɛː n ɖ
एडिलेड	eː ɖ ɪ l eː ɖ
विंडसर	ʋ ɪ n ɖ s ə ɾ
हामी	ɦ ɑː m iː
ज़ोर	z oː ɾ
साउथॉल	s ɑː ʊ t̪ʰ ɔː l
ज़्यादा	z j ɑː d̪ ɑː
खोपड़ी	kʰ oː p ɽ iː
पट्ठा	p ə ʈ ʈʰ ɑː
बरसात	b ə ɾ s ɑː t̪
घोटाला	ɡ ʱ oː ʈ ɑː l ɑː
घुसपैठ	ɡ ʱ ʊ s p ɛː ʈʰ
तमे	t̪ ə m eː
उनसठ	ʊ n s ə ʈʰ
गदा	ɡ ə d̪ ɑː
रंगकर्म	ɾ ə ŋ ɡ k ə ɾ m
पाजी	p ɑː d͡ʒ iː
दही	d̪ ə ɦ iː
नाम	n ɑː m
गहरा	ɡ ɛː ʱ ɾ ɑː
संचयन	s ə m t͡ʃ ə j ə n
निष्पक्ष	n ɪ ʃ p ə k ʃ
पाँव	p ɑ̃ː ʋ
नक्को	n ə k k oː
ध्वंसावशेष	d̪ ʱ ʋ ə n s ɑː ʋ ʃ eː ʃ
मंगवाना	m ə ŋ ɡ ʋ ɑː n ɑː
आधारभूत	ɑː d̪ ʱ ɑː ɾ b ʱ uː t̪
तीज	t̪ iː d͡ʒ
अवकलज	ə ʋ k ə l ə d͡ʒ
गढ़	ɡ ə ɽ ʱ
जर्मनी	d͡ʒ ə ɾ m ə n̪ iː
गायक	ɡ ɑː j ə k
अनुज्ञप्ति	ə n ʊ ɡ j ə p t̪ iː
मदुरै	m ə d̪ ʊ ɾ ɛː
सुई	s uː iː
स्वायत्तता	s ʋ ɑː j ə t̪ t̪ t̪ ɑː
ट्रंप	ʈ ɾ ə m p
राष्ट्रगान	ɾ ɑː ʃ ʈ ɾ ə ɡ ɑː n
कबाड़	k ə b ɑː ɽ
अधीनता	ə d̪ ʱ iː n t̪ ɑː
डॉक्टर	ɖ ɔː k ʈ ə ɾ
गुरुत्व	ɡ ʊ ɾ ʊ t̪ ʋ ə
चपत	t͡ʃ ə p ə t̪
कूदना	k uː d̪ n ɑː
अर्जन	ə ɾ d͡ʒ ə n
शूटिंग	ʃ uː ʈ ɪ ŋ ɡ
फोड़ा	pʰ oː ɽ ɑː
कलात्मक	k ə l ɑː t̪ m ə k
बनाने	b ə n ɑː n eː
वंशावली	ʋ ə n ʃ ɑː ʋ ə l iː
पोका	p oː k ɑː
अबिचल	ə b ɪ t͡ʃ ə l
दिलचस्प	d̪ ɪ l t͡ʃ ə s p
जनकपुर	d͡ʒ ə n ə k p ʊ ɾ
कर	k ə ɾ
शतरंज	ʃ ə t̪ ɾ ə ɲ d͡ʒ
मेमो	m eː m oː
झूठे	d ʒ ʱ uː ʈʰ e
लालची	l ɑː l t͡ʃ iː
अभियोजक	ə b ʱ iː j oː d͡ʒ ə k
नारंगी	n ɑː ɾ ə ŋ ɡ iː
मच्छर	m ə t͡ʃ t͡ʃʰ ə ɾ
अनगिनत	ə n ɡ ɪ n ə t̪
इसे	ɪ s eː
पकवान	p ə k ʋ ɑː n
ज़ैतून	z ɛː t̪ uː n
बंगाली	b ə ŋ ɡ ɑː l iː
सुन्नत	s ʊ n n ə t̪
विश्लेषक	ʋ ɪ ʃ l eː ʃ ə k
आध्यात्मिक	ɑː d̪ ʱ j ɑː t̪ m ɪ k
फ़ौज	f ɔː d͡ʒ
बैरा	b ɛː ɾ ɑː
गंजा	ɡ ə ɲ d͡ʒ ɑː
हमशक्ल	ɦ ə m ʃ ə k l
वही	ʋ ə ɦ iː
कैनबरा	k ɛː n ə b ɾ ɑː
बाज़ारी	b ɑː z ɑː ɾ iː
पदयात्रा	p ə d̪ j ɑː t̪ ɾ ɑː
मंशा	m ə n ʃ ɑː
ब्रूनेई	b ɾ uː n eː iː
जितना	d͡ʒ ɪ t̪ n ɑː
पुश्तैनी	p ʊ ʃ t̪ ɛː n iː
बगला	b ə ɡ l ɑː
मुक्का	m ʊ k k ɑː
उधेड़ना	ʊ d̪ ʱ eː ɽ n ɑː
समारोह	s ə m ɑː ɾ oː ʱ
बरामदा	b ə ɾ ɑː m d̪ ɑː
भोग	b ʱ oː ɡ
पश्चिमी	p ə ʃ t͡ʃ ɪ m iː
अंगदान	ə ŋ ɡ d̪ ɑː n
भाषाविद्	b ʱ ɑː ʃ ɑː ʋ ɪ d̪
उपाध्याय	ʊ p ɑː d̪ ʱ j ɑː j
छड़ी	t͡ʃʰ ə ɽ iː
मर्यादा	m ə ɾ j ɑː d̪ ɑː
भाड़ा	b ʱ ɑː ɽ ɑː
अभियंता	ə b ʱ iː j ə n t̪ ɑː
स्वदेशी	s ʋ ə d̪ eː ʃ iː
हिचकिचाना	ɦ ɪ t͡ʃ k ɪ t͡ʃ ɑː n ɑː
बदमाश	b ə d̪ m ɑː ʃ
हिजरत	ɦ ɪ d͡ʒ ɾ ə t̪
झाड़	d͡ʒ ʱ ɑː ɽ
गिद्ध	ɡ ɪ d̪ d̪ ʱ
मोहताज	m oː ʱ t̪ ɑː d͡ʒ
रग	ɾ ə ɡ
होकर	ɦ oː k ə ɾ
मद्धम	m ə d̪ d̪ ʱ ə m
मँगनी	m ə̃ ɡ n iː
रहस्यमय	ɾ ɛː ʱ s j ə m ə j
जुलना	d͡ʒ ʊ l n ɑː
कर्मभूमि	k ə ɾ m b ʱ uː m iː
किए	k ɪ eː
नीयत	n iː j ə t̪
अजमोद	ə d͡ʒ m oː d̪
जनूब	d͡ʒ ə n uː b
सेज	s eː d͡ʒ
जन्मदिन	d͡ʒ ə n ə m d̪ ɪ n
बद्दुआ	b ə d̪ d̪ ʊ ɑː
परिचय	p ə ɾ ɪ t͡ʃ ə j
बालू	b ɑː l uː
सवेरे	s ə ʋ eː ɾ eː
करोड़पति	k ə ɾ oː ɽ p ə t̪ iː
बहुसंख्यक	b ə ɦ ʊ s ə ŋ kʰ j ə k
क्षत्राणी	k ʃ ə t̪ ɾ ɑː n iː
यूनानी	j uː n ɑː n iː
बाल्यावस्था	b ɑː l j ɑː ʋ ə s t̪ʰ ɑː
मध्यवर्ती	m ə d̪ ʱ j ə ʋ ə ɾ t̪ iː
शकरकंद	ʃ ə k ə ɾ k ə n d̪
व्रत	ʋ ɾ ə t̪
स्वाध्याय	s ʋ ɑː d̪ ʱ j ɑː j
कवचित	k ə ʋ ə t͡ʃ ɪ t̪
उत्पाद	ʊ t̪ p ɑː d̪
अनुकूल	ə n ʊ k uː l
कन्नौज	k ə n n ɔː d͡ʒ
कर्नाटक	k ə ɾ n ɑː ʈ ə k
चेप	t͡ʃ eː p
मोम	m oː m
अविनय	ə ʋ ɪ n ə j
धरपकड़	d̪ ʱ ə ɾ p ə k ə ɽ
दक्षिणपंथी	d̪ ə k ʃ ɪ n p ə n t̪ʰ iː
चेला	t͡ʃ eː l ɑː
प्रभारी	p ɾ ə b ʱ ɑː ɾ iː
क्रमागत	k ɾ ə m ɑː ɡ ə t̪
जड़	d͡ʒ ə ɽ
अधिनायक	ə d̪ ʱ ɪ n ɑː j ə k
मौसी	m ɔː s iː
सिफ़र	s ɪ f ə ɾ
कुआँ	k ʊ ɑ̃ː
भड़कीला	b ʱ ə ɽ k iː l ɑː
सशुल्क	s ə ʃ ʊ l k
बासन	b ɑː s ə n
मेला	m eː l ɑː
आदम	ɑː d̪ ə m
मुस्लिम	m ʊ s l ɪ m
उनासी	ʊ n ɑː s iː
सवर्ण	s ə ʋ ə ɾ n
सैकड़ा	s ɛː k ɽ ɑː
प्रविष्टि	p ɾ ə ʋ ɪ ʃ ʈ iː
प्रतिरोधक	p ɾ ə t̪ ɪ ɾ oː d̪ ʱ ə k
मरघट	m ə ɾ ɡ ʱ ə ʈ
पार	p ɑː ɾ
शिकोहाबाद	ʃ ɪ k oː ɦ ɑː b ɑː d̪
पालथी	p ɑː l t̪ʰ iː
बुनियाद	b ʊ n ɪ j ɑː d̪
हर्ज	ɦ ə ɾ d͡ʒ
रनवास	ɾ ə n ʋ ɑː s
संतुलित	s ə n t̪ ʊ l ɪ t̪
विचारपूर्वक	ʋ ɪ t͡ʃ ɑː ɾ p uː ɾ ʋ ə k
संस्थान	s ə n s t̪ʰ ɑː n
अंगूठा	ə ŋ ɡ uː ʈʰ ɑː
रुग्णालय	ɾ ʊ ɡ n ɑː l ə j
नरगिस	n ə ɾ ɡ ɪ s
अनुचित	ə n ʊ t͡ʃ ɪ t̪
पुण्डरी	p ʊ n ɖ ə ɾ iː
लफ़्ज़	l ə f z
उद्योगीकरण	ʊ d̪ j oː ɡ iː k ə ɾ ə n
चींटा	t͡ʃ iː n ʈ ɑː
संगठनात्मक	s ə ŋ ɡ ə ʈʰ ə n ɑː t̪ m ə k
कुख्याति	k ʊ kʰ j ɑː t̪ iː
जांघ	d͡ʒ ɑː ŋ ɡ ʱ
प्रदाता	p ɾ ə d̪ ɑː t̪ ɑː
इंतिफ़ादा	ɪ n t̪ ɪ f ɑː d̪ ɑː
लंबाई	l ə m b ɑː iː
निगलना	n ɪ ɡ ə l n ɑː
पारिश्रमिक	p ɑː ɾ ɪ ʃ ɾ ə m ɪ k
मूँह	m ũː ʱ
माथा	m ɑː t̪ʰ ɑː
तासीर	t̪ ɑː s iː ɾ
शब्दावली	ʃ ə b d äː ʋ l iː
नया	n ə j ɑː
पुल्लिंग	p ʊ l l ɪ ŋ ɡ
रोहिंग्या	ɾ oː ɦ ɪ ŋ ɡ j ɑː
असत्याभास	ə s ə t̪ j ɑː b ʱ ɑː s
झरोखा	d͡ʒ ʱ ə ɾ oː kʰ ɑː
सुथरा	s ʊ t̪ʰ ɾ ɑː
पार्श्वसरट	p ɑː ɾ ʃ ʋ s ə ɾ ə ʈ
आड़ू	ɑː ɽ uː
लाजवाब	l ɑː d͡ʒ ə ʋ ɑː b
शतपाद	ʃ ə t̪ p ɑː d̪
बेगुनाह	b eː ɡ ʊ n ɑː ʱ
कोशिका	k oː ʃ ɪ k ɑː
बुड्ढी	b ʊ ɖ ɖ ʱ iː
तलाव	t̪ ə l ɑː ʋ
कार्य	k ɑː ɾ j
हटाना	ɦ ə ʈ ɑː n ɑː
किलो	k ɪ l oː
आडवाणी	ɑː ɖ ʋ ɑː n iː
आब	ɑː b
मिस्र	m ɪ s ɾ
बिटकॉइन	b ɪ ʈ k ɔː ɪ n
छोले	t͡ʃʰ oː l eː
मिति	m ɪ t̪ iː
पदाधिकारी	p ə d̪ ɑː d̪ ʱ ɪ k ɑː ɾ iː
ईरान	iː ɾ ɑː n
निरोग	n ɪ ɾ oː ɡ
ठिठुरना	ʈʰ ɪ ʈʰ ʊ ɾ n ɑː
अंडोरा	ə n ɖ oː ɾ ɑː
महल	m ɛː ʱ l
बलूचिस्तान	b ə l uː t͡ʃ ɪ s t̪ ɑː n
स्तनपायी	s t̪ ə n p ɑː j iː
सुमात्रा	s ʊ m ɑː t̪ ɾ ɑː
चिकना	t͡ʃ ɪ k n ɑː
चुंबकीय	t͡ʃ ʊ m b ə k iː j
बावला	b ɑː ʋ l ɑː
खर्च	kʰ ə ɾ t͡ʃ
सुधारवादी	s ʊ d̪ ʱ ɑː ɾ ʋ ɑː d̪ iː
कुटिल	k ʊ ʈ ɪ l
डालना	ɖ ɑː l n ɑː
वापसी	ʋ ɑː p s iː
यवशर्करा	j ə ʋ ʃ ə ɾ k ə ɾ ɑː
विदा	ʋ ɪ d̪ ɑː
गाड़ना	ɡ ɑː ɽ n ɑː
शमा	ʃ ə m ɑː
गाँववाला	ɡ ɑ̃ː ʋ ʋ ɑː l ɑː
पिंजरा	p ɪ ɲ d͡ʒ ɾ ɑː
खनिज	kʰ ə n ɪ d͡ʒ
तुर्कमेनिस्तान	t̪ ʊ ɾ k m eː n ɪ s t̪ ɑː n
सर्जन	s ə ɾ d͡ʒ ə n
उनका	ʊ n k ɑː
अध्यापक	ə d̪ ʱ j ɑː p ə k
अरबिंद	ə ɾ b ɪ n d̪
पसार	p ə s ɑː ɾ
कामना	k ɑː m n ɑː
तुरही	t̪ ʊ ɾ ɦ iː
मैलवेयर	m ɛː l ʋ eː j ə ɾ
असम	ə s ə m
सौंह	s ɔ̃ː ʱ
अधिवार्षिकी	ə d̪ ʱ ɪ ʋ ɑː ɾ ʃ ɪ k iː
ऊन	uː n
प्रांगार	p ɾ ɑː ŋ ɡ ɑː ɾ
कबूतर	k ə b uː t̪ ə ɾ
इमली	ɪ m l iː
उत्कृष्ट	ʊ t̪ k ɾ ɪ ʃ ʈ
अवशोषित	ə ʋ ʃ oː ʃ ɪ t̪
अजनबियत	ə d͡ʒ n ə b iː j ə t̪
निर्माण	n ɪ ɾ m ɑː n
काठमांडू	k ɑː ʈʰ m ɑː n ɖ uː
तंबोला	t̪ ə m b oː l ɑː
ढाई	ɖ ʱ ɑː iː
अकाल	ə k ɑː l
नुमाइंदगी	n ʊ m ɑː ɪ n d̪ ə ɡ iː
कानपुर	k ɑː n p ʊ ɾ
बिकवाल	b ɪ k ʋ ɑː l
भेड़	b ʱ eː ɽ
ज़ुल्फ़	z ʊ l f
अवोकाडो	ə ʋ oː k ɑː ɖ oː
भरतपुर	b ʱ ə ɾ ə t̪ p ʊ ɾ
नाज़ुकी	n ɑː z ʊ k iː
वैवाहिक	ʋ ɛː ʋ ɑː ɦ ɪ k
संकेत	s ə ŋ k eː t̪
इथियोपिया	ɪ t̪ʰ iː j oː p iː j ɑː
व्यंजन	ʋ j ə ɲ d͡ʒ ə n
ऊष्मीकरण	uː ʃ m iː k ɾ ə n
शहरवासी	ʃ ɛː ʱ ɾ ʋ ɑː s iː
आइस्ड	ɑː ɪ s ɖ
सालभर	s ɑː l b ʱ ə ɾ
सूनू	s uː n uː
चपाती	t͡ʃ ə p ɑː t̪ iː
सूची	s uː t͡ʃ iː
जनभाषा	d͡ʒ ə n b ʱ ɑː ʃ ɑː
मार्फ़िया	m ɑː ɾ f iː j ɑː
दक्ष	d̪ ə k ʃ
मामी	m ɑː m iː
शत	ʃ ə t̪
तरेरना	t̪ ə ɾ eː ɾ n ɑː
लाट	l ɑː ʈ
होंडुरस	ɦ oː n ɖ ʊ ɾ ə s
टीकाकरण	ʈ iː k ɑː k ə ɾ ə n
अरुचिकर	ə ɾ ʊ t͡ʃ ɪ k ə ɾ
राजनयिक	ɾ ɑː d͡ʒ n ə j ɪ k
सिपाही	s ɪ p ɑː iː
अचरज	ə t͡ʃ ɾ ə d͡ʒ
जोखिम	d͡ʒ oː kʰ ɪ m
कितक	k ɪ t̪ ə k
जॉर्डन	d͡ʒ ɔː ɾ ɖ ə n
वास्तुकला	ʋ ɑː s t̪ ʊ k ə l ɑː
आहार	ɑː ɦ ɑː ɾ
हमलावर	ɦ ə m l ɑː ʋ ə ɾ
सुभानअल्लाह	s ʊ b ʱ ɑː n ‿ ə l l ɑː ʱ
सेवा	s eː ʋ ɑː
एस्टोनिया	eː s ʈ oː n iː j ɑː
चटनी	t͡ʃ ə ʈ n iː
हरामी	ɦ ə ɾ ɑː m iː
मटकना	m ə ʈ ə k n ɑː
पादरी	p ɑː d̪ ɾ iː
अवकलन	ə ʋ k ə l ə n
कर्मी	k ə ɾ m iː
सिकंदराबाद	s ɪ k ə n d̪ ə ɾ ɑː b ɑː d̪
उपन्यासकार	ʊ p ə n j ɑː s k ɑː ɾ
सतह	s ə t̪ ə ʱ
परिक्रमा	p ə ɾ ɪ k ɾ ə m ɑː
तुझ	t̪ ʊ d͡ʒ ʱ
मुक्केबाज़	m ʊ k k eː b ɑː z
खग	kʰ ə ɡ
ललकार	l ə l k ɑː ɾ
भिन्न	b ʱ ɪ n n
तान	t̪ ɑː n
साहसी	s ɑː ʱ s iː
स्वभाव	s w ə b ʱ ɑː ʋ
तद्भव	t̪ ə d̪ b ʱ ə ʋ
आतिशबाजी	ɑː t̪ ɪ ʃ b ɑː d͡ʒ iː
रखा	ɾ ə kʰ ɑː
वॉट	ʋ ɔː ʈ
नसीब	n ə s iː b
उन्नाव	ʊ n n ɑː ʋ
मँगवाना	m ə ŋ ɡ ʋ ɑː n ɑː
अर्थात	ə ɾ t̪ʰ ɑː t̪
सहमत	s ɛː ʱ m ə t̪
सस्ता	s ə s t̪ ɑː
समाजसेवा	s ə m ɑː d͡ʒ s eː ʋ ɑː
थापना	t̪ʰ ɑː p n ɑː
सूजन	s uː d͡ʒ ə n
हस्ती	ɦ ə s t̪ iː
चुड़ैल	t͡ʃ ʊ ɽ ɛː l
चलना	t͡ʃ ə l n ɑː
छड़	t͡ʃʰ ə ɽ
सीट	s iː ʈ
मसनवी	m ə s n ə ʋ iː
अदहन	ə d̪ ʱ ə n
ममता	m ə m t̪ ɑː
कड़वापन	k ə ɽ ʋ ɑː p ə n
नवरात्रि	n ə ʋ ɾ ɑː t̪ ɾ iː
उन्मुक्त	ʊ n m ʊ k t̪
तलना	t̪ ə l n ɑː
निष्फल	n ɪ ʃ pʰ ə l
अधिसूचना	ə d̪ ʱ ɪ s uː t͡ʃ n ɑː
आदर	ɑː d̪ ə ɾ
चाँद	t͡ʃ ɑː n d̪
बिछाना	b ɪ t͡ʃʰ ɑː n ɑː
फ़िदा	f ɪ d̪ ɑː
अज़ाब	ə z ɑː b
अनुकूलन	ə n ʊ k uː l ə n
प्रतिरोध	p ɾ ə t̪ ɪ ɾ oː d̪ ʱ
लंगोटी	l ə ŋ ɡ oː ʈ iː
औपचारिक	ɔː p t͡ʃ ɑː ɾ ɪ k
लट्टू	l ə ʈ ʈ uː
कंडकटर	k ə n ɖ ə k ʈ ə ɾ
निकट	n ɪ k ə ʈ
चित्रकला	t͡ʃ ɪ t̪ ɾ k ə l ɑː
औषधीय	ɔː ʃ d̪ ʱ iː j
विभाजन	ʋ ɪ b ʱ ɑː d͡ʒ ə n
मैसिडोनिया	m ɛː s ɪ ɖ oː n iː j ɑː
फूल	pʰ uː l
फ़िनलैंड	f ɪ n l ɛː n ɖ
धनबाद	d̪ ʱ ə n b ɑː d̪
दिया	d̪ iː j ɑː
अनेक	ə n eː k
दंग	d̪ ə ŋ ɡ
जूझना	d͡ʒ uː d͡ʒ ʱ n ɑː
अमावस	ə m ɑː ʋ ə s
दावा	d̪ ɑː ʋ ɑː
व्लादिवोस्तोक	ʋ l ɑː d̪ ɪ ʋ oː s t̪ oː k
ये	j eː
संडास	s ə n ɖ ɑː s
बेगम	b eː ɡ ə m
अधिनियम	ə d̪ ʱ ɪ n iː j ə m
सांद्रता	s ɑː n d̪ ɾ ə t̪ ɑː
सुधारना	s ʊ d̪ ʱ ɑː ɾ n ɑː
प्यार	p j ɑː ɾ
दूना	d̪ uː n ɑː
पुरज़ा	p ʊ ɾ z ɑː
चलचित्रण	t͡ʃ ə l t͡ʃ ɪ t̪ ɾ ə n
गिनी	ɡ ɪ n iː
आमंत्रित	ɑː m ə n t̪ ɾ ɪ t̪
पुट्ठा	p ʊ ʈ ʈʰ ɑː
पेन	p e n
कमरा	k ə m ɾ ɑː
बरगद	b ə ɾ ɡ ə d̪
एकवर्णीय	eː k ʋ ə ɾ n iː j
अनुसरण	ə n ʊ s ə ɾ ə n
मुहैया	m ʊ ɦ ɛː j ɑː
वहमी	ʋ ɛː ʱ m iː
सीताफल	s iː t̪ ɑː pʰ ə l
हैं	ɦ ɛ̃ː
छह	t͡ʃʰ ə ʱ
सरहदी	s ə ɾ ɦ ə d̪ iː
भिक्षा	b ʱ ɪ k ʃ ɑː
बधिर	b ə d̪ ʱ ɪ ɾ
नमाज़	n ə m ɑː z
कुम्हलाना	k ʊ m ʱ l ɑː n ɑː
संतरा	s ə n t̪ ɾ ɑː
तलब	t̪ ə l ə b
तरंग	t̪ ə ɾ ə ŋ ɡ
चर्म	t͡ʃ ə ɾ m
समाकलन	s ə m ɑː k l ə n
रेलवे	ɾ eː l ʋ eː
चौड़ा	t͡ʃ ɔː ɽ ɑː
गायन	ɡ ɑː j ə n
पोपला	p oː p l ɑː
स्कूल	s k uː l
गहना	ɡ ɛː ʱ n ɑː
विद्युदणु	ʋ ɪ d̪ j ʊ d̪ ə n uː
राज	ɾ ɑː d͡ʒ
साग	s ɑː ɡ
अनब्याहा	ə n b j ɑː ɦ ɑː
हेज़लनट	ɦ eː z ə l n ə ʈ
बरज़बान	b ə ɾ ə z b ɑː n
जहाँगीर	d͡ʒ ə ɦ ɑ̃ː ɡ iː ɾ
बिक्री	b ɪ k ɾ iː
बेकार	b eː k ɑː ɾ
सूती	s uː t̪ iː
पंडित	p ə n ɖ ɪ t̪
जनसांख्यिकी	d͡ʒ ə n s ɑː ŋ kʰ j ɪ k iː
शेरनी	ʃ eː ɾ n iː
बढ़ई	b ə ɽ ʱ ə iː
वास्तव	ʋ ɑː s t̪ ə ʋ
छोड़ना	t͡ʃʰ oː ɽ n ɑː
अनपढ़	ə n p ə ɽ ʱ
प्रकाश	p ɾ ə k ɑː ʃ
श्यामदेश	ʃ j ɑː m d̪ eː ʃ
लोग	l oː ɡ
वाणिज्य	ʋ ɑː n ɪ d͡ʒ j
कंप्यूटरीकरण	k ə m p j uː ʈ ɾ iː k ə ɾ ə n
अड़तीस	ə ɽ t̪ iː s
बेनतीजा	b eː n ə t̪ iː d͡ʒ ɑː
राजग	ɾ ɑː d͡ʒ ə ɡ
रोमानिया	ɾ oː m ɑː n iː j ɑː
अंगुली	ə ŋ ɡ ʊ l iː
लुंगी	l ʊ ŋ ɡ iː
मुझको	m ʊ d͡ʒ ʱ k oː
सममिति	s ə m m ɪ t̪ iː
उत्तरदायित्व	ʊ t̪ t̪ ə ɾ d̪ ɑː j ɪ t̪ ʋ
भूखमरी	b ʱ uː kʰ m ə ɾ iː
राँझा	ɾ ɑː ɲ d͡ʒ ʱ ɑː
कुमाऊँ	k ʊ m ɑ̃ːː
ज्वार	d͡ʒ ʋ ɑː ɾ
पहल	p ɛː ʱ l
अनुपयोगी	ə n ʊ p j oː ɡ iː
संयोजक	s ə̃ j oː d͡ʒ ə k
अनुशीलन	ə n ʊ ʃ iː l ə n
किचन	k ɪ t͡ʃ ə n
लट	l ə ʈ
तंदुरुस्त	t̪ ə n d̪ ʊ ɾ ʊ s t̪
प्रारंभ	p ɾ ɑː ɾ ə m b ʱ
जिस	d͡ʒ ɪ s
मन्नत	m ə n n ə t̪
प्रतिकर्षण	p ɾ ə t̪ ɪ k ə ɾ ʃ ə n
मधुर	m ə d̪ ʱ ʊ ɾ
क्रियाकलाप	k ɾ iː j ɑː k ə l ɑː p
जानी	d͡ʒ ɑː n iː
नाभिक	n ɑː b ʱ ɪ k
मायने	m ɑː j n eː
आरोग्य	ɑː ɾ oː ɡ j
अँगहीन	ə̃ ɡ ʱ iː n
मनोरोग	m ə n oː ɾ oː ɡ
भाटक	b ʱ ɑː ʈ ə k
लपेटना	l ə p eː ʈ n ɑː
उत्पत्ति	ʊ t̪ p ə t̪ t̪ iː
दिसंबर	d̪ ɪ s ə m b ə ɾ
क्षेत्राधिकार	k ʃ eː t̪ ɾ ɑː d̪ ʱ ɪ k ɑː ɾ
सताना	s ə t̪ ɑː n ɑː
येड़ा	j eː ɽ ɑː
कनीज़	k ə n iː z
सहस्रमान	s ɛː ʱ s ɾ ə m ɑː n
मीन	m iː n
दायाँ	d̪ ɑː j ɑ̃ː
गृहस्थ	ɡ ɾ ɪ ɦ ə s t̪ʰ
सामूहिक	s ɑː m uː ɦ ɪ k
जुदा	d͡ʒ ʊ d̪ ɑː
बेवफ़ा	b eː ʋ ə f ɑː
नाई	n ɑː iː
पगोडा	p ə ɡ oː ɖ ɑː
अकादमिक	ə k ɑː d̪ m ɪ k
अत्याचारी	ə t̪ j ɑː t͡ʃ ɑː ɾ iː
साबित	s ɑː b ɪ t̪
चौराहा	t͡ʃ ɔː ɾ ɑː ɦ ɑː
दायर	d̪ ɑː j ə ɾ
कुंद	k ʊ n d̪
कोयल	k oː j ə l
किसानी	k ɪ s ɑː n iː
मजबूरी	m ə d͡ʒ b uː ɾ iː
बुआ	b ʊ ɑː
सैंतीस	s ɛː n t̪ iː s
लाठ	l ɑː ʈʰ
अनुपस्थित	ə n uː p ə s t̪ʰ ɪ t̪
मार्क्सवाद	m ɑː ɾ k s ʋ ɑː d̪
सुरमा	s ʊ ɾ m ɑː
मदार	m ə d̪ ɑː ɾ
शरमिंदा	ʃ ə ɾ m ɪ n d̪ ɑː
अनाड़ी	ə n ɑː ɽ iː
ज़रूर	z ə ɾ uː ɾ
फट्टू	pʰ ə ʈ ʈ uː
यातायात	j ɑː t̪ ɑː j ɑː t̪
अहिभृत्	ə ɦ ɪ b ʱ ɾ ɪ t̪
वेश्या	ʋ eː ʃ j ɑː
भगवान्	b ʱ ə ɡ ʋ ɑː n
परिभाषा	p ə r ɪ b ʱ aː ʃ aː
अद्यतन	ə d̪ j ə t̪ ə n
किलोग्राम	k ɪ l oː ɡ ɾ ɑː m
इंटेल	ɪ n ʈ eː l
आत्मसात	ɑː t̪ m ə s ɑː t̪
कांटा	k ɑː n ʈ ɑː
राजस्थानी	ɾ ɑː d͡ʒ ə s t̪ʰ ɑː n iː
आदिम	ɑː d̪ ɪ m
सेही	s eː ɦ iː
आकाश	ɑː k ɑː ʃ
अपशकुन	ə p ʃ ə k ʊ n
जागरूकता	d͡ʒ ɑː ɡ ɾ uː k t̪ ɑː
सरोद	s ə ɾ oː d̪
आशुलिपि	ɑː ʃ ʊ l ɪ p iː
भिंडी	b ʱ ɪ n ɖ iː
दुष्ट	d̪ ʊ ʃ ʈ
व्याकरण	ʋ j aː k ə r ə ɳ
हराम	ɦ ə ɾ ɑː m
लेस्टर	l eː s ʈ ə ɾ
मुबारकबाद	m ʊ b ɑː ɾ ə k b ɑː d̪
चालुक्य	t͡ʃ ɑː l ʊ k j
वर्गीकरण	ʋ ə ɾ ɡ iː k ɾ ə n
फेसबुक	pʰ eː s b ʊ k
ढलना	ɖ ʱ ə l n ɑː
स्टेडियम	s ʈ eː ɖ iː j ə m
अस्तित्व	ə s t̪ ɪ t̪ ʋ
अनियंत्रित	ə n iː j ə n t̪ ɾ ɪ t̪
मर्मघातक	m ə ɾ m ə ɡ ʱ ɑː t̪ ə k
पंचायत	p ə ɲ t͡ʃ ɑː j ə t̪
चरागाह	t͡ʃ ə ɾ ɑː ɡ ɑː ʱ
महकमा	m ɛː ʱ k m ɑː
नेत्रिका	n eː t̪ ɾ ɪ k ɑː
मेट्रो	m eː ʈ ɾ oː
फ़ुटबॉल	f ʊ ʈ b ɔː l
दंड	d̪ ə n ɖ
विजय	ʋ ɪ d͡ʒ ə j
तना	t̪ ə n ɑː
ढ़	ɽ ʱ ə
एकजुटता	eː k d͡ʒ ʊ ʈ t̪ ɑː
मृत्युदंड	m ɾ ɪ t̪ j ʊ d̪ ə n ɖ
गुलशन	ɡ ʊ l ʃ ə n
ष़	ɭ ə
अंतरिम	ə n t̪ ɾ ɪ m
मित्राई	m ɪ t̪ ɾ ɑː iː
सुखमय	s ʊ kʰ m ə j
अजीर्ण	ə d͡ʒ iː ɾ n
विधवा	ʋ ɪ d̪ ʱ ʋ ɑː
पतंगबाज़ी	p ə t̪ ə ŋ ɡ b ɑː z iː
मूली	m uː l iː
सार्वजनिक	s ɑː ɾ ʋ d͡ʒ ə n ɪ k
वृद्धि	ʋ ɾ ɪ d̪ d̪ ʱ iː
चुम्मा	t͡ʃ ʊ m m ɑː
बियाबान	b iː j ɑː b ɑː n
बिगुल	b ɪ ɡ ʊ l
विकिरण	ʋ ɪ k ɪ ɾ ə n
साध्वी	s ɑː d̪ ʱ ʋ iː
रुद्रवीणा	ɾ ʊ d̪ ɾ ə ʋ iː n ɑː
कदू	k ə d̪ uː
पेड़	p eː ɽ
मुरझाना	m ʊ ɾ d͡ʒ ʱ ɑː n ɑː
हैरान	ɦ ɛː ɾ ɑː n
व्याख्यान	ʋ j ɑː kʰ j ɑː n
नापसंद	n ɑː p ə s ə n d̪
हाँगर	ɦ ɑ̃ː ɡ ə ɾ
शिकंजा	ʃ ɪ k ə ɲ d͡ʒ ɑː
हँसना	ɦ ə̃ s n ɑː
उपलब्धि	ʊ p l ə b d̪ ʱ iː
रंगमंच	ɾ ə ŋ ɡ m ə ɲ t͡ʃ
अर्थव्यवस्था	ə ɾ t̪ʰ ə ʋ j ə ʋ ə s t̪ʰ ɑː
अपक्व	ə p ə k ʋ ə
सरीखा	s ə ɾ iː kʰ ɑː
फिर	pʰ ɪ ɾ
तातार	t̪ ɑː t̪ ɑː ɾ
खरोंच	kʰ ə ɾ oː ɲ t͡ʃ
याद	j ɑː d̪
रंग	ɾ ə ŋ ɡ
दृढ़संकल्प	d̪ ɾ ɪ ɽ ʱ s ə ŋ k ə l p
सफ़रनामा	s ə f ə ɾ n ɑː m ɑː
नतीजा	n ə t̪ iː d͡ʒ ɑː
तसला	t̪ ə s l ɑː
इक्यासी	ɪ k j ɑː s iː
ढूँढ़ना	ɖ ʱ ũː ɽ ʱ n ɑː
विभाजित	ʋ ɪ b ʱ ɑː d͡ʒ ɪ t̪
वापस	ʋ ɑː p ə s
अभिकलित्र	ə b ʱ ɪ k ə l ɪ t̪ ɾ
कुत्ती	k ʊ t̪ t̪ iː
मंज़ूर	m ə n z uː ɾ
फ़ैसलाबाद	f ɛː s l ɑː b ɑː d̪
समीर	s ə m iː ɾ
नुमाइश	n ʊ m ɑː ɪ ʃ
मध्यवर्ग	m ə d̪ ʱ j ə ʋ ə ɾ ɡ
इनका	ɪ n k ɑː
कसौटी	k ə s ɔː ʈ iː
सांख्यिकी	s ɑː ŋ kʰ j ɪ k iː
घरेलू	ɡ ʱ ə ɾ eː l uː
लोथ	l oː t̪ʰ
गोरिल्ला	ɡ oː ɾ ɪ l ɑː
आकस्मिक	ɑː k ə s m ɪ k
बीर	b iː ɾ
एकरूपता	eː k ɾ uː p t̪ ɑː
सरसठ	s ə ɾ s ə ʈʰ
पूर्णकालिक	p uː ɾ n ə k ɑː l ɪ k
चाट	t͡ʃ ɑː ʈ
खोजना	kʰ o d ʒ n̪ aː
कौआ	k ɔː ɑː
इंजील	ɪ ɲ d͡ʒ iː l
अजब	ə d͡ʒ ə b
कसके	k ə s k eː
सबब	s ə b ə b
टट्टी	ʈ ə ʈ ʈ iː
हेटौडा	ɦ eː ʈ ɔː ɖ ɑː
नीला	n iː l ɑː
अनस्तित्व	ə n ə s t̪ ɪ t̪ ʋ
गेहूँ	ɡ eː ɦ ũː
भृकुटी	b ʱ ɾ ɪ k ʊ ʈ iː
व्यर्थ	ʋ j ə ɾ t̪ʰ
मशीनीकरण	m ə ʃ iː n iː k ɾ ə n
संक्रामक	s ə ŋ k ɾ ɑː m ə k
सलवार	s ə l ʋ ɑː ɾ
रेलगाड़ी	ɾ eː l ɡ ɑː ɽ iː
हासिल	ɦ ɑː s ɪ l
झनझन	d͡ʒ ʱ ə n d͡ʒ ʱ ə n
मजनू	m ə d͡ʒ n uː
शलगम	ʃ ə l ɡ ə m
बहुचर्चित	b ə ɦ ʊ t͡ʃ ə ɾ t͡ʃ ɪ t̪
कार्यसूची	k ɑː ɾ j ə s uː t͡ʃ iː
मनसूब	m ə n s uː b
विजेता	ʋ ɪ d͡ʒ eː t̪ ɑː
बेतहाशा	b eː t̪ ə ɦ ɑː ʃ ɑː
संख्या	s ə ŋ kʰ j ɑː
पूंजी	p uː ɲ d͡ʒ iː
रोज़मर्रा	ɾ oː z m ə ɾ ɾ ɑː
भावनात्मक	b ʱ ɑː ʋ n ɑː t̪ m ə k
छांटना	t͡ʃʰ ɑː n ʈ n ɑː
मलेशिया	m ə l eː ʃ iː j ɑː
पटका	p ə ʈ k ɑː
दुअन्नी	d̪ ʊ ə n n iː
उपसचिव	ʊ p ə s t͡ʃ ɪ ʋ
रीता	ɾ iː t̪ ɑː
गठन	ɡ ə ʈʰ ə n
गुलाब	ɡ ʊ l ɑː b
हज़ारहा	ɦ ə z ɑː ɾ ɦ ɑː
पुनः	p ʊ n əʰ
रसोईघर	ɾ ə s oː iː ɡ ʱ ə ɾ
अनमोल	ə n m oː l
पराया	p ə ɾ ɑː j ɑː
तलाश	t̪ ə l ɑː ʃ
हाइपरटेक्स्ट	ɦ ɑː ɪ p ə ɾ ʈ eː k s ʈ
स्मारक	s m ɑː ɾ ə k
होगा	ɦ oː ɡ ɑː
गठजोड़	ɡ ə ʈʰ d͡ʒ oː ɽ
मुरदा	m ʊ ɾ d̪ ɑː
अंतर्वासी	ə n t̪ ə ɾ ʋ ɑː s iː
डायरी	ɖ ɑː j ə ɾ iː
द्विपक्षीय	d̪ ʋ ɪ p ə k ʃ iː j
अगरचे	ə ɡ ə ɾ t͡ʃ eː
अपकार	ə p k ɑː ɾ
इनसाफ़	ɪ n s ɑː f
निर्णय	n ɪ ɾ n ə j
छियानवे	t͡ʃʰ iː j ɑː n ʋ eː
राजहंस	ɾ ɑː d͡ʒ ʱ ə n s
उदारतावाद	ʊ d̪ ɑː ɾ t̪ ɑː ʋ ɑː d̪
जारी	d͡ʒ ɑː ɾ iː
अवधारण	ə ʋ d̪ ʱ ɑː ɾ ə n
पदोन्नत	p ə d̪ oː n n ə t̪
लापरवाही	l ɑː p ə ɾ ʋ ɑː ɦ iː
इत्तेला	ɪ t̪ t̪ eː l ɑː
थाना	t̪ʰ ɑː n ɑː
टेकना	ʈ eː k n ɑː
स्कर्ट	s k ə ɾ ʈ
कढ़ी	k ə ɽ ʱ iː
अए	ə eː
बत्तीस	b ə t̪ t̪ iː s
कोटर	k oː ʈ ə ɾ
सेनेगल	s eː n eː ɡ ə l
तनना	t̪ ə n n ɑː
चषक	t͡ʃ ə ʃ ə k
बिमारी	b ɪ m ɑː ɾ iː
गढ़ना	ɡ ə ɽ ʱ n ɑː
सॉसेज	s ɔː s eː d͡ʒ
अकर्मक	ə k ə ɾ m ə k
अलहदा	ə l ɛː ʱ d̪ ɑː
घोंघा	ɡ ʱ oː ŋ ɡ ʱ ɑː
खेतिहर	kʰ eː t̪ ɪ ɦ ə ɾ
उच्चारण	ʊ t͡ʃ t͡ʃ ɑː ɾ ə n
यौगिक	j ɔː ɡ ɪ k
शतावर	ʃ ə t̪ ɑː ʋ ə ɾ
कड़ा	k ə ɽ ɑː
अलीगढ़	ə l iː ɡ ə ɽ ʱ
करूंगा	k ə ɾ ũː ŋ ɡ ɑ
नौसेना	n ɔː s eː n ɑː
उढ़काना	ʊ ɽ ʱ k ɑː n ɑː
करघा	k ə ɾ ɡ ʱ ɑː
अपरिरुद्ध	ə p ə ɾ ɪ ɾ ʊ d̪ d̪ ʱ
अर्थहीन	ə ɾ t̪ʰ ɦ iː n
क्वेटा	k ʋ eː ʈ ɑː
अन्य	ə n j ə
शिनजियांग	ʃ ɪ n d͡ʒ iː j ɑː ŋ ɡ
मेघ	m eː ɡ ʱ
सारा	s ɑː ɾ ɑː
लकीर	l ə k iː ɾ
शक्ति	ʃ ə k t̪ iː
हिरन	ɦ ɪ ɾ ə n
सहकर्मी	s ɛː ʱ k ə ɾ m iː
नाजायज़	n ɑː d͡ʒ ɑː j ə z
चाँदनी	t͡ʃ ɑː n d̪ n iː
अन्यथा	ə n j ə t̪ʰ ɑː
बक्सा	b ə k s ɑː
वसूल	ʋ ə s uː l
हकीम	ɦ ə k iː m
तौल	t̪ ɔː l
पचानवे	p ə t͡ʃ ɑː n ʋ eː
मिसिसॉगा	m ɪ s ɪ s ɔː ɡ ɑː
मिटना	m ɪ ʈ n̪ aː
जिसने	d͡ʒ ɪ s n eː
उल्का	ʊ l k ɑː
संग्राम	s ə ŋ ɡ ɾ ɑː m
बेल्जियम	b eː l d͡ʒ iː j ə m
काँव	k ɑ̃ː ʋ
अनेकता	ə n eː k t̪ ɑː
पुरातत्वज्ञ	p ʊ ɾ ɑː t̪ ə t̪ ʋ ə ɡ j
रोमांच	ɾ oː m ɑː ɲ t͡ʃ
निरूपण	n ɪ ɾ uː p ə n
अधूरा	ə d̪ ʱ uː ɾ ɑː
मकान	m ə k aː n
स्टेटस	s ʈ eː ʈ ə s
पुनरुत्थान	p ʊ n ə ɾ ʊ t̪ t̪ʰ ɑː n
समापन	s ə m ɑː p ə n
आयोजित	ɑː j oː d͡ʒ ɪ t̪
इंडोनेशियन	ɪ n ɖ oː n eː ʃ iː j ə n
धंधा	d̪ ʱ ə n d̪ ʱ ɑː
पर्याप्त	p ə ɾ j ɑː p t̪
सलाहकार	s ə l ɑː ʱ k ɑː ɾ
इतराना	ɪ t̪ ɾ ɑː n ɑː
बहिन	b ɛː ʱ n
सलामी	s ə l ɑː m iː
विद्वान	ʋ ɪ d̪ ʋ ɑː n
उगना	ʊ ɡ n ɑː
वारिस	ʋ ɑː ɾ ɪ s
अवकलनीय	ə ʋ k ə l ə n iː j
ओला	oː l ɑː
परीक्षण	p ə ɾ iː k ʃ ə n
लादना	l ɑː d̪ n ɑː
बुंदेली	b ʊ n d̪ eː l iː
खुरपा	kʰ ʊ ɾ p ɑː
नींव	n ĩː ʋ
ज़फ़र	z ə f ə ɾ
नवजात	n ə ʋ d͡ʒ ɑː t̪
लहजा	l ɛː ʱ d͡ʒ ɑː
घोड़ा	ɡ ʱ oː ɽ ɑː
समन्दर	s ə m ə n d̪ ə ɾ
गिरना	ɡ ɪ ɾ n ɑː
आसमानी	ɑː s m ɑː n iː
तब	t̪ ə b
माँ	m ɑ̃ː
धँसना	d̪ ʱ ə̃ s n ɑː
समझना	s ə m ə d͡ʒ ʱ n ɑː
तत्कालीन	t̪ ə t̪ k ɑː l iː n
दासप्रथा	d̪ ɑː s p ɾ ə t̪ʰ ɑː
बहुदलीय	b ə ɦ ʊ d̪ ə l iː j
असर	ə s ə ɾ
पाँच	p ɑ̃ː t͡ʃ
चकोतरा	t͡ʃ ə k oː t̪ ɾ ɑː
क्रिस्मस	k ɾ ɪ s m ə s
हताहत	ɦ ə t̪ ɑː ɦ ə t̪
हैसियत	ɦ ɛː s iː j ə t̪
संरक्षण	s ə n ɾ ə k ʃ ə n
भाभी	b ʱ ɑː b ʱ iː
वलीअहद	ʋ ə l iː ɛː ʱ d̪
रक्तपात	ɾ ə k t̪ p ɑː t̪
मौजूदगी	m ɔː d͡ʒ uː d̪ ɡ iː
पचासी	p ə t͡ʃ ɑː s iː
रोटी	ɾ oː ʈ iː
इनको	ɪ n k oː
घमंड	ɡ ʱ ə m ə n ɖ
माने	m ɑː n eː
अशिष्ट	ə ʃ ɪ ʃ ʈ
जलारेख	d͡ʒ ə l ɑː ɾ eː kʰ
शिकारी	ʃ ɪ k ɑː ɾ iː
संकल्पना	s ə ŋ k ə l p ə n ɑː
पहनना	p ɛː ʱ n n ɑː
पिदर	p ɪ d̪ ə ɾ
सड़कछाप	s ə ɽ ə k t͡ʃʰ ɑː p
लीड्स	l iː ɖ s
चुकंदर	t͡ʃ ʊ k ə n d̪ ə ɾ
पान	p ɑː n
त्यागपत्र	t̪ j ɑː ɡ p ə t̪ ɾ
अजमेर	ə d͡ʒ m eː ɾ
कोरिया	k oː ɾ iː j ɑː
लघ्वातु	l ə ɡ ʱ ʋ ɑː t̪ uː
सामान्यतः	s ɑː m ɑː n j ə t̪ əʰ
केंद्रक	k eː n d̪ ɾ ə k
हूँ	ɦ ũː
सही	s ə ɦ iː
संवेदनशील	s ə m ʋ eː d̪ ə n ʃ iː l
मुझसे	m ʊ d͡ʒ ʱ s eː
मोल	m oː l
वस्तु	ʋ ə s t̪ uː
अभागा	ə b ʱ ɑː ɡ ɑː
ठिठक	ʈʰ ɪ ʈʰ ə k
लश्करी	l ə ʃ k ə ɾ iː
सैंतालीस	s ɛː n t̪ ɑː l iː s
अलाव	ə l ɑː ʋ
वतन	ʋ ə t̪ ə n
ज़मीर	z ə m iː ɾ
चित्त	t͡ʃ ɪ t̪ t̪
इंद्रनाथ	ɪ n d̪ ɾ ə n ɑː t̪ʰ
जल्दी	d͡ʒ ə l d̪ iː
तशरीफ़	t̪ ə ʃ ɾ iː f
कनटोप	k ə n ʈ oː p
दंभ	d̪ ə m b ʱ
बकरी	b ə k ɾ iː
शक्तिहीन	ʃ ə k t̪ ɪ ɦ iː n
ओर	oː ɾ
मातम	m ɑː t̪ ə m
युद्धबंदी	j ʊ d̪ d̪ ʱ b ə n d̪ iː
सुअर	s ʊ ə ɾ
कबीर	k ə b iː ɾ
साया	s ɑː j ɑː
गोरक्षा	ɡ oː ɾ ə k ʃ ɑː
भूसा	b ʱ uː s ɑː
इसमाईल	ɪ s m ɑː iː l
दंदान	d̪ ə n d̪ ɑː n
आशावाद	ɑː ʃ ɑː ʋ ɑː d̪
मुजरिम	m ʊ d͡ʒ ɾ ɪ m
ओक	oː k
संयोगवश	s ə̃ j oː ɡ ʋ ə ʃ
झोली	d͡ʒ ʱ oː l iː
कबड्डी	k ə b ə ɖ ɖ iː
छिटकना	t͡ʃʰ ɪ ʈ ə k n ɑː
चौंतीस	t͡ʃ ɔː n t̪ iː s
जिसे	d͡ʒ ɪ s eː
भड़काना	b ʱ ə ɽ k ɑː n ɑː
मुआवज़ा	m ʊ ɑː ʋ z ɑː
कंडीशनर	k ə n ɖ iː ʃ n ə ɾ
सूखा	s uː kʰ ɑː
चुलबुल	t͡ʃ ʊ l b ʊ l
हेकड़ी	ɦ eː k ɽ iː
रिवाज	ɾ ɪ ʋ ɑː d͡ʒ
जयकार	d͡ʒ ə j ə k ɑː ɾ
दक्षिणा	d̪ ə k ʃ ɪ n ɑː
करतब	k ə ɾ t̪ ə b
अकादमी	ə k ɑː d̪ m iː
भागे	b ʱ ɑː ɡ eː
कोयंबतूर	k oː j ə m b ə t̪ uː ɾ
रागी	ɾ ɑː ɡ iː
सुरक्षाबल	s ʊ ɾ ə k ʃ ɑː b ə l
पुट	p ʊ ʈ
संशोधन	s ə n ʃ oː d̪ ʱ ə n
प्रत्यय	p ɾ ə t̪ j ə j
मुख	m ʊ kʰ
विजयनगरम	ʋ ɪ d͡ʒ j ə n ə ɡ ɾ ə m
गिरोह	ɡ ɪ ɾ oː ʱ
निःशब्द	n ɪʰ ʃ ə b d̪
मूर्धन्य	m uː ɾ d̪ ʱ ə n j
कमली	k ə m l iː
आड़	ɑː ɽ
बीकानेर	b iː k ɑː n eː ɾ
परिंदा	p ə ɾ ɪ n d̪ ɑː
अंतःक्षेप	ə n t̪ əʰ k ʃ eː p
बच्चन	b ə t͡ʃ t͡ʃ ə n
शाबाशी	ʃ ɑː b ɑː ʃ iː
समाजवादी	s ə m ɑː d͡ʒ ʋ ɑː d̪ iː
फ़लस्तीनी	f ə l ə s t̪ iː n iː
जमात	d͡ʒ ə m ɑː t̪
कार्रवाई	k ɑː ɾ ɾ ə ʋ ɑː iː
रसीद	ɾ ə s iː d̪
एलान	eː l ɑː n
सूंस	s uː n s
नयन	n ə j ə n
चलचित्र	t͡ʃ ə l t͡ʃ ɪ t̪ ɾ
धन्य	d̪ ʱ ə n j ə
तबेला	t̪ ə b eː l ɑː
लापसी	l ɑː p s iː
छात्रवृत्ति	t͡ʃʰ ɑː t̪ ɾ ə ʋ ɾ ɪ t̪ t̪ iː
साल	s ɑː l
अँगरेज़ी	ə̃ ɡ ɾ eː z iː
थर्राना	t̪ʰ ə ɾ ɾ ɑː n ɑː
उपाय	ʊ p ɑː j
वैचारिक	ʋ ɛː t͡ʃ ɑː ɾ ɪ k
बैलगाड़ी	b ɛː l ɡ ɑː ɽ iː
फड़फड़ाना	pʰ ə ɽ pʰ ə ɽ ɑː n ɑː
गुंडागर्दी	ɡ ʊ n ɖ ɑː ɡ ə ɾ d̪ iː
पुत्रजया	p ʊ t̪ ɾ d͡ʒ ə j ɑː
मुखड़ा	m ʊ kʰ ɽ ɑː
भक्त	b ʱ ə k t̪
बेड़ा	b eː ɽ ɑː
सामरिक	s ɑː m ɾ ɪ k
रौंदना	ɾ ɔː n d̪ n ɑː
उत्सुक	ʊ t̪ s ʊ k
छीनाझपटी	t͡ʃʰ iː n ɑː d͡ʒ ʱ ə p ʈ iː
छोरा	t͡ʃʰ oː ɾ ɑː
विष	ʋ ɪ ʃ
सुहाग	s ʊ ɦ ɑː ɡ
ज्ञान	ɡ j ɑː n
तमीज़	t̪ ə m iː z
टंकक	ʈ ə ŋ k ə k
रुलाना	ɾ ʊ l ɑː n ɑː
मणिपुर	m ə n ɪ p ʊ ɾ
अवधारणा	ə ʋ d̪ ʱ ɑː ɾ n ɑː
पछत्तर	p ə t͡ʃʰ ə t̪ t̪ ə ɾ
इसमें	ɪ s m ẽ
गुजरांवाला	ɡ ʊ d͡ʒ ɾ ɑ̃ː ʋ ɑː l ɑː
तोता	t̪ oː t̪ ɑː
जलालाबाद	d͡ʒ ə l ɑː l ɑː b ɑː d̪
लौहपथगामिनी	l ɔː ʱ p ə t̪ʰ ɡ ɑː m ɪ n iː
गढ़वाल	ɡ ə ɽ ʱ ʋ ɑː l
ज्ञातृत्व	ɡ j ɑː t̪ ɾ ɪ t̪ ʋ
गांगुली	ɡ ɑː ŋ ɡ ʊ l iː
रेज़गारी	ɾ eː z ɡ ɑː ɾ iː
गिलहरी	ɡ ɪ l ɛː ʱ ɾ iː
दिवसीय	d̪ ɪ ʋ s iː j
फ़ौरन	f ɔː ɾ ə n
तालिका	t̪ ɑː l ɪ k ɑː
कैंटीन	k ɛː n ʈ iː n
खाँग	kʰ ɑ̃ː ɡ
उदयवर्ष	ʊ d̪ ə j ʋ ə ɾ ʃ
रशिया	ɾ ə ʃ iː j ɑː
देवदार	d̪ eː ʋ d̪ ɑː ɾ
मकड़ा	m ə k ɽ ɑː
ऊसर	uː s ə ɾ
जुस्तजू	d͡ʒ ʊ s t̪ ə d͡ʒ uː
ध्वस्त	d̪ ʱ ʋ ə s t̪
अखाड़ा	ə kʰ ɑː ɽ ɑː
कारक	k ɑː ɾ ə k
जताना	d͡ʒ ə t̪ ɑː n ɑː
चेन्नई	t͡ʃ eː n n ə iː
दृश्य	d̪ ɾ ɪ ʃ j
गंगाजल	ɡ ə ŋ ɡ ɑː d͡ʒ ə l
स्लोवेनियन	s l oː ʋ eː n iː j ə n
इल्तिजा	ɪ l t̪ ɪ d͡ʒ ɑː
शेष	ʃ eː ʃ
उत्साहित	ʊ t̪ s ɑː ɦ ɪ t̪
मोनाको	m oː n ɑː k oː
आकांक्षा	ɑː k ɑː ŋ k ʃ ɑː
साठ	s ɑː ʈʰ
टांकण	ʈ ɑː ŋ k ə n
गुर्दा	ɡ ʊ ɾ d̪ ɑː
खेलना	kʰ eː l n ɑː
सुनाई	s ʊ n ɑː iː
बहुराष्ट्रीय	b ə ɦ ʊ ɾ ɑː ʃ ʈ ɾ iː j
मौजूदा	m ɔː d͡ʒ uː d̪ ɑː
पिचकना	p ɪ t͡ʃ ə k n ɑː
लफ़ंगा	l ə f ə ŋ ɡ ɑː
बर्फ़ी	b ə ɾ f iː
निम्नलिखित	n ɪ m n ə l ɪ kʰ ɪ t̪
उड़ीसा	ʊ ɽ iː s ɑː
बबर	b ə b ə ɾ
झुर्री	d͡ʒ ʱ ʊ ɾ ɾ iː
थकित	t̪ʰ ə k ɪ t̪
हादसा	ɦ ɑː d̪ s ɑː
मजबूर	m ə d͡ʒ b uː ɾ
भूमंडलीय	b ʱ uː m ə n ɖ ə l iː j
मरियम	m ə ɾ iː j ə m
समयसारणी	s ə m ə j s ɑː ɾ n iː
धार्मिक	d̪ ʱ ɑː ɾ m ɪ k
मतभेद	m ə t̪ b ʱ eː d̪
अचूक	ə t͡ʃ uː k
तक	t̪ ə k
चंपा	t͡ʃ ə m p ɑː
अभियांत्रिकी	ə b ʱ iː j ɑː n t̪ ɾ ɪ k iː
ज़बानी	z ə b ɑː n iː
चित्ताकर्षक	t͡ʃ ɪ t̪ t̪ ɑː k ə ɾ ʃ ə k
फ़िलीपीन्स	f ɪ l iː p iː n s
धर्मनिरपेक्ष	d̪ ʱ ə ɾ m n ɪ ɾ p eː k ʃ
पेच	p eː t͡ʃ
धन्यवाद	d̪ ʱ ə n j ə ʋ ɑː d̪
दंत	d̪ ə n t̪
बिछड़ना	b ɪ t͡ʃʰ ə ɽ n ɑː
किशमिश	k ɪ ʃ m ɪ ʃ
ठपना	ʈʰ ə p n ɑː
निर्दिष्ट	n ɪ ɾ d̪ ɪ ʃ ʈ
प्रवाह	p ɾ ə ʋ ɑː ʱ
मानना	m ɑː n n ɑː
महत्त्व	m ɛː ʱ t̪ t̪ ʋ
पूर्ववर्ती	p uː ɾ ʋ ʋ ə ɾ t̪ iː
बोल	b oː l
रूठना	ɾ uː ʈʰ n ɑː
जैकबाबाद	d͡ʒ ɛː k b ɑː b ɑː d̪
खिलवाना	kʰ ɪ l ʋ ɑː n ɑː
व्याख्यायित	ʋ j ɑː kʰ j ɑː j ɪ t̪
जनप्रतिनिधि	d͡ʒ ə n p ɾ ə t̪ ɪ n ɪ d̪ ʱ iː
गिरजा	ɡ ɪ ɾ d͡ʒ ɑː
ओए	oː eː
ठोस	ʈʰ oː s
नादानी	n ɑː d̪ ɑː n iː
यथार्थ	j ə t̪ʰ ɑː ɾ t̪ʰ
इकट्ठा	ɪ k ə ʈ ʈʰ ɑː
धूम	d̪ ʱ uː m
भूराजनीति	b ʱ uː ɾ ɑː d͡ʒ n iː t̪ iː
कराची	k ə ɾ ɑː t͡ʃ iː
भेदपूर्ण	b ʱ eː d̪ p uː ɾ n
महाधिवक्ता	m ə ɦ ɑː d̪ ʱ ɪ ʋ ə k t̪ ɑː
चटकारा	t͡ʃ ə ʈ k ɑː ɾ ɑː
अल्बानिया	ə l b ɑː n iː j ɑː
खोआ	kʰ oː ɑː
पहलू	p ɛː ʱ l uː
हरमसरा	ɦ ə ɾ ə m ‿ s ə ɾ ɑː
गोपी	ɡ oː p iː
रीछ	ɾ iː t͡ʃʰ
आग्रह	ɑː ɡ ɾ ə ʱ
जंगम	d͡ʒ ə ŋ ɡ ə m
विवेचन	ʋ ɪ ʋ eː t͡ʃ ə n
बल्कि	b ə l k iː
स्मरणशक्ति	s m ə ɾ ə n ʃ ə k t̪ iː
जलेबी	d͡ʒ ə l eː b iː
मुहिम	m ʊ ɦ ɪ m
संपूर्ण	s ə m p uː ɾ n
भगवाकरण	b ʱ ə ɡ ʋ ɑː k ə ɾ ə n
मार्च	m ɑː ɾ t͡ʃ
नायाब	n ɑː j ɑː b
अथाह	ə t̪ʰ ɑː ʱ
वैद्युत	ʋ ɛː d̪ j ʊ t̪
कवयित्री	k ə ʋ j ɪ t̪ ɾ iː
दक्षिणपंथ	d̪ ə k ʃ ɪ n p ə n t̪ʰ
हयात	ɦ ə j ɑː t̪
उद्यान	ʊ d̪ j ɑː n
हड़ताली	ɦ ə ɽ t̪ ɑː l iː
लौड़ा	l ɔː ɽ ɑː
व्यंग्य	ʋ j ə ŋ ɡ j
सीखना	s iː kʰ n ɑː
संतान	s ə n t̪ ɑː n
खुजलाना	kʰ ʊ d͡ʒ l ɑː n ɑː
छंटना	t͡ʃʰ ə n ʈ n ɑː
आकृति	ɑː k ɾ ɪ t̪ iː
अनौपचारिक	ə n ɔː p t͡ʃ ɑː ɾ ɪ k
जाँघ	d͡ʒ ɑ̃ː ɡ ʱ
सय्याद	s ə j j ɑː d̪
नेक	n eː k
मद्रासी	m ə d̪ ɾ ɑː s iː
मर्दानगी	m ə ɾ d̪ ɑː n ɡ iː
संयोजकता	s ə̃ j oː d͡ʒ ə k t̪ ɑː
ब्रह्माण्ड	b ɾ ɛː ʱ m ɑː n ɖ
अग्रज	ə ɡ ɾ ə d͡ʒ
सशक्तिकरण	s ə ʃ ə k t̪ ɪ k ə ɾ ə n
ऊर्जा	uː ɾ d͡ʒ ɑː
पुनर्जीवित	p ʊ n ə ɾ d͡ʒ iː ʋ ɪ t̪
सम्यक्	s ə m j ə k
टलना	ʈ ə l n ɑː
सात	s ɑː t̪
प्रवेश	p ɾ ə ʋ eː ʃ
जिंस	d͡ʒ ɪ n s
मामला	m ɑː m l ɑː
अटपटा	ə ʈ p ə ʈ ɑː
अर्धायु	ə ɾ d̪ ʱ ɑː j uː
महाराज	m ə ɦ ɑː ɾ ɑː d͡ʒ
अदावत	ə d̪ ɑː ʋ ə t̪
ज़कात	z ə k ɑː t̪
होन्शू	ɦ oː n ʃ uː
परोसा	p ə ɾ oː s ɑː
खंडशः	kʰ ə n ɖ ʃ əʰ
उल्लंघन	ʊ l l ə ŋ ɡ ʱ ə n
उड़ान	ʊ ɽ ɑː n
क्रुद्ध	k ɾ ʊ d̪ d̪ ʱ
काबुकी	k ɑː b ʊ k iː
भुजंग	b ʱ ʊ d͡ʒ ə ŋ ɡ
खट	kʰ ə ʈ
अक्खड़	ə k kʰ ə ɽ
एकत्र	eː k ə t̪ ɾ
किशोरा	k ɪ ʃ oː ɾ ɑː
अर्धसाप्ताहिक	ə ɾ d̪ ʱ s ɑː p t̪ ɑː ɦ ɪ k
उपसर्ग	ʊ p s ə ɾ ɡ
नम्र	n ə m ɾ
आसन	ɑː s ə n
अतीत	ə t̪ iː t̪
मस्ताना	m ə s t̪ ɑː n ɑː
ईजियन	iː d͡ʒ iː j ə n
उलहना	ʊ l ɦ n ɑː
घंटा	ɡ ʱ ə n ʈ ɑː
रैन	ɾ ɛː n
गुजराती	ɡ ʊ d͡ʒ ɾ ɑː t̪ iː
कजरारा	k ə d͡ʒ ɾ ɑː ɾ ɑː
ज्ञानमीमांसा	ɡ j ɑː n m iː m ɑː n s ɑː
कैथल	k ɛː t̪ʰ ə l
पूर्णतः	p uː ɾ n ə t̪ əʰ
वक्ता	ʋ ə k t̪ ɑː
आह	ɑː ʱ
छिहत्तर	t͡ʃʰ ɪ ɦ ə t̪ t̪ ə ɾ
सकर्मक	s ə k ə ɾ m ə k
राजेश	r aː d͡ʒ e ʃ
शास्त्र	ʃ ɑː s t̪ ɾ
अँगरेज़	ə̃ ɡ ɾ eː z
जागना	d͡ʒ ɑː ɡ n ɑː
बपतिस्मा	b ə p t̪ ɪ s m ɑː
परवाना	p ə ɾ ʋ ɑː n ɑː
दिखाई	d̪ ɪ kʰ ɑː iː
लिवरपूल	l ɪ ʋ ə ɾ p uː l
सदरी	s ə d̪ ɾ iː
पेट्रोल	p eː ʈ ɾ oː l
पेटू	p eː ʈ uː
फ़्रांसीसी	f ɾ ɑː n s iː s iː
डकार	ɖ ə k ɑː ɾ
गांसू	ɡ ɑː n s uː
वेल्ला	ʋ eː l l ɑː
अरमान	ə ɾ m ɑː n
होंठ	ɦ oː n ʈʰ
सौदा	s ɔː d̪ ɑː
शब्दसूची	ʃ ə b d̪ s uː t͡ʃ iː
दंतकथा	d̪ ə n t̪ k ə t̪ʰ ɑː
जावा	d͡ʒ ɑː ʋ ɑː
लांछन	l ɑː ɲ t͡ʃʰ ə n
तकलीफ़	t̪ ə k l iː f
अयस्	ə j ə s
परास्त	p ə ɾ ɑː s t̪
महाराजा	m ə ɦ ɑː ɾ ɑː d͡ʒ ɑː
तुलसी	t̪ ʊ l s iː
पुष्प	p ʊ ʃ p
चुटकुला	t͡ʃ ʊ ʈ k ʊ l ɑː
पिया	p iː j ɑː
प्योंगचैंग	p j oː ŋ ɡ t͡ʃ ɛː ŋ ɡ
थामना	t̪ʰ ɑː m n ɑː
पहरा	p ɛː ʱ ɾ ɑː
लगन	l ə ɡ ə n
थूक	t̪ʰ uː k
मिन्नत	m ɪ n n ə t̪
वजह	ʋ ə d͡ʒ ə ʱ
बेलारूस	b eː l ɑː ɾ uː s
जमाख़ोरी	d͡ʒ ə m aː x oː r iː
फ्रांसीसी	f ɾ ɑː n s iː s iː
चन्द्र	t͡ʃ ə n d̪ ɾ
गांधीगिरी	ɡ ɑː n d̪ ʱ iː ɡ ɪ ɾ iː
हबीब	ɦ ə b iː b
थाई	t̪ʰ ɑː iː
चूर्ण	t͡ʃ uː ɾ n
काठ	k ɑː ʈʰ
गुझिया	ɡ ʊ d͡ʒ ʱ iː j ɑː
बढ़ाना	b ə ɽ ʱ ɑː n ɑː
वाजिब	ʋ ɑː d͡ʒ ɪ b
विशिष्ट	ʋ ɪ ʃ ɪ ʃ ʈ
इत्र	ɪ t̪ ɾ
दुभाषिया	d̪ ʊ b ʱ ɑː ʃ iː j ɑː
ऋणायन	ɾ ɪ n ɑː j ə n
स्कूली	s k uː l iː
बलूची	b ə l uː t͡ʃ iː
शोक	ʃ oː k
उतारना	ʊ t̪ ɑː ɾ n ɑː
वाटर	ʋ ɑː ʈ ə ɾ
लाइन	l ɑː ɪ n
फ़िदायीन	f ɪ d̪ ɑː j iː n
वसंत	ʋ ə s ə n t̪
मेरा	m eː ɾ ɑː
परस्पर	p ə ɾ ə s p ə ɾ
छिड़काव	t͡ʃʰ ɪ ɽ k ɑː ʋ
बदनाम	b ə d̪ n ɑː m
गुंजाइश	ɡ ʊ ɲ d͡ʒ ɑː ɪ ʃ
तसव्वुर	t̪ ə s ə ʋ ʋ ʊ ɾ
प्रकार्यात्मक	p ɾ ə k ɑː ɾ j ɑː t̪ m ə k
दिल	d̪ ɪ l
सदैव	s ə d̪ ɛː ʋ
मिल्कियत	m ɪ l k iː j ə t̪
उमंग	ʊ m ə ŋ ɡ
खेना	kʰ eː n ɑː
गऊ	ɡ ə uː
निर्जन	n ɪ ɾ d͡ʒ ə n
अश्व	ə ʃ ʋ
परख	p ə ɾ ə kʰ
अचकन	ə t͡ʃ k ə n
लोहड़ी	l oː ʱ ɽ iː
छननी	t͡ʃʰ ə n n iː
पिघलाना	p ɪ ɡ ʱ l ɑː n ɑː
विकिरणशीलता	ʋ ɪ k ɪ ɾ ə n ʃ iː l t̪ ɑː
दोपहर	d̪ oː p ɛː ʱ ɾ
राही	ɾ ɑː ɦ iː
भीख	b ʱ iː kʰ
ब्रैंपटन	b ɾ ɛː m p ʈ ə n
पतीला	p ə t̪ iː l ɑː
भंडार	b ʱ ə n ɖ ɑː ɾ
ज़बान	z ə b ɑː n
ज्ञाता	ɡ j ɑː t̪ ɑː
चरित्र	t͡ʃ ə ɾ ɪ t̪ ɾ
श्रद्धालु	ʃ ɾ ə d̪ d̪ ʱ ɑː l uː
गठित	ɡ ə ʈʰ ɪ t̪
कारनामा	k ɑː ɾ n ɑː m ɑː
लुत्फ़	l ʊ t̪ f
सन्निकटन	s ə n n ɪ k ə ʈ ə n
अनसुना	ə n s ʊ n ɑː
क्रांतिकारी	k ɾ ɑː n t̪ ɪ k ɑː ɾ iː
साख	s ɑː kʰ
अधिकार	ə d̪ ʱ ɪ k ɑː ɾ
नगरीकरण	n ə ɡ ɾ iː k ɾ ə n
प्रसंग	p ɾ ə s ə ŋ ɡ
नाग	n ɑː ɡ
ताया	t̪ ɑː j ɑː
एड़ी	eː ɽ iː
क्रम	k ɾ ə m
धनाग्र	d̪ ʱ ə n ɑː ɡ ɾ
नीर	n iː ɾ
पैर	p ɛː ɾ
चखना	t͡ʃ ə kʰ n ɑː
माहिर	m ɑː ɦ ɪ ɾ
इस्म	ɪ s m
टोप	ʈ oː p
अव्यक्त	ə ʋ j ə k t̪
समधी	s ə m d̪ ʱ iː
गाढ़ा	ɡ ɑː ɽ ʱ ɑː
निर्धन	n ɪ ɾ d̪ ʱ ə n
सादा	s ɑː d̪ ɑː
अगर	ə ɡ ə ɾ
इज़्ज़त	ɪ z z ə t̪
विकिरणशील	ʋ ɪ k ɪ ɾ ə n ʃ iː l
अफ़्साना	ə f s ɑː n ɑː
छोला	t͡ʃʰ oː l ɑː
गंभीर	ɡ ə m b ʱ iː ɾ
मचलना	m ə t͡ʃ ə l n ɑː
बाप्तिस्मा	b ɑː p t̪ ɪ s m ɑː
निर्यात	n ɪ ɾ j ɑː t̪
थानेदार	t̪ʰ ɑː n eː d̪ ɑː ɾ
वानर	ʋ ɑː n ə ɾ
ढोटा	ɖ ʱ oː ʈ ɑː
अनकहा	ə n k ə ɦ ɑː
वास्तु	ʋ ɑː s t̪ uː
बोत्सवाना	b oː t̪ s ə ʋ ɑː n ɑː
बसेरा	b ə s eː ɾ ɑː
बकचोदी	b ə k t͡ʃ oː d̪ iː
पीलापन	p iː l ɑː p ə n
सिडनी	s ɪ ɖ n iː
असफल	ə s ə pʰ ə l
आकर्षक	ɑː k ə ɾ ʃ ə k
धड़ल्ला	d̪ ʱ ə ɽ ə l l ɑː
रस	ɾ ə s
मलाल	m ə l ɑː l
स्लोवेनिया	s l oː ʋ eː n iː j ɑː
परिचालन	p ə ɾ ɪ t͡ʃ ɑː l ə n
बावरची	b ɑː ʋ ə ɾ t͡ʃ iː
ओगाज़्म	o ɡ aː z m
बौछार	b ɔː t͡ʃʰ ɑː ɾ
आंकड़ा	ɑː ŋ k ɽ ɑː
विज्ञापित	ʋ ɪ ɡ j ɑː p ɪ t̪
भार	b ʱ ɑː ɾ
दगला	d̪ ə ɡ l ɑː
अक्षत	ə k ʃ ə t̪
अहम	ɛː ʱ m
चिढ़	t͡ʃ ɪ ɽ ʱ
जीजा	d͡ʒ iː d͡ʒ ɑː
धुन्नी	d̪ ʱ ʊ n n iː
महत्व	m ɛː ʱ t̪ ʋ
प्रगतिशील	p ɾ ə ɡ ə t̪ ɪ ʃ iː l
मणि	m ə n iː
लहज़ा	l ɛː ʱ z ɑː
चोल	t͡ʃ oː l
अंगना	ə ŋ ɡ ə n ɑː
स्वतंत्र	s ʋ ə t̪ ə n t̪ ɾ
रोज़	ɾ oː z
चमड़ा	t͡ʃ ə m ɽ ɑː
आतिश	ɑː t̪ ɪ ʃ
बीमा	b iː m ɑː
मारपीट	m ɑː ɾ p iː ʈ
आम	ɑː m
स्वीडन	s ʋ iː ɖ ə n
शस्त्र	ʃ ə s t̪ ɾ
अनुशासन	ə n ʊ ʃ ɑː s ə n
लोक	l oː k
सूर्योदय	s uː ɾ j oː d̪ ə j
वरुण	ʋ ə r ʊ ɳ
त्यों	t̪ j õː
यमक	j ə m ə k
अनिश्चित	ə n ɪ ʃ t͡ʃ ɪ t̪
सड़सठ	s ə ɽ s ə ʈʰ
पायस	p ɑː j ə s
पूंडरी	p uː n ɖ ɾ iː
जादू	d͡ʒ ɑː d̪ uː
शव	ʃ ə ʋ
श्रद्धेय	ʃ ɾ ə d̪ d̪ ʱ eː j
लंबू	l ə m b uː
सखा	s ə kʰ ɑː
शहीद	ʃ ə ɦ iː d̪
बैतलहम	b ɛː t̪ l ɛː ʱ m
संग्रह	s ə ŋ ɡ ɾ ə ʱ
हिमांक	ɦ ɪ m ɑː ŋ k
बुसान	b ʊ s ɑː n
तत्व	t̪ ə t̪ ʋ
मुल्तानी	m ʊ l t̪ ɑː n iː
समायोजित	s ə m ɑː j oː d͡ʒ ɪ t̪
अंकल	ə ŋ k ə l
भारोत्तोलक	b ʱ ɑː ɾ oː t̪ t̪ oː l ə k
लाफा	l ɑː pʰ ɑː
संदेह	s ə n d̪ eː ʱ
कृत्रिम	k ɾ ɪ t̪ ɾ ɪ m
सब्ज़ी	s ə b z iː
अपहर्ता	ə pʰ ə ɾ t̪ ɑː
कामकाज	k ɑː m k ɑː d͡ʒ
सांस्कृतिक	s ɑː n s k ɾ ɪ t̪ ɪ k
नित्य	n ɪ t̪ j
पिलाना	p ɪ l ɑː n ɑː
डाक	ɖ ɑː k
गतिकी	ɡ ə t̪ ɪ k iː
बेंच	b eː ɲ t͡ʃ
थैला	t̪ʰ ɛː l ɑː
चना	t͡ʃ ə n ɑː
शोथ	ʃ oː t̪ʰ
अकूत	ə k uː t̪
नेकी	n eː k iː
स्नेही	s n eː ɦ iː
डिजिटल	ɖ ɪ d͡ʒ ɪ ʈ ə l
भिड़	b ʱ ɪ ɽ
तू	t̪ uː
पूछ	p uː t͡ʃʰ
दलबदलू	d̪ ə l b ə d̪ l uː
पपीता	p ə p iː t̪ ɑː
असहिष्णु	ə s ə ɦ ɪ ʃ n uː
जाँबाज़	d͡ʒ ɑ̃ː b ɑː z
वाद्ययंत्र	ʋ ɑː d̪ j ə j ə n t̪ ɾ
रणछोड़	ɾ ə n t͡ʃʰ oː ɽ
थूथन	t̪ʰ uː t̪ʰ ə n
सिगार	s ɪ ɡ ɑː ɾ
पारित	p ɑː ɾ ɪ t̪
अमेरिका	ə m eː ɾ ɪ k ɑː
अटकाना	ə ʈ k ɑː n ɑː
डुबकी	ɖ ʊ b k iː
धर्मस्थलों	d̪ ʱ ə ɾ m ə s t̪ʰ ə l õː
भैया	b ʱ ə iː j ɑː
पौष्टिक	p ɔː ʃ ʈ ɪ k
काल	k ɑː l
उपकार	ʊ p k ɑː ɾ
लपकना	l ə p ə k n ɑː
शमशेर	ʃ ə m ʃ eː ɾ
पतलू	p ə t̪ l uː
सरदी	s ə ɾ d̪ iː
सुस्ती	s ʊ s t̪ iː
सारस	s ɑː ɾ ə s
अंगूर	ə ŋ ɡ uː ɾ
कीटाणु	k iː ʈ ɑː n uː
ट्रॅक्टर	ʈ ɾ æː k ʈ ə ɾ
कामिल	k ɑː m ɪ l
आधुनिकीकरण	ɑː d̪ ʱ ʊ n ɪ k iː k ə ɾ ə n
जाएगा	d͡ʒ ɑː eː ɡ ɑː
सिया	s iː j ɑː
निराश	n ɪ ɾ ɑː ʃ
रज़ामंद	ɾ ə z ɑː m ə n d̪
अल्पकारी	ə l p ə k ɑː ɾ iː
चूकना	t͡ʃ uː k n ɑː
अगरबत्ती	ə ɡ ə ɾ b ə t̪ t̪ iː
ओणम	oː n ə m
झूठो	d ʒ ʱ uː ʈʰ o
लंगूर	l ə ŋ ɡ uː ɾ
रीढ़	ɾ iː ɽ ʱ
लंगड़ा	l ə ŋ ɡ ɽ ɑː
एकवचन	eː k ʋ ə t͡ʃ ə n
जुड़ना	d͡ʒ ʊ ɽ n ɑː
पेज	p eː d͡ʒ
बोली	b oː l iː
या	j ɑː
अर्द्ध	ə ɾ d̪ d̪ ʱ
मयूर	m ə j uː ɾ
विनिवेश	ʋ ɪ n ɪ ʋ eː ʃ
बार	b ɑː ɾ
मियाँ	m iː j ɑ̃ː
दरांती	d̪ ə ɾ ɑː n t̪ iː
समायोजन	s ə m ɑː j oː d͡ʒ ə n
मंगल	m ə ŋ ɡ ə l
गतिरोध	ɡ ə t̪ ɪ ɾ oː d̪ ʱ
मोहरा	m oː ʱ ɾ ɑː
सघन	s ə ɡ ʱ ə n
सिमटना	s ɪ m ə ʈ n ɑː
प्योंगयांग	p j oː ŋ ɡ j ɑː ŋ ɡ
अराजक	ə ɾ ɑː d͡ʒ ə k
सुनार	s ʊ n ɑː ɾ
पकड़	p ə k ə ɽ
असंभव	ə s ə m b ʱ ə ʋ
अप्रैल	ə p ɾ ɛː l
आसार	ɑː s ɑː ɾ
सब	s ə b
गन्ना	ɡ ə n n ɑː
अंगार	ə ŋ ɡ ɑː ɾ
खुलना	kʰ ʊ l n ɑː
अड़चन	ə ɽ t͡ʃ ə n
लैंगिक	l ɛː ŋ ɡ ɪ k
वामपंथी	ʋ ɑː m p ə n t̪ʰ iː
संदूषण	s ə n d̪ uː ʃ ə n
पश्चिम	p ə ʃ t͡ʃ ɪ m
फ़ैज़	f ɛː z
घनीय	ɡ ʱ ə n iː j
दौरा	d̪ ɔː ɾ ɑː
बाईस	b ɑː iː s
मुग्ध	m ʊ ɡ d̪ ʱ
बहरी	b ɛː ʱ ɾ iː
अटकलपच्चू	ə ʈ k ə l p ə t͡ʃ t͡ʃ uː
मशीन	m ə ʃ iː n
लचकना	l ə t͡ʃ ə k n ɑː
बोर्ड	b oː ɾ ɖ
ग्रीष्म	ɡ ɾ iː ʃ m
बहलना	b ɛː ʱ l n ɑː
कवक	k ə ʋ ə k
शिलांग	ʃ ɪ l ɑː ŋ ɡ
पापड़	p ɑː p ə ɽ
अन्यायपूर्ण	ə n j ɑː j p uː ɾ n
शुरू	ʃ ʊ ɾ uː
डायनासोर	ɖ ɑː j n ɑː s oː ɾ
नाहर	n ɑː ɦ ə ɾ
दशमलव	d̪ ə ʃ ə m l ə ʋ
नेपथ्य	n eː p ə t̪ʰ j
उपभोज्य	ʊ p b ʱ oː d͡ʒ j
स्वराक्षर	s ʋ ə ɾ ɑː k ʃ ə ɾ
तुलनात्मक	t̪ ʊ l ə n ɑː t̪ m ə k
मांसल	m ɑː n s ə l
संवैधानिक	s ə m ʋ ɛː d̪ ʱ ɑː n ɪ k
प्रसारित	p ɾ ə s ɑː ɾ ɪ t̪
क्षितिज	k ʃ ɪ t̪ ɪ d͡ʒ
निर्भर	n ɪ ɾ b ʱ ə ɾ
मार्गाभिगमन	m ɑː ɾ ɡ ɑː b ʱ ɪ ɡ ə m ə n
उपला	ʊ p l ɑː
कष्ट	k ə ʃ ʈ
इंडस्ट्री	ɪ n ɖ ə s ʈ ɾ iː
शहज़ादी	ʃ ɛː ʱ z ɑː d̪ iː
थमाना	t̪ʰ ə m ɑː n ɑː
मुआहिदा	m ʊ ɑː ɦ ɪ d̪ ɑː
निजीकरण	n ɪ d͡ʒ iː k ə ɾ ə n
कुवैत	k ʊ ʋ ɛː t̪
पुस्तकीय	p ʊ s t̪ ə k iː j
प्रत्यर्पण	p ɾ ə t̪ j ə ɾ p ə n
गुनगुनाना	ɡ ʊ n ɡ ʊ n ɑː n ɑː
दादा	d̪ ɑː d̪ ɑː
क्रमादेशन	k ɾ ə m ɑː d̪ eː ʃ ə n
अलगाववादी	ə l ɡ ɑː ʋ ʋ ɑː d̪ iː
संस्थापक	s ə n s t̪ʰ ɑː p ə k
मेघालय	m eː ɡ ʱ ɑː l ə j
अवपंक	ə ʋ p ə ŋ k
खिलाना	kʰ ɪ l ɑː n ɑː
मज़हब	m ə z ɦ ə b
सूरिया	s uː ɾ iː j ɑː
बाती	b ɑː t̪ iː
खेत	kʰ e t̪
हिस्सेदार	ɦ ɪ s s eː d̪ ɑː ɾ
चिरस्थायित्व	t͡ʃ ɪ ɾ s t̪ʰ ɑː j ɪ t̪ ʋ
इब्राहीम	ɪ b ɾ ɑː ɦ iː m
मूक	m uː k
तबला	t̪ ə b l ɑː
अर्थ	ə ɾ t̪ʰ
सुरत	s ʊ ɾ ə t̪
पचना	p ə t͡ʃ n ɑː
भोजनालय	b ʱ oː d͡ʒ n ɑː l ə j
वायुजनित	ʋ ɑː j ʊ d͡ʒ ə n ɪ t̪
तथापि	t̪ ə t̪ʰ ɑː p iː
धारणा	d̪ ʱ ɑː ɾ n ɑː
आगाह	ɑː ɡ ɑː ʱ
तलहटी	t̪ ə l ɛː ʱ ʈ iː
दरगाह	d̪ ə ɾ ɡ ɑː ʱ
सौगंद	s ɔː ɡ ə n d̪
फ़ारसी	f ɑː ɾ s iː
गिलास	ɡ ɪ l ɑː s
पारसी	p ɑː ɾ s iː
प्रायः	p ɾ ɑː j əʰ
गुज़रना	ɡ ʊ z ə ɾ n ɑː
लाओस	l ɑː oː s
सबूत	s ə b uː t̪
विपरीत	ʋ ɪ p ɾ iː t̪
निबंध	n ɪ b ə n d̪ ʱ
ओलंपिक	oː l ə m p ɪ k
अभ्यागत	ə b ʱ j ɑː ɡ ə t̪
विनय	ʋ ɪ n ə j
अब्बा	ə b b ɑː
कड़वाहट	k ə ɽ ʋ ɑː ɦ ə ʈ
मुसलमान	m ʊ s ə l m ɑː n
लार	l ɑː ɾ
अबटाबाद	ə b ʈ ɑː b ɑː d̪
खदान	kʰ ə d̪ ɑː n
बान	b ɑː n
भागना	b ʱ ɑː ɡ n ɑː
नाफ़	n ɑː f
अनजाने	ə n d͡ʒ ɑː n eː
पसंदीदा	p ə s ə n d̪ iː d̪ ɑː
दुष्परिणाम	d̪ ʊ ʃ p ə ɾ ɪ n ɑː m
कार्यकाल	k ɑː ɾ j ə k ɑː l
इकतीस	ɪ k t̪ iː s
नवविवाहित	n ə ʋ ʋ ɪ ʋ ɑː ɦ ɪ t̪
भाव	b ʱ ɑː ʋ
मुज़फ़्फ़रगढ़	m ʊ z ə f f ə ɾ ɡ ə ɽ ʱ
साफ़	s ɑː f
भारा	b ʱ ɑː ɾ ɑː
लखनऊ	l ə kʰ n ə uː
बाँग	b ɑ̃ː ɡ
संगठन	s ə ŋ ɡ ə ʈʰ ə n
उबाऊ	ʊ b ɑː uː
रेखा	ɾ eː kʰ ɑː
आतिशबाज़ी	ɑː t̪ ɪ ʃ b ɑː z iː
सहयोगी	s ə ʱ j oː ɡ iː
बंध	b ə n d̪ ʱ
मजमा	m ə d͡ʒ m ɑː
युद्धक्षेत्र	j ʊ d̪ d̪ ʱ k ʃ eː t̪ ɾ
आत्महत्या	ɑː t̪ m ɦ ə t̪ j ɑː
हमसाया	ɦ ə m s ɑː j ɑː
साइकिल	s ɑː ɪ k ɪ l
जलसिंह	d͡ʒ ə l s ɪ n ʱ
ग्रीस	ɡ ɾ iː s
दाम	d̪ ɑː m
संप्रभु	s ə m p ɾ ə b ʱ uː
तराशना	t̪ ə ɾ ɑː ʃ n ɑː
संरचनात्मक	s ə n ɾ ə t͡ʃ n ɑː t̪ m ə k
फलन	pʰ ə l ə n
व्याकुल	ʋ j ɑː k ʊ l
तुम	t ʊ m
आपका	ɑː p k ɑː
वंचित	ʋ ə ɲ t͡ʃ ɪ t̪
डोरी	ɖ oː ɾ iː
न्यायशास्त्र	n j ɑː j ʃ ɑː s t̪ ɾ
मलयालम	m ə l ə j ɑː l ə m
तेज़ाब	t̪ eː z ɑː b
वास्तविकता	ʋ ɑː s t̪ ə ʋ ɪ k t̪ ɑː
विघ्न	ʋ ɪ ɡ ʱ n
जनवरी	d͡ʒ ə n ʋ ə ɾ iː
दृग	d̪ ɾ ɪ ɡ
ताड़	t̪ ɑː ɽ
बद्ध	b ə d̪ d̪ ʱ
सुग्गा	s ʊ ɡ ɡ ɑː
प्यास	p j ɑː s
दिली	d̪ ɪ l iː
थन	t̪ʰ ə n
अनिच्छा	ə n ɪ t͡ʃ t͡ʃʰ ɑː
प्रगति	p ɾ ə ɡ ə t̪ iː
रक्खना	ɾ ə k kʰ n ɑː
फफकना	pʰ ə pʰ ə k n ɑː
दुकान	d̪ ʊ k ɑː n
गंदा	ɡ ə n d̪ ɑː
आलीशान	ɑː l iː ʃ ɑː n
नई	n ə iː
अस्मिता	ə s m ɪ t̪ ɑː
टक्कर	ʈ ə k k ə ɾ
जायफल	d͡ʒ ɑː j pʰ ə l
तमाम	t̪ ə m ɑː m
आर्यमन	ɑː ɾ j ə m ə n
कांसी	k ɑː n s iː
पशुपालक	p ə ʃ ʊ p ɑː l ə k
अखंडता	ə kʰ ə n ɖ t̪ ɑː
यादृच्छिक	j ɑː d̪ ɾ ɪ t͡ʃ t͡ʃʰ ɪ k
नियुक्ति	n iː j ʊ k t̪ iː
दलहन	d̪ ə l ɦ ə n
आगाही	ɑː ɡ ɑː ɦ iː
साधना	s ɑː d̪ ʱ n ɑː
क्लब	k l ə b
मूत्रमार्ग	m uː t̪ ɾ ə m ɑː ɾ ɡ
नर	n ə ɾ
मद	m ə d̪
काटना	k ɑː ʈ n ɑː
विपक्षी	ʋ ɪ p ə k ʃ iː
अवाम	ə ʋ ɑː m
कामगार	k ɑː m ɡ ɑː ɾ
नब्ज़	n ə b z
उदारवाद	ʊ d̪ ɑː ɾ ʋ ɑː d̪
सूबा	s uː b ɑː
बस	b ə s
वासुदेव	ʋ ɑː s ʊ d̪ eː ʋ
लगी	l ə ɡ iː
धर्मस्थलो	d̪ ʱ ə ɾ m ə s t̪ʰ ə l oː
स्टार	s ʈ ɑː ɾ
दाई	d̪ ɑː iː
किरणपुंज	k ɪ ɾ ə n p ʊ ɲ d͡ʒ
निपुण	n ɪ p ʊ n
रेखाखंड	ɾ eː kʰ ɑː kʰ ə n ɖ
खटपट	kʰ ə ʈ p ə ʈ
विराटनगर	ʋ ɪ ɾ ɑː ʈ ə n ɡ ə ɾ
पुजारी	p ʊ d͡ʒ ɑː ɾ iː
भूतकाल	b ʱ uː t̪ k ɑː l
वेबकॅम	ʋ eː b k æː m
बलगतिकी	b ə l ɡ ə t̪ ɪ k iː
धाकड़	d̪ ʱ ɑː k ə ɽ
त्वचा	t̪ ʋ ə t͡ʃ ɑː
सूक्ष्माणु	s uː k ʃ m ɑː n uː
प्रचलित	p ɾ ə t͡ʃ ə l ɪ t̪
हथकरघा	ɦ ə t̪ʰ k ə ɾ ɡ ʱ ɑː
उंचाई	ʊ ɲ t͡ʃ ɑː iː
झुरमुट	d͡ʒ ʱ ʊ ɾ m ʊ ʈ
राजमा	ɾ ɑː d͡ʒ m ɑː
छोग्याल	t͡ʃʰ oː ɡ j ɑː l
चुगना	t͡ʃ ʊ ɡ n ɑː
मानचित्र	m ɑː n t͡ʃ ɪ t̪ ɾ
खोदना	kʰ oː d̪ n ɑː
नहला	n ɛː ʱ l ɑː
स्वकीय	s ʋ ə k iː j
हिन्दुस्तान	ɦ ɪ n d̪ ʊ s t̪ ɑː n
अपमानित	ə p m ɑː n ɪ t̪
राम	ɾ ɑː m
इंटरव्यू	ɪ n ʈ ə ɾ ʋ j uː
दूसरे	d̪ uː s ɾ eː
ऐसे	ɛː s eː
मौलिक	m ɔː l ɪ k
मीडिया	m iː ɖ iː j ɑː
हिंडोला	ɦ ɪ n ɖ oː l ɑː
होशे	ɦ o ʃ e
बोना	b oː n ɑː
सूर्यास्त	s uː ɾ j ɑː s t̪
ध्वन्यात्मक	d̪ ʱ ʋ ə n j ɑː t̪ m ə k
अट्ठावन	ə ʈ ʈʰ ɑː ʋ ə n
हाज़िरजवाबी	ɦ ɑː z ɪ ɾ d͡ʒ ə ʋ ɑː b iː
निष्ठुर	n ɪ ʃ ʈʰ ʊ ɾ
उर्वरक	ʊ ɾ ʋ ə ɾ ə k
भौंरा	b ʱ ɔː n ɾ ɑː
खिड़की	kʰ ɪ ɽ k iː
प्रमुख	p ɾ ə m ʊ kʰ
परिपूर्ण	p ə ɾ ɪ p uː ɾ n
शक्ल	ʃ ə k l
संचार	s ə ɲ t͡ʃ ɑː ɾ
अभिरुचि	ə b ʱ ɪ ɾ ʊ t͡ʃ iː
नूह	n uː ʱ
सप्ताह	s ə p t̪ ɑː ʱ
अधिलाभ	ə d̪ ʱ ɪ l ɑː b ʱ
जाड़ा	d͡ʒ ɑː ɽ ɑː
प्रस्तावक	p ɾ ə s t̪ ɑː ʋ ə k
हाथी	ɦ ɑː t̪ʰ iː
स्तुति	s t̪ ʊ t̪ iː
पैंतीस	p ɛː n t̪ iː s
प्रेक्षित	p ɾ eː k ʃ ɪ t̪
साइकल	s ɑː ɪ k ə l
रूसी	ɾ uː s iː
परिभाषित	p ə ɾ ɪ b ʱ ɑː ʃ ɪ t̪
काढ़ना	k ɑː ɽ ʱ n ɑː
निर्माता	n ɪ ɾ m ɑː t̪ ɑː
अधीश	ə d̪ ʱ iː ʃ
उत्सुकता	ʊ t̪ s ʊ k t̪ ɑː
दशहरा	d̪ ə ʃ ɛː ʱ ɾ ɑː
फ़िकर	f ɪ k ə ɾ
पेड़ा	p eː ɽ ɑː
सूना	s uː n ɑː
उपभोक्ता	ʊ p b ʱ oː k t̪ ɑː
बोलना	b oː l n ɑː
उच्छेदन	ʊ t͡ʃ t͡ʃʰ eː d̪ ə n
बस्ती	b ə s t̪ iː
साथ	s ɑː t̪ʰ
अकेलापन	ə k eː l ɑː p ə n
पैकेट	p ɛː k eː ʈ
जिसको	d͡ʒ ɪ s k oː
बटेर	b ə ʈ eː ɾ
चौका	t͡ʃ ɔː k ɑː
हुई	ɦ ʊ iː
पात्र	p ɑː t̪ ɾ
सामान्यीकृत	s ɑː m ɑː n j iː k ɾ ɪ t̪
आँख	ɑ̃ː kʰ
अधिकता	ə d̪ ʱ ɪ k t̪ ɑː
इस्तेमाल	ɪ s t̪ eː m ɑː l
उतरना	ʊ t̪ ə ɾ n ɑː
मृग	m ɾ ɪ ɡ
खाद्य	kʰ ɑː d̪ j ə
पीपा	p iː p ɑː
कूच	k uː t͡ʃ
सूअर	s uː ə ɾ
सजीवता	s ə d͡ʒ iː ʋ t̪ ɑː
लाड़	l ɑː ɽ
डगमग	ɖ ə ɡ m ə ɡ
मोदी	m oː d̪ iː
इंच	ɪ ɲ t͡ʃ
जेब	d͡ʒ eː b
गुलेल	ɡ ʊ l eː l
शुरु	ʃ ʊ ɾ uː
पड़ोस	p ə ɽ oː s
जनेऊ	d͡ʒ ə n eː uː
सड़क	s ə ɽ ə k
माननीय	m ɑː n n iː j
घातीय	ɡ ʱ ɑː t̪ iː j
उजागर	ʊ d͡ʒ ɑː ɡ ə ɾ
वसीयत	ʋ ə s iː j ə t̪
टटोलना	ʈ ə ʈ oː l n ɑː
बीड़ी	b iː ɽ iː
करनाल	k ə ɾ n ɑː l
तुमने	t̪ ʊ m n eː
कुत्ता	k ʊ t̪ t̪ ɑː
बृहस्पति	b ɾ ɪ ɦ ə s p ə t̪ iː
समयानुसार	s ə m j ɑː n ʊ s ɑː ɾ
तर्जुमान	t̪ ə ɾ d͡ʒ ʊ m ɑː n
लोबिया	l oː b iː j ɑː
आघात	ɑː ɡ ʱ ɑː t̪
जुमेरात	d͡ʒ ʊ m eː ɾ ɑː t̪
मनु	m ə n uː
बंदा	b ə n d̪ ɑː
लिखने	l ɪ kʰ n eː
युद्धनीति	j ʊ d̪ d̪ ʱ n iː t̪ iː
रिक्शा	ɾ ɪ k ʃ ɑː
टिमटिमाना	ʈ ɪ m ʈ ɪ m ɑː n ɑː
छेद	t͡ʃʰ eː d̪
अग्नि	ə ɡ n iː
बिनती	b ɪ n t̪ iː
मुअज़्ज़िन	m ʊ ə z z ɪ n
नालायक	n ɑː l ɑː j ə k
लब्धि	l ə b d̪ ʱ iː
प्रोटीन	p ɾ oː ʈ iː n
नारी	n ɑː ɾ iː
प्रेरित	p ɾ eː ɾ ɪ t̪
हटना	ɦ ə ʈ n ɑː
झंझट	d͡ʒ ʱ ə ɲ d͡ʒ ʱ ə ʈ
बेतुका	b eː t̪ ʊ k ɑː
विनाशकारी	ʋ ɪ n ɑː ʃ k ɑː ɾ iː
आयुर्वेद	ɑː j ʊ ɾ ʋ eː d̪
अल्बम	ə l b ə m
स्वामी	s ʋ ɑː m iː
बीती	b iː t̪ iː
अंजु	ə ɲ d͡ʒ uː
व्यूहरचना	ʋ j uː ʱ ɾ ə t͡ʃ n ɑː
ऐनक	ɛː n ə k
ताउम्र	t̪ ɑː ʊ m ɾ
सन्निकट	s ə n n ɪ k ə ʈ
भिडु	b ʱ ɪ ɖ uː
संभव	s ə̃ m b ʱ ə ʋ
परन्दा	p ə ɾ ə n d̪ ɑː
फंदा	pʰ ə n d̪ ɑː
घिरना	ɡ ʱ ɪ ɾ n ɑː
फ़ितरत	f ɪ t̪ ɾ ə t̪
रामलीला	ɾ ɑː m l iː l ɑː
याजक	j ɑː d͡ʒ ə k
अंजन	ə ɲ d͡ʒ ə n
दहलीज़	d̪ ɛː ʱ l iː z
तिहत्तर	t̪ ɪ ɦ ə t̪ t̪ ə ɾ
गांव	ɡ ɑ̃ː ʋ
अपसामान्य	ə p s ɑː m ɑː n j
मामा	m ɑː m ɑː
स्थलीय	s t̪ʰ ə l iː j
सचमुच	s ə t͡ʃ m ʊ t͡ʃ
ऊटपटांग	uː ʈ ə p ʈ ɑː ŋ ɡ
तरीका	t̪ ə ɾ iː k ɑː
पेशावर	p eː ʃ ɑː ʋ ə ɾ
निष्ठा	n ɪ ʃ ʈʰ ɑː
गिला	ɡ ɪ l ɑː
क्षयरोग	k ʃ ə j ɾ oː ɡ
राज्यपाल	ɾ ɑː d͡ʒ j ə p ɑː l
अखंड	ə kʰ ə ɳ ɖ
गया	ɡ ə j ɑː
व्यथा	ʋ j ə t̪ʰ ɑː
छितराना	t͡ʃʰ ɪ t̪ ɾ ɑː n ɑː
नख	n ə kʰ
मजाल	m ə d͡ʒ ɑː l
नरसिंह	n ə ɾ s ɪ ŋ ɡ ʱ
हसीना	ɦ ə s iː n ɑː
चीड़	t͡ʃ iː ɽ
शिष्ट	ʃ ɪ ʃ ʈ
यूरोप	j uː ɾ oː p
भरपूर	b ʱ ə ɾ p uː ɾ
इलायची	ɪ l ɑː j ə t͡ʃ iː
प्रिटोरिया	p ɾ ɪ ʈ oː ɾ iː j ɑː
इबादत	ɪ b ɑː d̪ ə t̪
हैवान	ɦ ɛː ʋ ɑː n
विज़ारत	ʋ ɪ z ɑː ɾ ə t̪
प्रतिबिंब	p ɾ ə t̪ ɪ b ɪ m b
डोला	ɖ oː l ɑː
ललकारना	l ə l k ɑː ɾ n ɑː
नरवृषभ	n ə ɾ ʋ ɾ ɪ ʃ ə b ʱ
भंकस	b ʱ ə ŋ k ə s
छेड़	t͡ʃʰ eː ɽ
मसरूफ़	m ə s ɾ uː f
समरूप	s ə m ɾ uː p
रवाना	ɾ ə ʋ ɑː n ɑː
कील	k iː l
प्रायद्वीप	p ɾ ɑː j d̪ ʋ iː p
दाँत	d̪ ɑ̃ː t̪
छाल	t ʃʰ aː l
भाग्यशाली	b ʱ aː ɡ j ə ʃ aː l iː
बहावलनगर	b ə ɦ ɑː ʋ ə l n ə ɡ ə ɾ
संसाधन	s ə n s ɑː d̪ ʱ ə n
गर्दन	ɡ ə ɾ d̪ ə n
स्वीकारात्मक	s ʋ iː k ɑː ɾ ɑː t̪ m ə k
संप्रभुता	s ə m p ɾ ə b ʱ ʊ t̪ ɑː
घुंघरू	ɡ ʱ ʊ ŋ ɡ ʱ ɾ uː
आदिवासी	ɑː d̪ ɪ ʋ ɑː s iː
हाज़िरजवाब	ɦ ɑː z ɪ ɾ d͡ʒ ə ʋ ɑː b
मोड़ना	m oː ɽ n ɑː
पहेली	p ə ɦ eː l iː
आत्मकथा	ɑː t̪ m ə k ə t̪ʰ ɑː
घमासान	ɡ ʱ ə m ɑː s ɑː n
व्यवसाय	ʋ j ə ʋ s ɑː j
अगस्त	ə ɡ ə s t̪
परीक्षा	p ə ɾ iː k ʃ ɑː
माप	m ɑː p
चवन्नी	t͡ʃ ə ʋ ə n n iː
बनावट	b ə n ɑː ʋ ə ʈ
तैनाती	t̪ ɛː n ɑː t̪ iː
टूटना	ʈ uː ʈ n ɑː
स्वाभाविक	s ʋ ɑː b ʱ ɑː ʋ ɪ k
बेमेल	b eː m eː l
शख्सियत	ʃ ə kʰ s iː j ə t̪
अश्विनी	ə ʃ ʋ ɪ n iː
मुँडेर	m ʊ̃ ɖ eː ɾ
सत्ता	s ə t̪ t̪ ɑː
तारा	t̪ ɑː ɾ ɑː
राइफ़ल	ɾ ɑː ɪ f ə l
पेठा	p eː ʈʰ ɑː
बुलाकर	b ʊ l ɑː k ə ɾ
बिलखना	b ɪ l ə kʰ n ɑː
षष्ठी	ʃ ə ʃ ʈʰ iː
नाक	n ɑː k
साढ़े	s ɑː ɽ ʱ eː
फ्रेन्चाइज़	f ɾ eː n t͡ʃ ɑː ɪ z
भागी	b ʱ ɑː ɡ iː
जदयू	d͡ʒ ə d̪ j uː
इमला	ɪ m l ɑː
सितंबर	s ɪ t̪ ə m b ə ɾ
सहसा	s ə ʱ s ɑː
तालाब	t̪ ɑː l ɑː b
ठहरना	ʈʰ ɛː ʱ ɾ n ɑː
पैठ	p ɛː ʈʰ
कंकड़ीला	k ə ŋ k ɽ iː l ɑː
प्रगतिवाद	p ɾ ə ɡ ə t̪ ɪ ʋ ɑː d̪
व्यंग	ʋ j ə ŋ ɡ
कमाल	k ə m ɑː l
मोड़	m oː ɽ
उपनाम	ʊ p n ɑː m
तंज़ानिया	t̪ ə n z ɑː n iː j ɑː
बद्दू	b ə d̪ d̪ uː
मछुआरा	m ə t͡ʃʰ ʊ ɑː ɾ ɑː
शांतिपूर्ण	ʃ ɑː n t̪ ɪ p uː ɾ n
पुर्त॰	p ʊ ɾ t̪ ə
भू	b ʱ uː
डुलना	ɖ ʊ l n ɑː
सहना	s ɛː ʱ n ɑː
देखना	d̪ eː kʰ n ɑː
सोआ	s oː ɑː
नृत्त	n ɾ ɪ t̪ t̪
मादा	m ɑː d̪ ɑː
गांठकट	ɡ ɑː n ʈʰ k ə ʈ
उबालना	ʊ b ɑː l n ɑː
बानवे	b ɑː n ʋ eː
सितारा	s ɪ t̪ ɑː ɾ ɑː
जीन	d͡ʒ iː n
अंधड़	ə n d̪ ʱ ə ɽ
ज़ीना	z iː n ɑː
धावा	d̪ ʱ ɑː ʋ ɑː
निज़ामाबाद	n ɪ z ɑː m ɑː b ɑː d̪
निगाह	n ɪ ɡ ɑː ʱ
साठवां	s ɑː ʈʰ ʋ ɑ̃ː
नौ	n ɔː
महताब	m ɛː ʱ t̪ ɑː b
जन्मभूमि	d͡ʒ ə n m b ʱ uː m iː
अभिनेता	ə b ʱ ɪ n eː t̪ ɑː
छाप	t͡ʃʰ ɑː p
सामने	s ɑː m n eː
इसरो	ɪ s ɾ oː
कशमकश	k ə ʃ ə m k ə ʃ
बनावटी	b ə n aː ʋ ə ʈ i ˑ
संपत्ति	s ə m p ə t̪ t̪ iː
अलादीन	ə l ɑː d̪ iː n
चारपाई	t͡ʃ ɑː ɾ p ɑː iː
बीमारी	b iː m ɑː ɾ iː
बेताब	b eː t̪ ɑː b
पेशेवर	p eː ʃ eː ʋ ə ɾ
कुंजीपटल	k ʊ ɲ d͡ʒ iː p ə ʈ ə l
रुपया	ɾ ʊ p j ɑː
कुटुंब	k ʊ ʈ ʊ m b
वर्ष	ʋ ə ɾ ʃ
फ़ना	f ə n ɑː
ताप	t̪ ɑː p
बयान	b ə j ɑː n
छिन	t͡ʃʰ ɪ n
गेय	ɡ eː j
नवाज़	n ə ʋ ɑː z
अविलंब	ə ʋ ɪ l ə m b
नासिक	n ɑː s ɪ k
हिंसा	ɦ ɪ n s ɑː
कोहिमा	k oː ɦ ɪ m ɑː
एकघातीय	eː k ɡ ʱ ɑː t̪ iː j
रिक्त	ɾ ɪ k t̪
मजनूँ	m ə d͡ʒ n ũː
विश्व	ʋ ɪ ʃ ʋ ə
गुह	ɡ uː ʱ
अवज्ञा	ə ʋ ə ɡ j ɑː
प्रभाव	p ɾ ə b ʱ ɑː ʋ
खराई	kʰ ə ɾ ɑː iː
घसीटना	ɡ ʱ ə s iː ʈ n ɑː
गर्द	ɡ ə ɾ d̪
पुनर्निर्माण	p ʊ n ə ɾ n ɪ ɾ m ɑː n
परिदृश्य	p ə ɾ ɪ d̪ ɾ ɪ ʃ j
पीढ़ी	p iː ɽ ʱ iː
आमदनी	ɑː m ə d̪ n iː
माधव	m ɑː d̪ ʱ ə ʋ
सटीक	s ə ʈ iː k
उबरना	ʊ b ə ɾ n ɑː
न्यूनतम	n j uː n t̪ ə m
असंतुष्ट	ə s ə n t̪ ʊ ʃ ʈ
सीनेटर	s iː n eː ʈ ə ɾ
लागू	l ɑː ɡ uː
मौसा	m ɔː s ɑː
अदरक	ə d̪ ɾ ə k
घूर	ɡ ʱ uː ɾ
मैनचेस्टर	m ɛː n t͡ʃ eː s ʈ ə ɾ
सम्मेलन	s ə m m eː l ə n
शमशीर	ʃ ə m ʃ iː ɾ
बिस्तर	b ɪ s t̪ ə ɾ
सरल	s ə ɾ ə l
रूप	r uː p
फालतू	pʰ ɑː l t̪ uː
यज्ञ	j ə ɡʲ
गुरुत्वीय	ɡ ʊ ɾ ʊ t̪ ʋ iː j
गरुड	ɡ ə ɾ ʊ ɖ
पिस्ता	p ɪ s t̪ ɑː
कुर्की	k ʊ ɾ k iː
टोपी	ʈ oː p iː
शैली	ʃ ɛː l iː
उपन्यास	ʊ p ə n j ɑː s
नेत्र	n eː t̪ ɾ
स्फटयातु	s pʰ ə ʈ j ɑː t̪ uː
पैकार	p ɛː k ɑː ɾ
बरात	b ə ɾ ɑː t̪
संशोधित	s ə n ʃ oː d̪ ʱ ɪ t̪
शौच	ʃ ɔː t͡ʃ
सुलझा	s ʊ l d͡ʒ ʱ ɑː
पकोड़ा	p ə k oː ɽ ɑː
घुड़सवार	ɡ ʱ ʊ ɽ ə s ʋ ɑː ɾ
भ्राजातु	b ʱ ɾ ɑː d͡ʒ ɑː t̪ uː
हिंदको	ɦ ɪ n d̪ k oː
धनायन	d̪ ʱ ə n ɑː j ə n
इज़ाफ़ा	ɪ z ɑː f ɑː
अधिवेशन	ə d̪ ʱ ɪ ʋ eː ʃ ə n
नजीबाबाद	n ə d͡ʒ iː b ɑː b ɑː d̪
नादान	n ɑː d̪ ɑː n
बंजर	b ə ɲ d͡ʒ ə ɾ
हुस्न	ɦ ʊ s n
फीका	pʰ iː k ɑː
गर्भ	ɡ ə ɾ b ʱ
कुल	k ʊ l
अमरीका	ə m ɾ iː k ɑː
पाबंदी	p ɑː b ə n d̪ iː
वर्मसरट	ʋ ə ɾ m s ə ɾ ə ʈ
कूर	k uː ɾ
सलोना	s ə l oː n ɑː
चौंकाना	t͡ʃ ɔː ŋ k ɑː n ɑː
निरंकुशवाद	n ɪ ɾ ə ŋ k ʊ ʃ ʋ ɑː d̪
इतिहासकार	ɪ t̪ ɪ ɦ ɑː s k ɑː ɾ
गुफ़्तार	ɡ ʊ f t̪ ɑː ɾ
नमी	n ə m iː
रज़ाकार	ɾ ə z ɑː k ɑː ɾ
राब्ता	ɾ ɑː b t̪ ɑː
लघु	l ə ɡ ʱ uː
मल	m ə l
लिहाज़ा	l ɪ ɦ ɑː z ɑː
इश्तहार	ɪ ʃ t̪ ə ɦ ɑː ɾ
विविधता	ʋ ɪ ʋ ɪ d̪ ʱ t̪ ɑː
सौभाग्य	s ɔː b ʱ ɑː ɡ j
दीदार	d̪ iː d̪ ɑː ɾ
रस्सा	ɾ ə s s ɑː
प्राधिकार	p ɾ ɑː d̪ ʱ ɪ k ɑː ɾ
बवासीर	b ə ʋ ɑː s iː ɾ
उसमान	ʊ s m ɑː n
गलियारा	ɡ ə l iː j ɑː ɾ ɑː
अनेकानेक	ə n eː k ɑː n eː k
प्रक्रम	p ɾ ə k ɾ ə m
ललचाना	l ə l t͡ʃ ɑː n ɑː
भारतीय	b ʱ ɑː ɾ t̪ iː j
घाना	ɡ ʱ ɑː n ɑː
कांग्रेसी	k ɑː ŋ ɡ ɾ eː s iː
बात	b ɑː t̪
बटाटा	b ə ʈ ɑː ʈ ɑː
दाहिने	d̪ ɑː ɦ ɪ n eː
ठंडक	ʈʰ ə n ɖ ə k
समकालीन	s ə m k ɑː l iː n
अब्रू	ə b ɾ uː
शामियाना	ʃ ɑː m iː j ɑː n ɑː
अज़ीम	ə z iː m
मखीजा	m ə kʰ iː d͡ʒ ɑː
किरण	k ɪ ɾ ə n
अंतर्जाल	ə n t̪ ə ɾ d͡ʒ ɑː l
चुदाना	t ʃ ʊ d̪ aː n̪ aː
छिलका	t͡ʃʰ ɪ l k ɑː
आइसलैंड	ɑː ɪ s l ɛː n ɖ
प्लाविका	p l ɑː ʋ ɪ k ɑː
काम	k ɑː m
कोठारी	k oː ʈʰ ɑː ɾ iː
पकड़ना	p ə k ə ɽ n ɑː
आसन्न	ɑː s ə n n
टहलना	ʈ ɛː ʱ l n ɑː
जोर्जिया	d͡ʒ oː ɾ d͡ʒ iː j ɑː
निर्धनता	n ɪ ɾ d̪ ʱ ə n t̪ ɑː
गोमूत्र	ɡ oː m uː t̪ ɾ
पूरबी	p uː ɾ b iː
कपास	k ə p ɑː s
डाल	ɖ ɑː l
सक्सेना	s ə k s eː n ɑː
गड्ढा	ɡ ə ɖ ɖ ʱ ɑː
नदियों	n ə d̪ iː j õː
हाथ	ɦ ɑː t̪ʰ
छटा	t͡ʃʰ ə ʈ ɑː
अमचूर	ə m t͡ʃ uː ɾ
अनुप्रयुक्त	ə n ʊ p ɾ ə j ʊ k t̪
सार्थक	s ɑː ɾ t̪ʰ ə k
इग्लू	ɪ ɡ l uː
उँडेलना	ʊ̃ ɖ eː l n ɑː
अंग्रेज़ियत	ə ŋ ɡ ɾ eː z iː j ə t̪
हाँ	ɦ ɑ̃ː
अनुशासित	ə n ʊ ʃ ɑː s ɪ t̪
मुर्दन	m ʊ ɾ d̪ ə n
मशरूम	m ə ʃ ɾ uː m
खेल	kʰ eː l
आरोप	ɑː ɾ oː p
नीलगाय	n iː l ɡ ɑː j
उगलना	ʊ ɡ ə l n ɑː
हम	ɦ ə m
तन्दूरी	t̪ ə n d̪ uː ɾ iː
बमबारी	b ə m b ɑː ɾ iː
उमर	ʊ m ə ɾ
नल्ला	n ə l l ɑː
गुरू	ɡ ʊ ɾ uː
योकोहामा	j oː k oː ɦ ɑː m ɑː
अनशन	ə n ʃ ə n
किफ़ायती	k ɪ f ɑː j ə t̪ iː
लुचपन	l ʊ t͡ʃ p ə n
परदेशी	p ə ɾ d̪ eː ʃ iː
अंतर्देशीय	ə n t̪ ə ɾ d̪ eː ʃ iː j
दशम	d̪ ə ʃ ə m
घात	ɡ ʱ ɑː t̪
चेरापूंजी	t͡ʃ eː ɾ ɑː p uː ɲ d͡ʒ iː
आयुर्विज्ञान	ɑː j ʊ ɾ ʋ ɪ ɡ j ɑː n
नवशास्त्रीय	n ə ʋ ʃ ɑː s t̪ ɾ iː j
भेषज	b ʱ eː ʃ ə d͡ʒ
कलावंत	k ə l ɑː ʋ ə n t̪
जोंक	d͡ʒ oː ŋ k
उद्यमी	ʊ d̪ j ə m iː
बिचौलिया	b ɪ t͡ʃ ɔː l iː j ɑː
अरस्तू	ə ɾ ə s t̪ uː
औसतन	ɔː s t̪ ə n
रहीम	ɾ ə ɦ iː m
रहस्य	r ɛ ɦ ɛ s j
उलझन	ʊ l d͡ʒ ʱ ə n
निरंकुश	n ɪ ɾ ə ŋ k ʊ ʃ
बाँझ	b ɑ̃ː d͡ʒ ʱ
अवयव	ə ʋ j ə ʋ
सातवां	s ɑː t̪ ʋ ɑ̃ː
बल	b ə l
उम्दा	ʊ m d̪ ɑː
दीवान	d̪ iː ʋ ɑː n
सोशलिस्ट	s oː ʃ l ɪ s ʈ
श्रमण	ʃ ɾ ə m ə n
विजयादशमी	ʋ ɪ d͡ʒ j ɑː d̪ ə ʃ m iː
तीन	t̪ iː n
चिमनी	t͡ʃ ɪ m n iː
समिति	s ə m ɪ t̪ iː
वर्मा	ʋ ə ɾ m ɑː
दिनेश	d̪ ɪ n eː ʃ
मुलायम	m ʊ l ɑː j ə m
मिज़ोरम	m ɪ z oː ɾ ə m
अज़रबैजान	ə z ə ɾ b ɛː d͡ʒ ɑː n
झक्कड़	d͡ʒ ʱ ə k k ə ɽ
चालीसपद	t͡ʃ ɑː l iː s p ə d̪
गत्ता	ɡ ə t̪ t̪ ɑː
फ़ॉलोअर	f ɔː l oː ə ɾ
पायल	p ɑː j ə l
आघ	ɑː ɡ ʱ
कार्यभार	k ɑː ɾ j ə b ʱ ɑː ɾ
जलीय	d͡ʒ ə l iː j
उसे	ʊ s eː
संभालना	s ə m b ʱ ɑː l n ɑː
मनमाना	m ə n m ɑː n ɑː
तंबू	t̪ ə m b uː
दंगल	d̪ ə ŋ ɡ ə l
आसवन	ɑː s ə ʋ ə n
दीवाना	d̪ iː ʋ ɑː n ɑː
महावत	m ə ɦ ɑː ʋ ə t̪
अनचाहा	ə n t͡ʃ ɑː ɦ ɑː
लय	l ə j
मटक	m ə ʈ ə k
शिगात्से	ʃ ɪ ɡ ɑː t̪ s eː
दारुलहुकूमत	d̪ ɑː ɾ ʊ l ɦ ʊ k uː m ə t̪
गाड़ा	ɡ ɑː ɽ ɑː
पंछी	p ə ɲ t͡ʃʰ iː
शीर्ष	ʃ iː ɾ ʃ
दरबार	d̪ ə ɾ b ɑː ɾ
मगर	m ə ɡ ə ɾ
सियाही	s iː j ɑː ɦ iː
उसूल	ʊ s uː l
ऊद	uː d̪
काँस	k ɑ̃ː s
जमाना	d͡ʒ ə m ɑː n ɑː
अव्वल	ə ʋ ʋ ə l
लगना	l ə ɡ n ɑː
अड़ियल	ə ɽ iː j ə l
अराजकता	ə ɾ ɑː d͡ʒ ə k t̪ ɑː
गिरफ़्तार	ɡ ɪ ɾ ə f t̪ ɑː ɾ
पोलिश	p oː l ɪ ʃ
विकासशील	ʋ ɪ k ɑː s ʃ iː l
अंकन	ə ŋ k ə n
निषेचन	n ɪ ʃ eː t͡ʃ ə n
इसीलिए	ɪ s iː l ɪ eː
लेना	l eː n ɑː
गन्दा	ɡ ə n d̪ ɑː
केतली	k eː t̪ l iː
बघारना	b ə ɡ ʱ ɑː ɾ n ɑː
निष्क्रियता	n ɪ ʃ k ɾ iː j ə t̪ ɑː
कोख	k oː kʰ
ज़मानत	z ə m ɑː n ə t̪
वैंकूवर	ʋ ɛː ŋ k uː ʋ ə ɾ
दक्षिण	d̪ ə k ʃ ɪ n
मीम	m iː m
छात्रसंघ	t͡ʃʰ ɑː t̪ ɾ ə s ə ŋ ɡ ʱ
सौ	s ɔː
लेखन	l eː kʰ ə n
कोलाहल	k oː l ɑː ɦ ə l
चाह	t͡ʃ ɑː ʱ
दरवाज़ा	d̪ ə ɾ ʋ ɑː z ɑː
अर्दली	ə ɾ d̪ ə l iː
शुष्क	ʃ ʊ ʃ k
भेंट	b ʱ eː n ʈ
स्याही	s j ɑː ɦ iː
हंटर	ɦ ə n ʈ ə ɾ
सिंदूर	s ɪ n d̪ uː ɾ
बेशुमार	b eː ʃ ʊ m ɑː ɾ
दो	d̪ oː
उड़द	ʊ ɽ ə d̪
योग्यकार्ता	j oː ɡ j ə k ɑː ɾ t̪ ɑː
चमत्कारी	t͡ʃ ə m ə t̪ k ɑː ɾ iː
बताना	b ə t̪ ɑː n ɑː
विशेषकर	ʋ ɪ ʃ eː ʃ k ə ɾ
सूखना	s uː kʰ n ɑː
भूखा	b ʱ uː kʰ ɑː
अनमना	ə n m ə n ɑː
ईसा	iː s ɑː
गिरमिटिया	ɡ ɪ ɾ m ɪ ʈ iː j ɑː
कटोरा	k ə ʈ oː ɾ ɑː
भतीजा	b ʱ ə t̪ iː d͡ʒ ɑː
भारत	b ʱ ɑː ɾ ə t̪
झरना	d͡ʒ ʱ ə ɾ n ɑː
उन्माद	ʊ n̪ m aː d̪
ठिंगना	ʈʰ ɪ ŋ ɡ n ɑː
इसरार	ɪ s ɾ ɑː ɾ
नीतिगत	n iː t̪ ɪ ɡ ə t̪
मुहर	m ʊ ɦ ə ɾ
चाप	t͡ʃ ɑː p
इस्लाम	ɪ s l ɑː m
भ्रम	b ʱ ɾ ə m
बाँध	b ɑ̃ː d̪ ʱ
सेंकना	s eː ŋ k n ɑː
टांगना	ʈ ɑː ŋ ɡ n ɑː
विश्लेषण	ʋ ɪ ʃ l eː ʃ ə n
जनाब	d͡ʒ ə n ɑː b
हंगामा	ɦ ə ŋ ɡ ɑː m ɑː
समृद्धिकरण	s ə m ɾ ɪ d̪ d̪ ʱ ɪ k ə ɾ ə n
ककड़ी	k ə k ɽ iː
पूर्ण	p uː ɾ n
गर्भाशय	ɡ ə ɾ b ʱ ɑː ʃ ə j
अलगाना	ə l ɡ ɑː n ɑː
विलास	ʋ ɪ l ɑː s
दिगंबर	d̪ ɪ ɡ ə m b ə ɾ
कीर्तन	k iː ɾ t̪ ə n
ताजिकिस्तान	t̪ ɑː d͡ʒ ɪ k ɪ s t̪ ɑː n
खेती	kʰ eː t̪ iː
उलफ़त	ʊ l f ə t̪
पाकपत्तन	p ɑː k p ə t̪ t̪ ə n
न्याय	n j ɑː j
अविवाहित	ə ʋ ɪ ʋ ɑː ɦ ɪ t̪
पाबंद	p ɑː b ə n d̪
अंबर	ə m b ə ɾ
फुलका	pʰ ʊ l k ɑː
लोकाट	l oː k ɑː ʈ
लोकनृत्य	l oː k n ɾ ɪ t̪ j
उद्योग	ʊ d̪ j oː ɡ
सट्टा	s ə ʈ ʈ ɑː
इत्यादि	ɪ t̪ j ɑː d̪ iː
त्रिमूर्ति	t̪ ɾ ɪ m uː ɾ t̪ iː
एकांत	eː k ɑː n t̪
शोषण	ʃ oː ʃ ə n
बहुत	b ə h ʊ t̪
नेकटाई	n eː k ʈ ɑː iː
लैंडर	l ɛː n ɖ ə ɾ
तराई	t̪ ə ɾ ɑː iː
स्वर्गवासी	s ʋ ə ɾ ɡ ʋ ɑː s iː
कार्यकुशल	k ɑː ɾ j ə k ʊ ʃ ə l
रखवाला	ɾ ə kʰ ʋ ɑː l ɑː
आदर्श	ɑː d̪ ə ɾ ʃ
सुलह	s ʊ l ə ʱ
निराशा	n ɪ ɾ ɑː ʃ ɑː
ज़ंजीर	z ə ɲ d͡ʒ iː ɾ
मुन्ना	m ʊ n n ɑː
पौन	p ɔː n
जाना	d͡ʒ ɑː n ɑː
समर्थन	s ə m ə ɾ t̪ʰ ə n
ओष्ठ्य	oː ʃ ʈʰ j ə
पेंशन	p eː n ʃ ə n
पुलिसकर्मी	p ʊ l ɪ s k ə ɾ m iː
महाराष्ट्र	m ə ɦ ɑː ɾ ɑː ʃ ʈ ɾ
प्रासुक	p ɾ ɑː s ʊ k
अलबत्ता	ə l b ə t̪ t̪ ɑː
निज़ाम	n ɪ z ɑː m
लिख्टेंश्टाइन	l ɪ kʰ ʈ eː n ʃ ʈ ɑː ɪ n
सरूर	s ə ɾ uː ɾ
स्लोवाकिया	s l oː ʋ ɑː k iː j ɑː
एकाधिकार	eː k ɑː d̪ ʱ ɪ k ɑː ɾ
अंगिया	ə ŋ ɡ iː j ɑː
माखन	m ɑː kʰ ə n
महंगा	m ɛː ʱ ŋ ɡ ɑː
पूर्वाग्रह	p uː ɾ ʋ ɑː ɡ ɾ ə ʱ
बतौर	b ə t̪ ɔː ɾ
पाषाण	p ɑː ʃ ɑː n
अमानती	ə m ɑː n ə t̪ iː
सजावट	s ə d͡ʒ ɑː ʋ ə ʈ
अंतरजाल	ə n t̪ ə ɾ d͡ʒ ɑː l
गणितज्ञ	ɡ ə n ɪ t̪ ə ɡ j
डेढ़	ɖ eː ɽ ʱ
उपयोग	ʊ p j oː ɡ
बंदरिया	b ə n d̪ ə ɾ iː j ɑː
डंठल	ɖ ə n ʈʰ ə l
नीलाम	n iː l ɑː m
चट्टान	t͡ʃ ə ʈ ʈ ɑː n
मोहलत	m oː ʱ l ə t̪
आर्मीनिया	ɑː ɾ m iː n iː j ɑː
चंद्र	t͡ʃ ə n d̪ ɾ
जलजमाव	d͡ʒ ə l d͡ʒ ə m ɑː ʋ
चौदह	t͡ʃ ɔː d̪ ə ʱ
अंगोट	ə ŋ ɡ oː ʈ
मानदेय	m ɑː n d̪ eː j
व्याख्या	ʋ j ɑː kʰ j ɑː
शाइस्ता	ʃ ɑː ɪ s t̪ ɑː
पुरोहित	p ʊ ɾ oː ɦ ɪ t̪
इसका	ɪ s k ɑː
जेल	d͡ʒ eː l
बर्तन	b ə ɾ t̪ ə n
नेपाल	n eː p ɑː l
आकांक्षी	ɑː k ɑː ŋ k ʃ iː
उपनगर	ʊ p n ə ɡ ə ɾ
खीसा	kʰ iː s ɑː
रक्षण	ɾ ə k ʃ ə n
पाठक	p ɑː ʈʰ ə k
बूढ़ा	b uː ɽ ʱ ɑː
उत्पल	ʊ t̪ p ə l
गुप्तांग	ɡ ʊ p t̪ ɑː ŋ ɡ
कलसा	k ə l s ɑː
जौहर	d͡ʒ ɔː ɦ ə ɾ
सुंदर	s ʊ n d̪ ə ɾ
गूंजना	ɡ uː ɲ d͡ʒ n ɑː
अपुष्ट	ə p ʊ ʃ ʈ
चक्रव्यूह	t͡ʃ ə k ɾ ə ʋ j uː ʱ
जुर्रत	d͡ʒ ʊ ɾ ɾ ə t̪
असहिष्णुता	ə s ə ɦ ɪ ʃ n ʊ t̪ ɑː
मज़ा	m ə z ɑː
तरफ़	t̪ ə ɾ ə f
खाना	kʰ ɑː n ɑː
घोराही	ɡ ʱ oː ɾ ɑː ɦ iː
प्रशासक	p ɾ ə ʃ ɑː s ə k
ब्याह	b j ɑː ʱ
नेवला	n eː ʋ l ɑː
ससुर	s ə s ʊ ɾ
अग्रवाल	ə ɡ ɾ ʋ ɑː l
देश	d̪ eː ʃ
ज्ञ	ɡ j ə
विद्युन्मय	ʋ ɪ d̪ j ʊ n m ə j
चयन	t͡ʃ ə j ə n
डसना	ɖ ə s n ɑː
सेवानिवृत्ति	s eː ʋ ɑː n ɪ ʋ ɾ ɪ t̪ t̪ iː
ऊंचा	ũ t͡ʃ a
दालचीनी	d̪ ɑː l t͡ʃ iː n iː
हल्ला	ɦ ə l l ɑː
झुठलाना	d͡ʒ ʱ ʊ ʈʰ l ɑː n ɑː
साम्राज्यवाद	s ɑː m ɾ ɑː d͡ʒ j ə ʋ ɑː d̪
ध्रुवीकरण	d̪ ʱ ɾ ʊ ʋ iː k ɾ ə n
चुंबकत्व	t͡ʃ ʊ m b k ə t̪ ʋ
तलवा	t̪ ə l ʋ ɑː
सुडौल	s ʊ ɖ ɔː l
घाटी	ɡ ʱ ɑː ʈ iː
झूठा	d ʒ ʱ uː ʈʰ aː
गोलगप्पा	ɡ oː l ɡ ə p p ɑː
प्रतिरूप	p ɾ ə t̪ ɪ ɾ uː p
अंतर्जातीय	ə n t̪ ə ɾ d͡ʒ ɑː t̪ iː j
ऋणाग्र	ɾ ɪ n ɑː ɡ ɾ
बकवास	b ə k ʋ ɑː s
उलझना	ʊ l ə d͡ʒ ʱ n ɑː
सुस्ताना	s ʊ s t̪ ɑː n ɑː
ननद	n ə n ə d̪
कपिलवस्तु	k ə p ɪ l ʋ ə s t̪ uː
अंतरंगता	ə n t̪ ə ɾ ə ŋ ɡ t̪ ɑː
गर्भवती	ɡ ə ɾ b ʱ ʋ ə t̪ iː
तनहाई	t̪ ə n ɦ ɑː iː
हिरासत	ɦ ɪ ɾ ɑː s ə t̪
लड़खड़ाना	l ə ɽ kʰ ə ɽ ɑː n ɑː
वादसभा	ʋ aː d̪ s ə b ʱ aː
शुभकामना	ʃ ʊ b ʱ k ɑː m n ɑː
बाण	b ɑː n
सूजी	s uː d͡ʒ iː
पोथी	p oː t̪ʰ iː
लालफ़ीताशाही	l ɑː l f iː t̪ ɑː ʃ ɑː ɦ iː
भय	b ʱ ɛː
इमोशन	ɪ m oː ʃ ə n
लेखाचित्र	l eː kʰ ɑː t͡ʃ ɪ t̪ ɾ
कल्पनादर्श	k ə l p ə n ɑː d̪ ə ɾ ʃ
सत्तानवे	s ə t̪ t̪ ɑː n ʋ eː
पथरीला	p ə t̪ʰ ɾ iː l ɑː
चूहा	t͡ʃ uː ɦ ɑː
प्रयास	p ɾ ə j ɑː s
चाकलेट	t͡ʃ ɑː k l eː ʈ
लोगो	l oː ɡ oː
रसोई	ɾ ə s oː iː
जारक	d͡ʒ ɑː ɾ ə k
खीरा	kʰ iː ɾ ɑː
मछुआ	m ə t͡ʃʰ ʊ ɑː
दौड़ाना	d̪ ɔː ɽ ɑː n ɑː
तिलहन	t̪ ɪ l ɦ ə n
बुलंदशहर	b ʊ l ə n d̪ ʃ ɛː ʱ ɾ
प्याज़	p j ɑː z
नगाड़ा	n ə ɡ ɑː ɽ ɑː
मत्त	m ə t̪ t̪
फ़तवा	f ə t̪ ʋ ɑː
मेलबॉर्न	m eː l b ɔː ɾ n
भरोसा	b ʱ ə ɾ oː s ɑː
ट्रक	ʈ ɾ ə k
लालफ़ीता	l ɑː l f iː t̪ ɑː
खड़िया	kʰ ə ɽ iː j ɑː
संक्षिप्त	s ə ŋ k ʃ ɪ p t̪
गांडू	ɡ ɑː n ɖ uː
उकसाना	ʊ k s ɑː n ɑː
शराब	ʃ ə ɾ ɑː b
सहसंयोजक	s ə ʱ s ə̃ j oː d͡ʒ ə k
मुख्य	m ʊ kʰ j ə
दफ़ा	d̪ ə f ɑː
कथा	k ə t̪ʰ ɑː
अभिभावक	ə b ʱ ɪ b ʱ ɑː ʋ ə k
तिब्बत	t̪ ɪ b b ə t̪
मच्छ	m ə t͡ʃ t͡ʃʰ
कारगर	k ɑː ɾ ɡ ə ɾ
जज़ा	d͡ʒ ə z ɑː
चिपकना	t͡ʃ ɪ p ə k n ɑː
मांस	m ɑː n s
सुलझाना	s ʊ l d͡ʒ ʱ ɑː n ɑː
कीकर	k iː k ə ɾ
यौम	j ɔː m
आवेश	ɑː ʋ eː ʃ
मास्को	m ɑː s k oː
अभियोक्ता	ə b ʱ iː j oː k t̪ ɑː
दर	d̪ ə ɾ
दलील	d̪ ə l iː l
हरियाली	ɦ ə ɾ iː j ɑː l iː
दुरुपयोग	d̪ ʊ ɾ ʊ p j oː ɡ
कलन	k ə l ə n
बतलाना	b ə t̪ l ɑː n ɑː
था	t̪ʰ ɑː
तेलुगू	t̪ eː l ʊ ɡ uː
गिनती	ɡ ɪ n t̪ iː
अफ़सर	ə f s ə ɾ
कॉफ़ी	k ɔː f iː
अनुमानतः	ə n ʊ m ɑː n t̪ əʰ
बजना	b ə d͡ʒ n ɑː
प्रतिरोधकता	p ɾ ə t̪ ɪ ɾ oː d̪ ʱ ə k t̪ ɑː
पौरोहित्य	p ɔː ɾ oː ɦ ɪ t̪ j
समाज	s ə m ɑː d͡ʒ
चील	t͡ʃ iː l
नवंबर	n ə ʋ ə m b ə ɾ
अज़ीज़	ə z iː z
कढ़ाई	k ə ɽ ʱ ɑː iː
प्रतिलोम	p ɾ ə t̪ ɪ l oː m
अल्फ़ाज़	ə l f ɑː z
महापौर	m ə ɦ ɑː p ɔː ɾ
मटकाना	m ə ʈ k ɑː n ɑː
राजकोट	ɾ ɑː d͡ʒ k oː ʈ
बाट	b ɑː ʈ
बड़े	b ə ɽ eː
अरुचि	ə ɾ ʊ t͡ʃ iː
थपथपाना	t̪ʰ ə p ə t̪ʰ p ɑː n ɑː
विस्फोट	ʋ ɪ s pʰ oː ʈ
अष्टकोण	ə ʃ ʈ k oː n
उमड़ना	ʊ m ə ɽ n ɑː
चित्रकारी	t͡ʃ ɪ t̪ ɾ ə k ɑː ɾ iː
भग	b ʱ ə ɡ
फ़िरंगी	f ɪ ɾ ə ŋ ɡ iː
रजोदर्शन	ɾ ə d͡ʒ oː d̪ ə ɾ ʃ ə n
प्रॉसिक्यूटर	p ɾ ɔː s ɪ k j uː ʈ ə ɾ
संवेदना	s ə̃ m ʋ eː d̪ n̪ aː
पूरी	p uː ɾ iː
वित्तीय	ʋ ɪ t̪ t̪ iː j
स्थल	s t̪ʰ ə l
दिल्ली	d̪ ɪ l l iː
बदहज़मी	b ə d̪ ʱ ə z m iː
काना	k ɑː n ɑː
परदेश	p ə ɾ d̪ eː ʃ
जादूगरनी	d͡ʒ ɑː d̪ uː ɡ ə ɾ n iː
प्रेस	p ɾ eː s
अंतर्राष्ट्रीय	ə n t̪ ə ɾ ɾ ɑː ʃ ʈ ɾ iː j
पठानकोट	p ə ʈʰ ɑː n k oː ʈ
ऐच्छिक	ɛː t͡ʃ t͡ʃʰ ɪ k
रावलपिंडी	ɾ ɑː ʋ ə l p ɪ n ɖ iː
परित्यक्त	p ə ɾ ɪ t̪ j ə k t̪
मनुज	m ə n ʊ d͡ʒ
कमान	k ə m ɑː n
लातीनी	l ɑː t̪ iː n iː
किराया	k ɪ ɾ ɑː j ɑː
मर्दुमशुमारी	m ə ɾ d̪ ʊ m ʃ ʊ m ɑː ɾ iː
हंगरी	ɦ ə ŋ ɡ ɾ iː
नमश्कार	n ə m ə ʃ k ɑː ɾ
वेबसाइट	ʋ eː b s ɑː ɪ ʈ
गिराना	ɡ ɪ ɾ ɑː n ɑː
शासक	ʃ ɑː s ə k
अल्पसंख्यक	ə l p s ə ŋ kʰ j ə k
जाला	d͡ʒ ɑː l ɑː
भक्ति	b ʱ ə k t̪ iː
मालदीव	m ɑː l d̪ iː ʋ
सक्षम	s ə k ʃ ə m
गिरफ़्तारी	ɡ ɪ ɾ ə f t̪ ɑː ɾ iː
प्रतिच्छेद	p ɾ ə t̪ ɪ t͡ʃ t͡ʃʰ eː d̪
रोध	ɾ oː d̪ ʱ
अंगुल	ə ŋ ɡ ʊ l
कोपचा	k oː p t͡ʃ ɑː
जातिगत	d͡ʒ ɑː t̪ ɪ ɡ ə t̪
अभ्यस्त	ə b ʱ j ə s t̪
सावधानी	s ɑː ʋ d̪ ʱ ɑː n iː
पत्थरबाज़ी	p ə t̪ t̪ʰ ə ɾ b ɑː z iː
दोहा	d̪ oː ɦ ɑː
दरार	d̪ ə ɾ ɑː ɾ
क्या	k j ɑː
अचानक	ə t͡ʃ ɑː n ə k
केरल	k eː ɾ ə l
रिज़ल्ट	ɾ ɪ z ə l ʈ
सलामत	s ə l ɑː m ə t̪
पंखावाला	p ə ŋ kʰ ɑː ʋ ɑː l ɑː
थमना	t̪ʰ ə m n ɑː
रिपोर्टर	ɾ ɪ p oː ɾ ʈ ə ɾ
रंगकर्मी	ɾ ə ŋ ɡ k ə ɾ m iː
जुमला	d͡ʒ ʊ m l ɑː
फ़ुर्सत	f ʊ ɾ s ə t̪
चुपड़ना	t͡ʃ ʊ p ə ɽ n ɑː
जय	d͡ʒ ə j
ठूँसना	ʈʰ ũː s n ɑː
अगिन	ə ɡ ɪ n
समीक्षा	s ə m iː k ʃ ɑː
मायूसी	m ɑː j uː s iː
वली	ʋ ə l iː
हिजड़ा	ɦ ɪ d͡ʒ ɽ ɑː
सशस्त्र	s ə ʃ ə s t̪ ɾ
रान	ɾ ɑː n
खुलकर	kʰ ʊ l k ə ɾ
वाद्य	ʋ ɑː d̪ j
ब्रह्म	b ɾ ə ʱ m
दबोचना	d̪ ə b oː t͡ʃ n ɑː
प्राप्त	p ɾ ɑː p t̪
मूसल	m uː s ə l
कुसुम	k ʊ s ʊ m
कोहराम	k oː ʱ ɾ ɑː m
अबिवात्त	ə b ɪ ʋ ɑː t̪ t̪
सवा	s ə ʋ ɑː
ग्लासगो	ɡ l ɑː s ɡ oː
ईद	iː d̪
आसामी	ɑː s ɑː m iː
इमोजी	ɪ m oː d͡ʒ iː
बीबी	b iː b iː
मोक्ष	m oː k ʃ ə
ओढ़ना	oː ɽ ʱ n ɑː
बेजान	b eː d͡ʒ ɑː n
माह	m ɑː ʱ
गंदगी	ɡ ə n d̪ ə ɡ iː
वायुमंडलीय	ʋ ɑː j ʊ m ə n ɖ l iː j
हिजरी	ɦ ɪ d͡ʒ ɾ iː
वफ़ा	ʋ ə f ɑː
दाताओ	d̪ ɑː t̪ ɑː oː
समाधि	s ə m ɑː d̪ ʱ iː
ठुमक	ʈʰ ʊ m ə k
सोची	s oː t͡ʃ iː
तेंदुआ	t̪ eː n d̪ ʊ ɑː
मुर्दा	m ʊ ɾ d̪ ɑː
वेटिकन	ʋ eː ʈ ɪ k ə n
भजन	b ʱ ə d͡ʒ ə n
रसूल	ɾ ə s uː l
सुन्दर	s ʊ n d̪ ə ɾ
खूब	kʰ uː b
ऐसी	ɛː s iː
गंध	ɡ ə n d̪ ʱ
हुक्म	ɦ ʊ k m
झा	d͡ʒ ʱ ɑː
कोटा	k oː ʈ ɑː
अधिभार	ə d̪ ʱ ɪ b ʱ ɑː ɾ
केन्या	k eː n j ɑː
पूर्णांक	p uː ɾ n ɑː ŋ k
जलाल	d͡ʒ ə l ɑː l
दूर	d̪ uː ɾ
तंदुरुस्ती	t̪ ə n d̪ ʊ ɾ ʊ s t̪ iː
तिक्की	t̪ ɪ k k iː
रईस	ɾ ə iː s
मक्खन	m ə k kʰ ə n
स्थूल	s t̪ʰ uː l
सुर	s ʊ ɾ
चलाना	t͡ʃ ə l ɑː n ɑː
अपकीर्ति	ə p k iː ɾ t̪ iː
अनूठा	ə n uː ʈʰ ɑː
नस्लभेद	n ə s l b ʱ eː d̪
गोरू	ɡ oː ɾ uː
हुड़दंगबाज़	ɦ ʊ ɽ d̪ ə ŋ ɡ b ɑː z
साक्षर	s ɑː k ʃ ə ɾ
दराज़	d̪ ə ɾ ɑː z
शोषित	ʃ oː ʃ ɪ t̪
मनश्चिकित्सक	m ə n ə ʃ t͡ʃ ɪ k ɪ t̪ s ə k
केंद्र	k eː n d̪ ɾ
मौखिक	m ɔː kʰ ɪ k
इलाही	ɪ l ɑː ɦ iː
करारा	k ə ɾ ɑː ɾ ɑː
नवाबशाह	n ə ʋ ɑː b ʃ ɑː ʱ
अजी	ə d͡ʒ iː
सहायक	s ə ɦ ɑː j ə k
तेरा	t̪ eː ɾ ɑː
कगार	k ə ɡ ɑː ɾ
शोहरत	ʃ oː ʱ ɾ ə t̪
बदन	b ə d̪ ə n
नाता	n ɑː t̪ ɑː
गुदा	ɡ ʊ d̪ ɑː
सितम	s ɪ t̪ ə m
अर्धशिक्षित	ə ɾ d̪ ʱ ʃ ɪ k ʃ ɪ t̪
असहाय	ə s ɦ ɑː j
आज़ाद	ɑː z ɑː d̪
चायदानी	t͡ʃ ɑː j d̪ ɑː n iː
हिन्दी	ɦ ɪ n d̪ iː
गरिमा	ɡ ə ɾ ɪ m ɑː
दुर्गंध	d̪ ʊ ɾ ɡ ə n d̪ ʱ
आज्ञा	ɑː ɡ j ɑː
लेबनॉन	l eː b n ɔː n
सचिव	s ə t͡ʃ ɪ ʋ
आश्वासन	ɑː ʃ ʋ ɑː s ə n
कसरत	k ə s ɾ ə t̪
अयस्क	ə j ə s k
बीजांडासन	b iː d͡ʒ ɑː n ɖ ɑː s ə n
रवानी	ɾ ə ʋ ɑː n iː
छत्तीसगढ़	t͡ʃʰ ə t̪ t̪ iː s ɡ ə ɽ ʱ
ज्ञानकोष	ɡ j ɑː n k oː ʃ
प्रचार	p ɾ ə t͡ʃ ɑː ɾ
चिंता	t͡ʃ ɪ n t̪ ɑː
नेतृत्व	n eː t̪ ɾ ɪ t̪ ʋ
मांग	m ɑː ŋ ɡ
माले	m ɑː l eː
सवाना	s ə ʋ ɑː n ɑː
तिरस्कार	t̪ ɪ ɾ ə s k ɑː ɾ
ऊपर	uː p ə ɾ
मिसेज़	m ɪ s eː z
कंगन	k ə ŋ ɡ ə n
अटारी	ə ʈ ɑː ɾ iː
मुजाहिदीन	m ʊ d͡ʒ ɑː ɦ ɪ d̪ iː n
निरभिमान	n ɪ ɾ ə b ʱ ɪ m ɑː n
स्त्री	s t̪ ɾ iː
पंडाल	p ə n ɖ ɑː l
अगुआ	ə ɡ ʊ ɑː
प्रदेश	p ɾ ə d̪ eː ʃ
परवानगी	p ə ɾ ʋ ɑː n ɡ iː
सेवक	s eː ʋ ə k
कथ्य	k ə t̪ʰ j
अभिवादन	ə b ʱ ɪ ʋ ɑː d̪ ə n
नागपुर	n ɑː ɡ p ʊ ɾ
सिचुआन	s ɪ t͡ʃ ʊ ɑː n
मधुशाला	m ə d̪ ʱ ʊ ʃ ɑː l ɑː
फ़रेब	f ə ɾ eː b
मनोरंजन	m ə n oː ɾ ə ɲ d͡ʒ ə n
मुस्कुराना	m ʊ s k ʊ ɾ ɑː n ɑː
बरकत	b ə ɾ k ə t̪
दाता	d̪ ɑː t̪ ɑː
भूमिपुत्र	b ʱ uː m ɪ p ʊ t̪ ɾ
विलासिता	ʋ ɪ l ɑː s ɪ t̪ ɑː
पलान्डु	p ə l ɑː n ɖ uː
कृति	k ɽ ɪ t̪ iː
बारी	b ɑː ɾ iː
कुल्चा	k ʊ l t͡ʃ ɑː
सराय	s ə ɾ ɑː j
गणेश	ɡ ə ɳ e ʃ
दीपिका	d̪ iː p ɪ k ɑː
चीनी	t͡ʃ iː n iː
दिरम	d̪ ɪ ɾ ə m
कठमुल्ला	k ə ʈʰ m ʊ l l ɑː
भूविज्ञान	b ʱ uː ʋ ɪ ɡ j ɑː n
पुराना	p ʊ ɾ ɑː n ɑː
बंबा	b ə m b ɑː
उद्योगपति	ʊ d̪ j oː ɡ p ə t̪ iː
हरिस	ɦ ə ɾ ɪ s
संध्या	s ə n d̪ ʱ j ɑː
चमक	t͡ʃ ə m ə k
बेबुनियाद	b eː b ʊ n iː j ɑː d̪
भ्राता	b ʱ ɾ ɑː t̪ ɑː
लमहा	l ə m ɦ ɑː
कुल्ला	k ʊ l l ɑː
तेजपत्ता	t̪ eː d͡ʒ p ə t̪ t̪ ɑː
मुझ	m ʊ d͡ʒ ʱ
छल	t͡ʃʰ ə l
आरामदेह	ɑː ɾ ɑː m d̪ eː ʱ
दीनार	d̪ iː n ɑː ɾ
चाची	t͡ʃ ɑː t͡ʃ iː
कक्षा	k ə k ʃ ɑː
अभ्यासवश	ə b ʱ j ɑː s ʋ ə ʃ
तकलीफ़देह	t̪ ə k l iː f d̪ eː ʱ
व्यष्टि	ʋ j ə ʃ ʈ iː
विखंडन	ʋ ɪ kʰ ə n ɖ ə n
शीघ्रता	ʃ iː ɡ ʱ ɾ ə t̪ ɑː
नारीवाद	n ɑː ɾ iː ʋ ɑː d̪
निचला	n ɪ t͡ʃ l ɑː
होशियार	ɦ oː ʃ iː j ɑː ɾ
म्यान	m j ɑː n
बमवर्षक	b ə m ʋ ə ɾ ʃ ə k
धज्जी	d̪ ʱ ə d͡ʒ d͡ʒ iː
नारा	n ɑː ɾ ɑː
सत्रह	s ə t̪ ɾ ə ʱ
झाग	d͡ʒ ʱ ɑː ɡ
चाचा	t͡ʃ ɑː t͡ʃ ɑː
अनिवार्यतः	ə n ɪ ʋ ɑː ɾ j ə t̪ əʰ
साधन	s ɑː d̪ ʱ ə n
संज्ञा	s ə ɲ ɡ j ɑː
मरहबा	m ə ɾ ɦ ə b ɑː
रूमाल	ɾ uː m ɑː l
बाजी	b ɑː d͡ʒ iː
सज़ा	s ə z ɑː
इंद्रिय	ɪ n d̪ ɾ ɪ j
वीरान	ʋ iː ɾ ɑː n
नर्तकी	n ə ɾ t̪ ə k iː
उत्तराधिकारी	ʊ t̪ t̪ ə ɾ ɑː d̪ ʱ ɪ k ɑː ɾ iː
आत्मघाती	ɑː t̪ m ə ɡ ʱ ɑː t̪ iː
आनन	ɑː n ə n
आफ़त	ɑː f ə t̪
जज	d͡ʒ ə d͡ʒ
पंगु	p ə ŋ ɡ uː
मोरनी	m oː ɾ n iː
पुण्य	p ʊ n j
बरमा	b ə ɾ m ɑː
ललाट	l ə l ɑː ʈ
मंत्र	m ə n t̪ ɾ
ढकना	ɖ ʱ ə k n ɑː
अग्रिम	ə ɡ ɾ ɪ m
आग्नेय	ɑː ɡ n eː j
भटकना	b ʱ ə ʈ ə k n ɑː
तिरुवनंतपुरम	t̪ ɪ ɾ ʊ ʋ ə n ə n t̪ ə p ʊ ɾ ə m
पुल	p ʊ l
सुचारु	s ʊ t͡ʃ ɑː ɾ uː
पर	p ə ɾ
अभिगम	ə b ʱ ɪ ɡ ə m
लौंग	l ɔː ŋ ɡ
ज्ञानवर्धन	ɡ j ɑː n ʋ ə ɾ d̪ ʱ ə n
समझौता	s ə m d͡ʒ ʱ ɔː t̪ ɑː
उच्चायुक्त	ʊ t͡ʃ t͡ʃ ɑː j ʊ k t̪
भगवान	b ʱ ə ɡ ʋ ɑː n
बूझना	b uː d͡ʒ ʱ n ɑː
मह्ल	m ə ʱ l
भूमिगत	b ʱ uː m ɪ ɡ ə t̪
भात	b ʱ ɑː t̪
सत्तावन	s ə t̪ t̪ ɑː ʋ ə n
समाधान	s ə m ɑː d̪ ʱ ɑː n
नाशपाती	n ɑː ʃ p ɑː t̪ iː
रमणीय	ɾ ə m ɳ iː j ə
पारी	p ɑː ɾ iː
संपदा	s ə m p ə d̪ ɑː
पाउंड	p ɑː ʊ n ɖ
इतिहास	ɪ t̪ ɪ ɦ ɑː s
हलफ़नामा	ɦ ə l ə f n ɑː m ɑː
हिया	ɦ iː j ɑː
गाँधीनगर	ɡ ɑ̃ː d̪ ʱ iː n ə ɡ ə ɾ
गली	ɡ ə l iː
सैद्धांतिक	s ɛː d̪ d̪ ʱ ɑː n t̪ ɪ k
तैंतालीस	t̪ ɛː n t̪ ɑː l iː s
संरचना	s ə n ɾ ə t͡ʃ n ɑː
सिद्धांत	s ɪ d̪ d̪ ʱ ɑː n t̪
आधिक	ɑː d̪ ʱ ɪ k
कालापन	k ɑː l ɑː p ə n
अरवी	ə ɾ ʋ iː
पत्तीदार	p ə t̪ t̪ iː d̪ ɑː ɾ
युद्धस्थल	j ʊ d̪ d̪ ʱ s t̪ʰ ə l
मालागासी	m ɑː l ɑː ɡ ɑː s iː
प्रभुत्व	p ɾ ə b ʱ ʊ t̪ ʋ
शाबाश	ʃ ɑː b ɑː ʃ
बित्ता	b ɪ t̪ t̪ ɑː
कँगनी	k ə̃ ɡ n iː
ऐतराज़	ɛː t̪ ɾ ɑː z
बदौलत	b ə d̪ ɔː l ə t̪
पालतू	p ɑː l t̪ uː
हाइड्रोजन	ɦ ɑː ɪ ɖ ɾ oː d͡ʒ ə n
धर्मभूमि	d̪ ʱ ə ɾ m b ʱ uː m iː
मानवाधिकार	m ɑː n ə ʋ ɑː d̪ ʱ ɪ k ɑː ɾ
तोहफ़ा	t̪ oː ʱ f ɑː
प्रतिफल	p ɾ ə t̪ ɪ pʰ ə l
लौ	l ɔː
पूरा	p uː ɾ ɑː
ठुकराना	ʈʰ ʊ k ɾ ɑː n ɑː
हमारा	ɦ ə m ɑː ɾ ɑː
ओलिंपियाड	oː l ɪ m p iː j ɑː ɖ
टेक	ʈ eː k
दिनभर	d̪ ɪ n b ʱ ə ɾ
छिपाना	t͡ʃʰ ɪ p ɑː n ɑː
जानवर	d͡ʒ ɑː n ʋ ə ɾ
शहंशाह	ʃ ɛː ʱ n ʃ ɑː ʱ
कैंब्रिज	k ɛː m b ɾ ɪ d͡ʒ
चिथड़ा	t͡ʃ ɪ t̪ʰ ɽ ɑː
कैथी	k ɛː t̪ʰ iː
आक्रमणकारी	ɑː k ɾ ə m ə n k ɑː ɾ iː
हिंदी	ɦ ɪ n d̪ iː
कंपन	k ə m p ə n
बोध	b oː d̪ ʱ
क्षारीय	k ʃ ɑː ɾ iː j
निकलवाना	n ɪ k ə l ʋ ɑː n ɑː
चाशनी	t ʃ ɑː ʃ n iː
इक्यानवे	ɪ k j ɑː n ʋ eː
साझा	s ɑː d͡ʒ ʱ ɑː
सिलवट	s ɪ l ʋ ə ʈ
ठंड	ʈʰ ə n ɖ
अभ्यास	ə b ʱ j ɑː s
ज्वालामुखी	d ʒ ʋ aː l aː m ʊ kʰ iː
तस्वीर	t̪ ə s ʋ iː ɾ
पन्ना	p ə n n ɑː
गुलदस्ता	ɡ ʊ l d̪ ə s t̪ ɑː
वेलिंग्टन	ʋ eː l ɪ ŋ ɡ ʈ ə n
हमला	ɦ ə m l ɑː
डूंगर	ɖ uː ŋ ɡ ə ɾ
इलज़ाम	ɪ l z ɑː m
पगली	p ə ɡ l iː
आलु	ɑː l uː
नीति	n iː t̪ iː
लड्डू	l ə ɖ ɖ uː
साड़ी	s ɑː ɽ iː
मीर	m iː ɾ
जुनून	d͡ʒ ʊ n uː n
चमड़ी	t͡ʃ ə m ɽ iː
इंजन	ɪ ɲ d͡ʒ ə n
बचत	b ə t͡ʃ ə t̪
मलहम	m ə l ɦ ə m
प्राक्कथन	p ɾ ɑː k k ə t̪ʰ ə n
ने	n eː
कोरा	k oː ɾ ɑː
स्वच्छ	s ʋ ə t͡ʃ t͡ʃʰ
रंजिश	ɾ ə ɲ d͡ʒ ɪ ʃ
अप्रकट	ə p ɾ ə k ə ʈ
ओझा	oː d͡ʒ ʱ ɑː
अंकुश	ə ŋ k ʊ ʃ
बहाव	b ə ɦ ɑː ʋ
हूबहू	ɦ uː b ə ɦ uː
उज़्बेकिस्तान	ʊ z b eː k ɪ s t̪ ɑː n
बहरा	b ɛː ʱ ɾ ɑː
कोसना	k oː s n ɑː
उदास	ʊ d̪ ɑː s
ज़नाना	z ə n ɑː n ɑː
उधड़ना	ʊ d̪ ʱ ə ɽ n ɑː
संसार	s ə n s ɑː ɾ
आसरा	ɑː s ɾ ɑː
हल	ɦ ə l
खिसकना	kʰ ɪ s ə k n ɑː
बुद्ध	b ʊ d̪ d̪ ʱ
दीया	d̪ iː j ɑː
प्रजातंत्रवाद	p ɾ ə d͡ʒ ɑː t̪ ə n t̪ ɾ ə ʋ ɑː d̪
वातानुकूलित	ʋ ɑː t̪ ɑː n ʊ k uː l ɪ t̪
स्वाहिली	s ʋ ɑː ɦ ɪ l iː
रोज़गार	ɾ oː z ɡ ɑ ɾ
नोनी	n oː n iː
मसनद	m ə s n ə d̪
तन	t̪ ə n
तेईस	t̪ eː iː s
चिंगारी	t͡ʃ ɪ ŋ ɡ ɑː ɾ iː
अलम	ə l ə m
आसाम	ɑː s ɑː m
आना	ɑː n ɑː
दिलासा	d̪ ɪ l ɑː s ɑː
में	m ẽ
अनुयायी	ə n ʊ j ɑː j iː
सांड	s ɑː n ɖ
कोंपल	k oː m p ə l
रतालू	ɾ ə t̪ ɑː l uː
फूलदान	pʰ uː l d̪ ɑː n
साथसाथ	s aː t̪ʰ s aː t̪ʰ
धमनी	d̪ ʱ ə m n iː
साधारणतः	s ɑː d̪ ʱ ɑː ɾ ə n t̪ əʰ
निहाई	n ɪ ɦ ɑː iː
गोवा	ɡ oː ʋ ɑː
गुलज़ार	ɡ ʊ l z ɑː ɾ
इस	ɪ s
सैर	s ɛː ɾ
छानना	t͡ʃʰ ɑː n n ɑː
हलाक	ɦ ə l ɑː k
वायु	ʋ ɑː j uː
अनाथालय	ə n ɑː t̪ʰ ɑː l ə j
नीदरलैण्ड	n iː d̪ ə ɾ l ɛː n ɖ
मेहनती	m eː ɦ ə n t̪ iː
सेवानिवृत्त	s eː ʋ ɑː n ɪ ʋ ɾ ɪ t̪ t̪
बहुजन	b ə ɦ ʊ d͡ʒ ə n
फ़रवरी	f ə ɾ ʋ ə ɾ iː
दफ़नाना	d̪ ə f n ɑː n ɑː
विलीन	ʋ ɪ l iː n
गर्भावस्था	ɡ ə ɾ b ʱ ɑː ʋ ə s t̪ʰ ɑː
खिलौना	kʰ ɪ l̪ ɔː n̪ ɑː
वहशी	ʋ ə ʱ ʃ iː
उचित	ʊ t͡ʃ ɪ t̪
संघ	s ə ŋ ɡ ʱ
न्यूज़ीलैण्ड	n j uː z iː l ɛː n ɖ
पनाह	p ə n ɑː ʱ
मध्य	m ə d̪ ʱ j
आक	ɑː k
नाभिकीय	n ɑː b ʱ ɪ k iː j
नाना	n ɑː n ɑː
चक्रवृद्धि	t͡ʃ ə k ɾ ə ʋ ɾ ɪ d̪ d̪ ʱ iː
चीता	t͡ʃ iː t̪ ɑː
निर्देश	n ɪ ɾ d̪ eː ʃ
गर्दिश	ɡ ə ɾ d̪ ɪ ʃ
अगणित	ə ɡ ə n ɪ t̪
तामील	t̪ ɑː m iː l
बांग्लादेश	b ɑː ŋ ɡ l ɑː d̪ eː ʃ
द्वारा	d̪ ʋ ɑː ɾ ɑː
पोलैंड	p oː l ɛː n ɖ
मय्यत	m ə j j ə t̪
कार्ड	k ɑː ɾ ɖ
किमी	k ɪ m iː
चतुराई	t͡ʃ ə t̪ ʊ ɾ ɑː iː
बेइज़्ज़ती	b eː ɪ z z ə t̪ iː
तीली	t̪ iː l iː
पुष्टीकरण	p ʊ ʃ ʈ iː k ə ɾ ə n
ज़िम्बाब्वे	z ɪ m b ɑː b ʋ eː
स्थितिज	s t̪ʰ ɪ t̪ ɪ d͡ʒ
उन्होंने	ʊ n ɦ õː n eː
राख	r a kʰ
जोशीला	d͡ʒ oː ʃ iː l ɑː
आत्मीय	ɑː t̪ m iː j
कलीसिया	k ə l iː s iː j ɑː
घर्षण	ɡ ʱ ə ɾ ʃ ə n
निर्जीव	n ɪ ɾ d͡ʒ iː ʋ
मिसाल	m ɪ s ɑː l
छोकरी	t͡ʃʰ oː k ɾ iː
अतुल्य	ə t̪ ʊ l j
शीर्षक	ʃ iː ɾ ʃ ə k
शादीशुदा	ʃ ɑː d̪ iː ʃ ʊ d̪ ɑː
सधुक्कड़ी	s ə d̪ ʱ ʊ k k ə ɽ iː
धर्मशाला	d̪ ʱ ə ɾ ə m ʃ ɑː l ɑː
धर्म	d̪ ʱ ə ɾ m
चुसना	t ʃ ʊ s n̪ aː
अंगहीन	ə ŋ ɡ ʱ iː n
पूछना	p uː t͡ʃʰ n ɑː
नापना	n ɑː p n ɑː
उत्तरार्द्ध	ʊ t̪ t̪ ə ɾ ɑː ɾ d̪ d̪ ʱ
भेजा	b ʱ eː d͡ʒ ɑː
प्रेरणा	p ɾ eː ɾ n ɑː
फ़ीस	f iː s
अत्युत्तम	ə t̪ j ʊ t̪ t̪ ə m
अपदेश	ə p d̪ eː ʃ
समाना	s ə m ɑː n ɑː
उठना	ʊ ʈʰ n ɑː
अज्ञानपन	ə ɡ j ɑː n p ə n
प्रधानाध्यापक	p ɾ ə d̪ ʱ ɑː n ɑː d̪ ʱ j ɑː p ə k
स्मरण	s m ə ɾ ə n
अत्फ़ाल	ə t̪ f ɑː l
जनपद	d͡ʒ ə n p ə d̪
महागुरु	m ə ɦ ɑː ɡ ʊ ɾ uː
जई	d͡ʒ ə iː
अपेक्षाकृत	ə p eː k ʃ ɑː k ɾ ɪ t̪
तहज़ीब	t̪ ɛː ʱ z iː b
माजरा	m ɑː d͡ʒ ɾ ɑː
मोच	m oː t͡ʃ
प्रादेशिक	p ɾ ɑː d̪ eː ʃ ɪ k
हुआ	ɦ ʊ ɑː
इंडोनेशिया	ɪ n ɖ oː n eː ʃ iː j ɑː
फेफड़ा	pʰ eː pʰ ɽ ɑː
नशेड़ी	n ə ʃ eː ɽ iː
पसीना	p ə s iː n ɑː
प्रबन्ध	p ɾ ə b ə n d̪ ʱ
लण्ड	l ə n ɖ
मंच	m ə ɲ t͡ʃ
कुनबा	k ʊ n b ɑː
पाँचवां	p ɑ̃ː t͡ʃ ʋ ɑ̃ː
दादुर	d̪ ɑː d̪ ʊ ɾ
कैंची	k ɛː ɲ t͡ʃ iː
तसल्ली	t̪ ə s ə l l iː
कुँआरी	k ʊ̃ ɑː ɾ iː
दिखावा	d̪ ɪ kʰ ɑː ʋ ɑː
चपरासी	t͡ʃ ə p ɾ ɑː s iː
अपर्याप्त	ə p ə ɾ j ɑː p t̪
कचहरी	k ə t͡ʃ ɛː ʱ ɾ iː
सफ़र	s ə f ə ɾ
हसीन	ɦ ə s iː n
मूस	m uː s
अंचल	ə ɲ t͡ʃ ə l
पंसारी	p ə n s ɑː ɾ iː
अनुपस्थिति	ə n ʊ p ə s t̪ʰ ɪ t̪ iː
फ़रमाना	f ə ɾ m ɑː n ɑː
याददाश्त	j ɑː d̪ d̪ ɑː ʃ t̪
औषध	ɔː ʃ ə d̪ ʱ
शनि	ʃ ə n iː
सर्वनाम	s ə ɾ ʋ ə n ɑː m
क्रोध	k ɾ oː d̪ ʱ
उससे	ʊ s s eː
निवास	n ɪ ʋ ɑː s
खाँसी	kʰ ɑ̃ː s iː
हल्का	ɦ ə l̪ k ɑː
पकाना	p ə k ɑː n ɑː
रवा	ɾ ə ʋ ɑː
ग्वालियर	ɡ ʋ ɑː l iː j ə ɾ
बादशाहत	b ɑː d̪ ʃ ɑː ɦ ə t̪
नायिका	n ɑː j ɪ k ɑː
राष्ट्रीय	ɾ ɑː ʃ ʈ ɾ iː j
पारगम्यता	p ɑː ɾ ɡ ə m j ə t̪ ɑː
उन्नत	ʊ n n ə t̪
गायकी	ɡ ɑː j ə k iː
अंधेरा	ə n d̪ ʱ eː ɾ ɑː
अनिश्चितता	ə n ɪ ʃ t͡ʃ ɪ t̪ t̪ ɑː
मोरक्को	m oː ɾ ə k k oː
मुकम्मल	m ʊ k ə m m ə l
मुंडन	m ʊ n ɖ ə n
स्थगित	s t̪ʰ ə ɡ ɪ t̪
कन्द	k ə n d̪
जहान	d͡ʒ ə ɦ ɑː n
औषधि	ɔː ʃ d̪ ʱ iː
लालच	l ɑː l ə t͡ʃ
निषेधन	n ɪ ʃ eː d̪ ʱ ə n
अंश	ə n ʃ
कश्मीर	k ə ʃ m iː ɾ
वालिदैन	ʋ ɑː l ɪ d̪ ɛː n
गौरव	ɡ ɔː ɾ ə ʋ
माफ़ी	m ɑː f iː
गोबर	ɡ oː b ə ɾ
सहस्रपाद	s ɛː ʱ s ɾ ə p ɑː d̪
संगणक	s ə ŋ ɡ ə n ə k
आफ़ताब	ɑː f t̪ ɑː b
पसरना	p ə s ə ɾ n ɑː
रागमाला	ɾ ɑː ɡ m ɑː l ɑː
घाव	ɡ ʱ ɑː ʋ
अरब	ə ɾ ə b
पेचीदा	p eː t͡ʃ iː d̪ ɑː
अणु	ə n uː
रोपाई	ɾ oː p ɑː iː
भाई	b ʱ ɑː iː
बादाम	b ɑː d̪ ɑː m
दिनांकित	d̪ ɪ n ɑː ŋ k ɪ t̪
विधानसभा	ʋ ɪ d̪ ʱ ɑː n s ə b ʱ ɑː
कूटनीतिक	k uː ʈ n iː t̪ ɪ k
रीति	ɾ iː t̪ iː
जूता	d͡ʒ uː t̪ ɑː
आपातकाल	ɑː p ɑː t̪ k ɑː l
व्यस्त	ʋ j ə s t̪
सेहतमंद	s eː ɦ ə t̪ m ə n d̪
दफ़्तरशाह	d̪ ə f t̪ ə ɾ ʃ ɑː ʱ
दस्यु	d̪ ə s j uː
रोका	ɾ oː k ɑː
बलिदान	b ə l ɪ d̪ ɑː n
अर्जेंटीना	ə ɾ d͡ʒ eː n ʈ iː n ɑː
ज्यों	d͡ʒ j õː
अखिल	ə kʰ ɪ l
अभ्यासक्रम	ə b ʱ j ɑː s k ɾ ə m
हरकत	ɦ ə ɾ k ə t̪
अंगड़ाई	ə ŋ ɡ ɽ ɑː iː
फट	pʰ ə ʈ
तुर्की	t̪ ʊ ɾ k iː
पाहन	p ɑː ɦ ə n
धमकाना	d̪ ʱ ə m k ɑː n ɑː
समष्टि	s ə m ə ʃ ʈ iː
संयोग	s ə̃ j oː ɡ
लिपटना	l ɪ p ə ʈ n ɑː
स्वास्थ्य	s ʋ ɑː s t̪ʰ j ə
अदा	ə d̪ ɑː
दर्द	d̪ ə ɾ d̪
भैंसा	b ʱ ɛ̃ː s ɑː
गगन	ɡ ə ɡ ə n
गुलूबंद	ɡ ʊ l uː b ə n d̪
केला	k eː l ɑː
शोला	ʃ oː l ɑː
लाज़िम	l ɑː z ɪ m
बीहड़	b iː ɦ ə ɽ
सराहना	s ə ɾ ɑː ʱ n ɑː
जुगनू	d͡ʒ ʊ ɡ n uː
चैट	t͡ʃ ɛː ʈ
सयाना	s ə j ɑː n ɑː
वृत्तांत	ʋ ɾ ɪ t̪ t̪ ɑː n t̪
ताई	t̪ ɑː iː
गांभीर्य	ɡ ɑː m b ʱ iː ɾ j
मिरजई	m ɪ ɾ d͡ʒ ə iː
मधुमक्खी	m ə d̪ ʱ ʊ m ə k kʰ iː
माफ़	m ɑː f
स्तनधारी	s t̪ ə n d̪ ʱ ɑː ɾ iː
सर्बिया	s ə ɾ b iː j ɑː
सहजात	s ɛː ʱ d͡ʒ ɑː t̪
अजवाइन	ə d͡ʒ ʋ ɑː ɪ n
अटक	ə ʈ ə k
ऑस्ट्रिया	ɔː s ʈ ɾ iː j ɑː
अड़ंगा	ə ɽ ə ŋ ɡ ɑː
पद्धति	p ə d̪ d̪ ʱ ə t̪ iː
भौमिकी	b ʱ ɔː m ɪ k iː
प्रतीक	p ɾ ə t̪ iː k
छूना	t͡ʃʰ uː n ɑː
परखना	p ə ɾ ə kʰ n ɑː
वाणी	ʋ ɑː n iː
विनिपेग	ʋ ɪ n ɪ p eː ɡ
खत्री	kʰ ə t̪ ɾ iː
शजरा	ʃ ə d͡ʒ ɾ ɑː
अप्रत्यक्ष	ə p ɾ ə t̪ j ə k ʃ
नौकर	n ɔː k ə ɾ
अधिकृत	ə d̪ ʱ ɪ k ɾ ɪ t̪
महासचिव	m ə ɦ ɑː s ə t͡ʃ ɪ ʋ
बिटिया	b ɪ ʈ iː j ɑː
आन्दोलन	ɑː n d̪ oː l ə n
अफ़साना	ə f s ɑː n ɑː
अब्र	ə b ɾ
बरस	b ə ɾ ə s
विरोधाभास	ʋ ɪ ɾ oː d̪ ʱ ɑː b ʱ ɑː s
अंतर्निहित	ə n t̪ ə ɾ n ɪ ɦ ɪ t̪
कटना	k ə ʈ n ɑː
मौला	m ɔː l ɑː
अपराधी	ə p ɾ ɑː d̪ ʱ iː
इस्राइल	ɪ s ɾ ɑː ɪ l
गरुड़	ɡ ə ɾ ʊ ɽ
निष्कर्ष	n ɪ ʃ k ə ɾ ʃ
टिक्का	ʈ ɪ k k ɑː
रोग	ɾ oː ɡ
चित्रित	t͡ʃ ɪ t̪ ɾ ɪ t̪
वायुसेना	ʋ ɑː j uː s eː n ɑː
हमें	ɦ ə m ẽ
धर्मपरायण	d̪ ʱ ə ɾ m p ə ɾ ɑː j ə n
समीप	s ə m iː p
हेकड़	ɦ eː k ə ɽ
प्रशंसक	p ɾ ə ʃ ə n s ə k
अस्सी	ə s s iː
बन	b ə n
सस्तापन	s ə s t̪ ɑː p ə n
नवजीवन	n ə ʋ d͡ʒ iː ʋ ə n
श्वित्र	ʃ ʋ ɪ t̪ ɾ
शुरुआती	ʃ ʊ ɾ ʊ ɑː t̪ iː
मुआयना	m ʊ ɑː j n ɑː
कनिष्ठ	k ə n ɪ ʃ ʈʰ
मंचूरिया	m ə ɲ t͡ʃ uː ɾ iː j ɑː
प्रज्वलित	p ɾ ə d͡ʒ ʋ ə l ɪ t̪
जम्मू	d͡ʒ ə m m uː
मई	m ə iː
बांस	b ɑː n s
प्राचल	p ɾ ɑː t͡ʃ ə l
लोहू	l oː ɦ uː
ब्राह्मी	b ɾ ɑː ʱ m iː
अच्छापन	ə t͡ʃː ɑ p ə n
किरायेदार	k ɪ ɾ ɑː j eː d̪ ɑː ɾ
एल्युमिनियम	eː l j ʊ m ɪ n iː j ə m
ढालना	ɖ ʱ ɑː l n ɑː
शरियत	ʃ ə ɾ iː j ə t̪
ढोर	ɖ ʱ oː ɾ
इम्तिहान	ɪ m t̪ ɪ ɦ ɑː n
चिली	t͡ʃ ɪ l iː
चक्षु	t͡ʃ ə k ʃ uː
निर्मेघ	n ɪ ɾ m eː ɡ ʱ
थीं	t̪ʰ ĩː
भगनासा	b ʱ ə ɡ n ɑː s ɑː
शूर	ʃ uː ɾ
अक्सर	ə k s ə ɾ
संस्कृत	s ə n s k ɾ ɪ t̪
महान	m ə ɦ ɑː n
अँगूठी	ə̃ ɡ uː ʈʰ iː
वाहिका	ʋ ɑː ɦ ɪ k ɑː
ढांचा	ɖ ʱ ɑː ɲ t͡ʃ ɑː
चौथाई	t͡ʃ ɔː t̪ʰ ɑː iː
मेहमाननवाज़ी	m eː ʱ m ɑː n n ə ʋ ɑː z iː
मृतप्राय	m ɾ ɪ t̪ p ɾ ɑː j
पहुँचाना	p ə ɦ ʊ̃ t͡ʃ ɑː n ɑː
प्रणाम	p ɾ ə n ɑː m
अशरफ़ी	ə ʃ ə ɾ f iː
टोफ़ू	ʈ oː f uː
औद्योगिक	ɔː d̪ j oː ɡ ɪ k
उत्प्रेरक	ʊ t̪ p ɾ eː ɾ ə k
अकड़	ə k ə ɽ
मत	m ə t̪
रहमान	ɾ ɛː ʱ m ɑː n
जबड़ा	d͡ʒ ə b ɽ ɑː
राष्ट्र	ɾ ɑː ʃ ʈ ɾ
मरना	m ə ɾ n ɑː
पिस्तौल	p ɪ s t̪ ɔː l
भोपाल	b ʱ oː p ɑː l
नाप	n ɑː p
उनतालीस	ʊ n t̪ ɑː l iː s
गुंडा	ɡ ʊ n ɖ ɑː
डाउनलोड	ɖ ɑː ʊ n l oː ɖ
सरद	s ə ɾ ə d̪
प्रागितिहास	p ɾ ɑː ɡ ɪ t̪ ɪ ɦ ɑː s
रामल्लाह	ɾ ɑː m ə l l ɑː ʱ
कहावत	k ə ɦ ɑː ʋ ə t̪
अलगाववाद	ə l ɡ ɑː ʋ ʋ ɑː d̪
कांदा	k ɑː n d̪ ɑː
दूब	d̪ uː b
ठगी	ʈʰ ə ɡ iː
बेगाना	b eː ɡ ɑː n ɑː
होशंगाबाद	ɦ oː ʃ ə ŋ ɡ ɑː b ɑː d̪
तेजपुर	t̪ eː d͡ʒ p ʊ ɾ
जावित्री	d͡ʒ ɑː ʋ ɪ t̪ ɾ iː
नागालैण्ड	n ɑː ɡ ɑː l ɛː n ɖ
चांपानेर	t͡ʃ ɑː m p ɑː n eː ɾ
ईंट	iː n ʈ
आधिपत्य	ɑː d̪ ʱ ɪ p ə t̪ j
तालमेल	t̪ ɑː l m eː l
दहलना	d̪ ɛː ʱ l n ɑː
घन	ɡ ʱ ə n
शिलातैल	ʃ ɪ l ɑː t̪ ɛː l
जगाना	d͡ʒ ə ɡ ɑː n ɑː
अप्रसन्न	ə p ɾ ə s ə n n
सेंटी	s eː n ʈ iː
जीव	d͡ʒ iː ʋ
मरीज़	m ə ɾ iː z
इस्लामाबाद	ɪ s l ɑː m ɑː b ɑː d̪
भौतिकी	b ʱ ɔː t̪ ɪ k iː
परचम	p ə ɾ t͡ʃ ə m
कैरम	k ɛː ɾ ə m
जन्मना	d͡ʒ ə n m n ɑː
प्रशासिक	p ɾ ə ʃ ɑː s ɪ k
नचाना	n ə t͡ʃ ɑː n ɑː
अर्धवार्षिक	ə ɾ d̪ ʱ ʋ ɑː ɾ ʃ ɪ k
गिरफ़्त	ɡ ɪ ɾ ə f t̪
डोलना	ɖ oː l n ɑː
औज़ार	ɔː z ɑː ɾ
कौन	k ɔː n
स्वशिक्षा	s ʋ ə ʃ ɪ k ʃ ɑː
सत्वर	s ə t̪ ʋ ə ɾ
होली	ɦ oː l iː
क्रूस	k ɾ uː s
हकलाना	ɦ ə k l ɑː n ɑː
असंवैधानिक	ə s ə m ʋ ɛː d̪ ʱ ɑː n ɪ k
चिड़वा	t͡ʃ ɪ ɽ ʋ ɑː
छाला	t͡ʃʰ ɑː l ɑː
पतंगबाज़	p ə t̪ ə ŋ ɡ b ɑː z
अभूतपूर्व	ə b ʱ uː t̪ p uː ɾ ʋ
पुरातत्व	p ʊ ɾ ɑː t̪ ə t̪ ʋ
अंदर	ə n d̪ ə ɾ
दीवार	d̪ iː ʋ ɑː ɾ
डिप्टी	ɖ ɪ p ʈ iː
आँगन	ɑ̃ː ɡ ə n
सिंह	s ɪ n ʱ
तोपची	t̪ oː p t͡ʃ iː
कोशिश	k oː ʃ ɪ ʃ
शिकम	ʃ ɪ k ə m
निर्वाचित	n ɪ ɾ ʋ ɑː t͡ʃ ɪ t̪
तराना	t̪ ə ɾ ɑː n ɑː
गाण्डू	ɡ ɑː n ɖ uː
टखना	ʈ ə kʰ n ɑː
पोतना	p oː t̪ n ɑː
भोंकना	b ʱ oː ŋ k n ɑː
नीलम	n iː l ə m
शौरसेनी	ʃ ɔː ɾ s eː n iː
बौछाड़	b ɔː t͡ʃʰ ɑː ɽ
क्रिकेटर	k ɾ ɪ k eː ʈ ə ɾ
प्राथमिक	p r aː t̪ʰ m ɪ k
दृढ़तापूर्वक	d̪ ɾ ɪ ɽ ʱ t̪ ɑː p uː ɾ ʋ ə k
महत्त्वपूर्ण	m ɛː ʱ t̪ t̪ ʋ ə p uː ɾ n
शिक्षामित्र	ʃ ɪ k ʃ ɑː m ɪ t̪ ɾ
नामकरण	n ɑː m k ə ɾ ə n
बहकना	b ɛː ʱ k n ɑː
चीज़	t͡ʃ iː z
विविध	ʋ ɪ ʋ ɪ d̪ ʱ
सामर्थ्य	s ɑː m ə ɾ t̪ʰ j ə
झूमर	d͡ʒ ʱ uː m ə ɾ
आइसक्रीम	ɑː ɪ s k ɾ iː m
पठान	p ə ʈʰ ɑː n
भविष्यवाणी	b ʱ ə ʋ ɪ ʃ j ə ʋ ɑː n iː
अनहोनी	ə n ɦ oː n iː
महबूब	m ɛː ʱ b uː b
वृद्धाश्रम	ʋ ɾ ɪ d̪ d̪ ʱ ɑː ʃ ɾ ə m
नेतन्याहू	n eː t̪ ə n j ɑː ɦ uː
यौवन	j ɔː ʋ ə n
अनुनाद	ə n ʊ n ɑː d̪
फ़रीदाबाद	f ə ɾ iː d̪ ɑː b ɑː d̪
उनचास	ʊ n t͡ʃ ɑː s
मरम्मत	m ə ɾ ə m m ə t̪
अगाऊ	ə ɡ ɑː uː
वरण	ʋ ə ɾ ə n
महकना	m ɛː ʱ k n ɑː
उदगद्रि	ʊ d̪ ɡ ə d̪ ɾ iː
यौवनकाल	j ɔː ʋ ə n k ɑː l
रेत	ɾ eː t̪
स्थानांतरण	s t̪ʰ ɑː n ɑː n t̪ ɾ ə n
अनियमित	ə n iː j ə m ɪ t̪
चर्च	t͡ʃ ə ɾ t͡ʃ
क्रियावाचक	k ɾ iː j ɑː ʋ ɑː t͡ʃ ə k
पड़ना	p ə ɽ n ɑː
रसूलुल्लाह	ɾ ə s uː l ʊ l l ɑː ʱ
गोली	ɡ oː l iː
चिड़िया	t͡ʃ ɪ ɽ iː j ɑː
है	ɦ ɛː
गढ़ी	ɡ ə ɽ ʱ iː
मेमना	m eː m n ɑː
पांच	p ɑː ɲ t͡ʃ
लड़ाकू	l ə ɽ ɑː k uː
पुदीना	p ʊ d̪ iː n ɑː
पालना	p ɑː l n ɑː
माओवादी	m ɑː oː ʋ ɑː d̪ iː
अमेरिकी	ə m eː ɾ ɪ k iː
असंवेदनशील	ə s ə m ʋ eː d̪ ə n ʃ iː l
अम्ल	ə m l
अपत्य	ə p ə t̪ j
श्रेणी	ʃ ɾ eː n iː
आघातपूर्ण	ɑː ɡ ʱ ɑː t̪ p uː ɾ n
सरंजाम	s ə ɾ ə ɲ d͡ʒ ɑː m
माल्टा	m aː l ʈ aː
सिक्किम	s ɪ k k ɪ m
अबोध	ə b oː d̪ ʱ
चूना	t͡ʃ uː n ɑː
सौतेला	s ɔː t̪ eː l ɑː
निम्न	n ɪ m n
अनुपूरक	ə n ʊ p uː ɾ ə k
दंगा	d̪ ə ŋ ɡ ɑː
चक्रवर्ती	t͡ʃ ə k ɾ ə ʋ ə ɾ t̪ iː
पूजना	p uː d͡ʒ n ɑː
जन	d͡ʒ ə n
कुमारी	k ʊ m ɑː ɾ iː
हिम	ɦ ɪ m
नकेल	n ə k eː l
उत्पीड़न	ʊ t̪ p iː ɽ ə n
दौलतमंद	d̪ ɔː l ə t̪ m ə n d̪
दुर्व्यवहार	d̪ ʊ ɾ ʋ j ə ʋ ɦ ɑː ɾ
दूरी	d̪ uː ɾ iː
नाला	n ɑː l ɑː
पगडंडी	p ə ɡ ɖ ə n ɖ iː
भुवन	b ʱ ʊ ʋ ə n
पर्याय	p ə ɾ j ɑː j
वारदात	ʋ ɑː ɾ d̪ ɑː t̪
प्रबल	p ɾ ə b ə l
धरातल	d̪ ʱ ə ɾ ɑː t̪ ə l
जोखना	d͡ʒ oː kʰ n ɑː
चायदान	t͡ʃ ɑː j d̪ ɑː n
चेहरा	t͡ʃ eː ʱ ɾ ɑː
मूर्ख	m uː ɾ kʰ
मेज़बान	m eː z b ɑː n
विश्वकोश	ʋ ɪ ʃ ʋ ə k oː ʃ
बाबर	b ɑː b ə ɾ
धोखा	d̪ ʱ oː kʰ ɑː
छापामार	t͡ʃʰ ɑː p ɑː m ɑː ɾ
दर्ज	d̪ ə ɾ d͡ʒ
सार्वत्रिक	s ɑː ɾ ʋ ə t̪ ɾ ɪ k
पनामा	p ə n ɑː m ɑː
चरवाहा	t͡ʃ ə ɾ ʋ ɑː ɦ ɑː
मालिश	m ɑː l ɪ ʃ
आलू	ɑː l uː
पतलून	p ə t̪ l uː n
लखन	l ə kʰ ə n
नाकाम	n ɑː k ɑː m
मोतीचूर	m oː t̪ iː t͡ʃ uː ɾ
ज़ालिम	z ɑː l ɪ m
गुम	ɡ ʊ m
अतिवाद	ə t̪ ɪ ʋ ɑː d̪
मरहम	m ə ɾ ɦ ə m
विज्ञान	ʋ ɪ ɡ j ɑː n
बिन	b ɪ n
भद्दा	b ʱ ə d̪ d̪ ɑː
सदन	s ə d̪ ə n
हृदयाघात	ɦ ɾ ɪ d̪ ə j ɑː ɡ ʱ ɑː t̪
तहरी	t̪ ɛː ʱ ɾ iː
बेफ़िक्री	b eː f ɪ k ɾ iː
विज्ञापन	ʋ ɪ ɡ j ɑː p ə n
राखी	ɾ ɑː kʰ iː
पास्ता	p ɑː s t̪ ɑː
यज्ञकर्ता	j ə ɡ j ə k ə ɾ t̪ ɑː
गणना	ɡ ə n n ɑː
परमाणविक	p ə ɾ m ɑː n ʋ ɪ k
भाईचारा	b ʱ ɑː iː t͡ʃ ɑː ɾ ɑː
फ़ील्मी	f iː l m iː
तावीज़	t̪ ɑː ʋ iː z
जनरल	d͡ʒ ə n ɾ ə l
ढील	ɖ ʱ iː l
मंत्रिमंडल	m ə n t̪ ɾ ɪ m ə n ɖ ə l
कंठ	k ə n ʈʰ
दर्ज़ी	d̪ ə ɾ z iː
शिक्षाविद्	ʃ ɪ k ʃ ɑː ʋ ɪ d̪
सिंगापुर	s ɪ ŋ ɡ ɑː p ʊ ɾ
हवाला	ɦ ə ʋ ɑː l ɑː
चिमटा	t͡ʃ ɪ m ʈ ɑː
दावेदार	d̪ ɑː ʋ eː d̪ ɑː ɾ
मल्होत्रा	m ə l ɦ oː t̪ ɾ ɑː
चवालीस	t͡ʃ ə ʋ ɑː l iː s
खदेड़ना	kʰ ə d̪ eː ɽ n ɑː
एटीएम	eː ʈ iː eː m
मोटू	m oː ʈ uː
निवृत्त	n ɪ ʋ ɾ ɪ t̪ t̪
ज़मीं	z ə m ĩː
क्लास	k l ɑː s
तौलिया	t̪ ɔː l iː j ɑː
जँभाई	d͡ʒ ə̃ b ʱ ɑː iː
सोमालिया	s oː m ɑː l iː j ɑː
ज्यादा	d͡ʒ j ɑː d̪ ɑː
विक्रय	ʋ ɪ k ɾ ə j
कहवा	k ə ʱ ʋ ɑː
असुरक्षित	ə s ʊ ɾ ə k ʃ ɪ t̪
वासी	ʋ ɑː s iː
तत्त्व	t̪ ə t̪ʷ
चुम्बन	t͡ʃ ʊ m b ə n
कठघरा	k ə ʈʰ ɡ ʱ ə ɾ ɑː
अजान	ə d͡ʒ ɑː n
फ़रार	f ə ɾ ɑː ɾ
कनपटी	k ə n p ə ʈ iː
भौंह	b ʱ ɔ̃ː ʱ
करणी	k ə ɾ n iː
पहर	p eː ʱ ɾ
नोटबुक	n oː ʈ b ʊ k
उसको	ʊ s k oː
अर्धसरकारी	ə ɾ d̪ ʱ s ə ɾ k ɑː ɾ iː
का	k ɑː
फांसी	pʰ ɑː n s iː
ईक्वाडोर	iː k ʋ ɑː ɖ oː ɾ
सत्यापनों	s ə t̪ j ɑː p n õː
पंजाब	p ə ɲ d͡ʒ ɑː b
बबूल	b ə b uː l
महाविद्यालय	m ə ɦ ɑː ʋ ɪ d̪ j ɑː l ə j
अंक	ə ŋ k
भाषा	b ʱ ɑː ʂ ɑː
बहनचोद	b ɛː ʱ n t͡ʃ oː d̪
नहलाना	n ɛː ʱ l ɑː n ɑː
शहर	ʃ ɛː ʱ ɾ
मराठी	m ə ɾ ɑː ʈʰ iː
संन्यास	s ə n n j ɑː s
मुरादाबाद	m ʊ ɾ ɑː d̪ ɑː b ɑː d̪
सस्यविज्ञान	s ə s j ə ʋ ɪ ɡ j ɑː n
रामरज	ɾ ɑː m ɾ ə d͡ʒ
पाठ्य	p ɑː ʈʰ j
बाढ़	b ɑː ɽ ʱ
महावीर	m ə ɦ ɑː ʋ iː ɾ
नाभि	n ɑː b ʱ iː
वित्त	ʋ ɪ t̪ t̪
गुलाबी	ɡ ʊ l ɑː b iː
अँगीठी	ə̃ ɡ iː ʈʰ iː
पहुँचना	p ə ɦ ʊ̃ t͡ʃ n ɑː
नफ़रत	n ə f ɾ ə t̪
सतलुज	s ə t̪ l ʊ d͡ʒ
अदब	ə d̪ ə b
शतकवीर	ʃ ə t̪ ə k ʋ iː ɾ
ठोकना	ʈʰ oː k n ɑː
पर्यावरण	p ə ɾ j ɑː ʋ ə ɾ ə n
चूज़ा	t͡ʃ uː z ɑː
आंदोलन	ɑː n d̪ oː l ə n
बंगला	b ə ŋ ɡ l ɑː
बिंदु	b ɪ n d̪ uː
प्रभात	p ɾ ə b ʱ ɑː t̪
बहकाना	b ɛː ʱ k ɑː n ɑː
दाताओं	d̪ ɑː t̪ ɑː oː n
प्रयोगकर्ता	p ɾ ə j oː ɡ k ə ɾ t̪ ɑː
प्राकृत	p ɾ ɑː k ɾ ɪ t̪
परिरुद्ध	p ə ɾ ɪ ɾ ʊ d̪ d̪ ʱ
प्रियवर	p ɾ iː j ə ʋ ə ɾ
इश्क	ɪ ʃ k
उनहत्तर	ʊ n ɦ ə t̪ t̪ ə ɾ
तृण	t̪ ɾ ɪ n
विचारधारा	ʋ ɪ t͡ʃ ɑː ɾ d̪ ʱ ɑː ɾ ɑː
राज़ी	ɾ ɑː z iː
व्यापार	ʋ j ɑː p ɑː ɾ
आदिभाषा	ɑː d̪ ɪ b ʱ ɑː ʃ ɑː
सिफ़त	s ɪ f ə t̪
तीस	t̪ iː s
गाँजा	ɡ ɑː ɲ d͡ʒ ɑː
क्वथनांक	k ʋ ə t̪ʰ ə n ɑː ŋ k
जनजाति	d͡ʒ ə n d͡ʒ ɑː t̪ iː
जायदाद	d͡ʒ ɑː j ə d̪ ɑː d̪
हालाँकि	ɦ ɑː l ɑ̃ː k iː
ध्वज	d̪ ʱ ʋ ə d͡ʒ
उपलब्ध	ʊ p l ə b d̪ ʱ
दुक्की	d̪ ʊ k k iː
रामचंद्र	ɾ ɑː m t͡ʃ ə n d̪ ɾ
क्षेत्रफल	k ʃ eː t̪ ɾ ə pʰ ə l
ज़्यादती	z j ɑː d̪ ə t̪ iː
आत्मघात	ɑː t̪ m ə ɡ ʱ ɑː t̪
निजी	n ɪ d͡ʒ iː
कहलाना	k ɛː ʱ l ɑː n ɑː
बुल्ला	b ʊ l l ɑː
खोला	kʰ oː l ɑː
कार	k ɑː ɾ
अतिसार	ə t̪ ɪ s ɑː ɾ
पीठ	p iː ʈʰ
न्यायपालिका	n j ɑː j p ɑː l ɪ k ɑː
मिठास	m ɪ ʈʰ ɑː s
अनियमितता	ə n iː j ə m ɪ t̪ t̪ ɑː
किलोमीटर	k ɪ l oː m iː ʈ ə ɾ
वस्त्र	ʋ ə s t̪ ɾ
दोहरना	d̪ oː ɦ ə ɾ n ɑː
विनम्रता	ʋ ɪ n ə m ɾ ə t̪ ɑː
साथी	s ɑː t̪ʰ iː
जाति	d͡ʒ ɑː t̪ iː
उल्टा	ʊ l ʈ ɑː
आयु	ɑː j uː
दादरा	d̪ ɑː d̪ ɾ ɑː
ब्रह्मांड	b ɾ ɛː ʱ m ɑː n ɖ
मरुस्थल	m ə ɾ ʊ s t̪ʰ ə l
हैरत	ɦ ɛː ɾ ə t̪
ट्वीट	ʈ ʋ iː ʈ
हीलियम	ɦ iː l iː j ə m
रंभा	ɾ ə m b ʱ ɑː
अनपच	ə n p ə t͡ʃ
तोमर	t̪ oː m ə ɾ
नान	n ɑː n
संबंध	s ə m b ə n d̪ ʱ
सत्य	s ə t̪ j
कारोबारी	k ɑː ɾ oː b ɑː ɾ iː
बयासी	b ə j ɑː s iː
पब	p ə b
क्राइस्टचर्च	k ɾ ɑː ɪ s ʈ t͡ʃ ə ɾ t͡ʃ
गाय	ɡ ɑː j
चोरी	t͡ʃ oː ɾ iː
सत्याग्रह	s ə t̪ j ɑː ɡ ɾ ə ʱ
अंकुरित	ə ŋ k ʊ ɾ ɪ t̪
इमारती	ɪ m ɑː ɾ ə t̪ iː
अठारह	ə ʈʰ ɑː ɾ ə ʱ
नाती	n ɑː t̪ iː
विषम	ʋ ɪ ʃ ə m
कुचलना	k ʊ t͡ʃ ə l n ɑː
माइक	m ɑː ɪ k
गाना	ɡ ɑː n ɑː
उपवास	ʊ p ʋ ɑː s
मध्यावकाश	m ə d̪ ʱ j ɑː ʋ k ɑː ʃ
इलाज	ɪ l ɑː d͡ʒ
सिंचाई	s ɪ ɲ t͡ʃ ɑː iː
लुप्त	l ʊ p t̪
शटर	ʃ ə ʈ ə ɾ
चुकाना	t͡ʃ ʊ k ɑː n ɑː
बुद्धि	b ʊ d̪ d̪ ʱ iː
प्रजातंत्र	p ɾ ə d͡ʒ ɑː t̪ ə n t̪ ɾ
कंगारू	k ə ŋ ɡ ɑː ɾ uː
डेटा	ɖ eː ʈ ɑː
आतंकित	ɑː t̪ ə ŋ k ɪ t̪
समिट	s ə m ɪ ʈ
तिरुचिरापल्ली	t̪ ɪ ɾ ʊ t͡ʃ ɪ ɾ ɑː p ə l l iː
ज्ञात	ɡ j ɑː t̪
रखवाल	ɾ ə kʰ ʋ ɑː l
महक	m eː ɦ eː k
झूठमूठ	d ʒ ʱ uː ʈʰ m uː ʈʰ
वरिष्ठ	ʋ ə ɾ ɪ ʃ ʈʰ
सौम्य	s ɔː m j
आलस्य	ɑː l ə s j
सौदागर	s ɔː d̪ ɑː ɡ ə ɾ
धरती	d̪ ʱ ə ɾ t̪ iː
सगाई	s ə ɡ ɑː iː
ठेठ	ʈʰ eː ʈʰ
अध्यादेश	ə d̪ ʱ j ɑː d̪ eː ʃ
कमज़ोर	k ə m z oː ɾ
कोतवाल	k oː t̪ ʋ ɑː l
मुरदाबाद	m ʊ ɾ d̪ ɑː b ɑː d̪
घेरा	ɡ ʱ eː ɾ ɑː
छाँव	t͡ʃʰ ɑ̃ː ʋ
पनीर	p ə n iː ɾ
अंगारा	ə ŋ ɡ ɑː ɾ ɑː
दाल	d̪ ɑː l
लगाना	l ə ɡ ɑː n ɑː
घड़ियाल	ɡ ʱ ə ɽ iː j ɑː l
शिनकानसेन	ʃ ɪ n k ɑː n s eː n
वादा	ʋ ɑː d̪ ɑː
दूरदर्शिता	d̪ uː ɾ d̪ ə ɾ ʃ ɪ t̪ ɑː
तेज	t̪ eː d͡ʒ
लीद	l iː d̪
सर्वप्रथम	s ə ɾ ʋ p ɾ ə t̪ʰ ə m
जज़्बात	d͡ʒ ə z b ɑː t̪
सम्मिश्रण	s ə m m ɪ ʃ ɾ ə n
कद्दू	k ə d̪ d̪ uː
सहमति	s ɛː ʱ m ə t̪ iː
अफ़लातून	ə f l ɑː t̪ uː n
सिफ़ारिश	s ɪ f ɑː ɾ ɪ ʃ
लथपथ	l ə t̪ʰ p ə t̪ʰ
सुधार	s ʊ d̪ ʱ ɑː ɾ
फ़ाश	f ɑː ʃ
बहुव्रीहि	b ə ɦ ʊ ʋ ɾ iː ɦ iː
पर्व	p ə ɾ ʋ
विषयासक्त	ʋ ɪ ʃ ə j ɑː s ə k t̪
जुआ	d͡ʒ ʊ ɑː
सहारा	s ə ɦ ɑː ɾ ɑː
मूँगफली	m uː ŋ ɡ pʰ ə l iː
शीत	ʃ iː t̪
बर्फ़ीला	b ə ɾ f iː l ɑː
संवाददाता	s ə m ʋ ɑː d̪ d̪ ɑː t̪ ɑː
देखभाल	d̪ eː kʰ b ʱ ɑː l
हितकार	ɦ ɪ t̪ k ɑː ɾ
बावन	b ɑː ʋ ə n
ब्रज	b ɾ ə d͡ʒ
स्पैनिश	s p ɛː n ɪ ʃ
बनाना	b ə n ɑː n ɑː
तकल्लुफ़	t̪ ə k ə l l ʊ f
चौड़ाई	t͡ʃ ɔː ɽ ɑː iː
लेखाकार	l eː kʰ ɑː k ɑː ɾ
गलसुआ	ɡ ə l s ʊ ɑː
निरंतर	n ɪ ɾ ə n t̪ ə ɾ
भूमंडल	b ʱ uː m ə n ɖ ə l
तपस्वी	t̪ ə p ə s ʋ iː
दिल्लीवाला	d̪ ɪ l l iː ʋ ɑː l ɑː
कार्यशाला	k ɑː ɾ j ə ʃ ɑː l ɑː
दुहाई	d̪ ʊ ɦ ɑː iː
गाँधी	ɡ ɑ̃ː d̪ ʱ iː
शारजाह	ʃ ɑː ɾ d͡ʒ ɑː ʱ
प्रदर्शित	p ɾ ə d̪ ə ɾ ʃ ɪ t̪
घोलना	ɡ ʱ oː l n ɑː
अस्थायी	ə s t̪ʰ ɑː j iː
आदमी	ɑː d̪ m iː
जातिवाद	d͡ʒ ɑː t̪ iː ʋ ɑː d̪
दामन	d̪ ɑː m ə n
सुविख्यात	s ʊ ʋ ɪ kʰ j ɑː t̪
नम्रता	n ə m ɾ ə t̪ ɑː
छली	t͡ʃʰ ə l iː
समोसा	s ə m oː s ɑː
पेशाब	p eː ʃ ɑː b
मेंडक	m eː n ɖ ə k
सोग	s oː ɡ
खंडहर	kʰ ə n ɖ ʱ ə ɾ
हिंद	ɦ ɪ n d̪
कटार	k ə ʈ ɑː ɾ
प्लीज़	p l iː z
महमूद	m ɛː ʱ m uː d̪
गई	ɡ ə iː
अपयश	ə p j ə ʃ
पीतल	p iː t̪ ə l
अहंकार	eː ɦ eː ŋ k ɑː ɾ
फुलझड़ी	pʰ ʊ l d͡ʒ ʱ ə ɽ iː
निखरना	n ɪ kʰ ə ɾ n ɑː
कदाचित्	k ə d̪ ɑː t͡ʃ ɪ t̪
पाचन	p ɑː t͡ʃ ə n
अंगोछा	ə ŋ ɡ oː t͡ʃʰ ɑː
कोटवाल	k oː ʈ ʋ ɑː l
त्रासद	t̪ ɾ ɑː s ə d̪
हौसला	ɦ ɔː s l ɑː
आगज़नी	aː ɡ z ə n iː
लिखनेवाली	l ɪ kʰ n eː ʋ ɑː l iː
थोक	t̪ʰ oː k
हैक्टर	ɦ ɛː k ʈ ɛː ɾ
सौराष्ट्र	s ɔː ɾ ɑː ʃ ʈ ɾ
लिखनेवाला	l ɪ kʰ n eː ʋ ɑː l ɑː
जो	d͡ʒ oː
सपूत	s ə p uː t̪
चरबी	t͡ʃ ə ɾ b iː
चौकीदार	t͡ʃ ɔː k iː d̪ ɑː ɾ
कुबेर	k ʊ b eː ɾ
कुरूपता	k ʊ ɾ uː p t̪ ɑː
भीमसरट	b ʱ iː m s ə ɾ ə ʈ
स्कॉट्स	s k ɔː ʈ s
ईंधन	iː n d̪ ʱ ə n
भोर	b ʱ oː ɾ
अन्दर	ə n d̪ ə ɾ
ज़िंदाबाद	z ɪ n d̪ ɑː b ɑː d̪
खटमल	kʰ ə ʈ m ə l
मैंने	m ɛ̃ː n eː
सुईदाब	s ʊ iː d̪ ɑː b
अर्थशास्त्री	ə ɾ t̪ʰ ə ʃ ɑː s t̪ ɾ iː
ठहराव	ʈʰ ɛː ʱ ɾ ɑː ʋ
मेष	m eː ʃ
बेलना	b eː l n ɑː
इलाहाबाद	ɪ l ɑː ɦ ɑː b ɑː d̪
आँसू	ɑ̃ː s uː
डार्विन	ɖ ɑː ɾ ʋ ɪ n
बहत्तर	b ɛː ʱ t̪ t̪ ə ɾ
उपेक्षा	ʊ p eː k ʃ ɑː
धारित	d̪ ʱ ɑː ɾ ɪ t̪
द्रुतगामी	d̪ ɾ ʊ t̪ ɡ ɑː m iː
श्रुति	ʃ ɾ ʊ t̪ iː
अपरिपक्व	ə p ɾ ɪ p ə k ʋ
लौहपथगामिनीसूचकदर्शकहरितताम्रलौहपट्टिका	l ɔː ʱ p ə t̪ʰ ɡ ɑː m ɪ n iː s uː t͡ʃ ə k d̪ ə ɾ ʃ ə kʰ ə ɾ ɪ t̪ t̪ ɑː m ɾ ə l ɔː ʱ p ə ʈ ʈ ɪ k ɑː
ब्याज	b j ɑː d͡ʒ
जैसा	d͡ʒ ɛː s ɑː
दहेज़	d̪ ə ɦ eː z
कुटिया	k ʊ ʈ iː j ɑː
अपूर्व	ə p uː ɾ ʋ ə
उपहार	ʊ pʰ ɑː ɾ
माटी	m ɑː ʈ iː
गला	ɡ ə l ɑː
कुसल	k ʊ s ə l
उस्ताद	ʊ s t̪ ɑː d̪
अगवानी	ə ɡ ʋ ɑː n iː
रेतना	ɾ eː t̪ n ɑː
अन्यायी	ə n j ɑː j iː
सख्खर	s ə kʰ kʰ ə ɾ
इकत्तीस	ɪ k ə t̪ t̪ iː s
ताँबा	t̪ ɑ̃ː b ɑː
तालु	t̪ ɑː l uː
अंग्रेज़	ə ŋ ɡ ɾ eː z
निस्संदेह	n ɪ s s ə n d̪ eː ʱ
कपूर	k ə p uː ɾ
भाँग	b ʱ ɑː ŋ ɡ
मृदु	m ɾ ɪ d̪ uː
अनिवार्य	ə n ɪ ʋ ɑː ɾ j
अट्ठानवे	ə ʈ ʈʰ ɑː n ʋ eː
लोमड़ी	l oː m ɽ iː
चौंसठ	t͡ʃ ɔː n s ə ʈʰ
संदिग्ध	s ə n d̪ ɪ ɡ d̪ ʱ
करौंदा	k ə ɾ ɔː n d̪ ɑː
प्रिंस	p ɾ ɪ n s
रोशनी	ɾ oː ʃ n iː
बेर	b eː ɾ
वृद्धावस्था	ʋ ɾ ɪ d̪ d̪ ʱ ɑː ʋ ə s t̪ʰ ɑː
कदापि	k ə d̪ ɑː p iː
ब्यूरो	b j uː ɾ oː
अभिव्यक्ति	ə b ʱ ɪ ʋ j ə k t̪ iː
दोआब	d̪ oː ɑː b
टीस	ʈ iː s
अहिवाद	ə ɦ ɪ ʋ ɑː d̪
सलाह	s ə l ɑː ʱ
अराजकवादी	ə ɾ ɑː d͡ʒ ə k ʋ ɑː d̪ iː
आतमीयता	ɑː t̪ m iː j ə t̪ ɑː
इंस्पेक्टर	ɪ n s p eː k ʈ ə ɾ
भुज	b ʱ ʊ d͡ʒ
खंभा	kʰ ə m b ʱ ɑː
अहबाब	ɛː ʱ b ɑː b
सिलसिला	s ɪ l s ɪ l ɑː
रोमांचक	ɾ oː m ɑː ɲ t͡ʃ ə k
धनिया	d̪ ʱ ə n iː j ɑː
गुवाहाटी	ɡ ʊ ʋ ɑː ɦ ɑː ʈ iː
बेशक	b eː ʃ ə k
ठहराना	ʈʰ ɛː ʱ ɾ ɑː n ɑː
उर्दू	ʊ ɾ d̪ uː
पाजामा	p a d͡ʒ a m a
कतराना	k ə t̪ ɾ ɑː n ɑː
धारा	d̪ ʱ ɑː ɾ ɑː
रंडी	ɾ ə n ɖ iː
जोत	d͡ʒ oː t̪
दारचीनी	d̪ ɑː ɾ t͡ʃ iː n iː
स्वर्ग	s ʋ ə ɾ ɡ
एकाध	eː k ɑː d̪ ʱ
दूधिया	d̪ uː d̪ ʱ ɪ j ɑː
भागा	b ʱ ɑː ɡ ɑː
कौड़ी	k ɔː ɽ iː
नर्स	n ə ɾ s
न्यायिक	n j ɑː j ɪ k
कूत	k uː t̪
मोर्चा	m oː ɾ t͡ʃ ɑː
आव्यूह	ɑː ʋ j uː ʱ
टिकाऊ	ʈ ɪ k ɑː uː
म्लेच्छ	m l eː t͡ʃ t͡ʃʰ
भेलपूरी	b ʱ eː l p uː ɾ iː
अँगिया	ə̃ ɡ iː j ɑː
कनपेड़	k ə n p eː ɽ
लताड़ना	l ə t̪ ɑː ɽ n ɑː
नज़रिया	n ə z ə ɾ iː j ɑː
संहिता	s ə n ɦ ɪ t̪ ɑː
नरेश	n ə ɾ eː ʃ
रगड़ना	ɾ ə ɡ ə ɽ n ɑː
प्रसन्नता	p ɾ ə s ə n n t̪ ɑː
तिकड़म	t̪ ɪ k ɽ ə m
पश्चात्	p ə ʃ t͡ʃ ɑː t̪
सद्भावना	s ə d̪ b ʱ ɑː ʋ n ɑː
दादी	d̪ ɑː d̪ iː
अपमानजनक	ə p m ɑː n d͡ʒ ə n ə k
कान्हा	k ɑː n ɦ ɑː
रबड़	ɾ ə b ə ɽ
अंजाम	ə ɲ d͡ʒ ɑː m
मँगेतर	m ə ŋ ɡ eː t̪ ə ɾ
डुबोना	ɖ ʊ b oː n ɑː
धोना	d̪ ʱ oː n̪ ɑː
मेल	m eː l
आवृत्ति	ɑː ʋ ɾ ɪ t̪ t̪ iː
जोश	d͡ʒ oː ʃ
कूलॉम	k uː l ɔː m
बिल्कुल	b ɪ l k ʊ l
वेदांत	ʋ eː d̪ ɑː n t̪
भैंस	b ʱ ɛ̃ː s
मक्खनफल	m ə k kʰ ə n pʰ ə l
दाँव	d̪ ɑ̃ː ʋ
अक्टूबर	ə k ʈ uː b ə ɾ
चांदी	t͡ʃ ɑː n d̪ iː
आफ़्रीदी	ɑː f ɾ iː d̪ iː
युग	j ʊ ɡ
जमीन	d͡ʒ ə m iː n
मार्केट	m ɑː ɾ k eː ʈ
सेब	s eː b
अनाज	ə n ɑː d͡ʒ
खजूर	kʰ ə d͡ʒ uː ɾ
इंतज़ार	ɪ n t̪ ə z ɑː ɾ
यूहन्ना	j uː ɦ ə n n ɑː
बुलाना	b ʊ l ɑː n ɑː
वहीं	ʋ ə ɦ ĩː
अहाता	ə ɦ ɑː t̪ ɑː
सुनवाई	s ʊ n ʋ ɑː iː
रजिस्टर	ɾ ə d͡ʒ ɪ s ʈ ə ɾ
युद्धप्रिय	j ʊ d̪ d̪ ʱ p ɾ ɪ j
तक्षशिला	t̪ ə k ʃ ə ʃ ɪ l ɑː
शुल्क	ʃ ʊ l k
लवण	l ə ʋ ə n
दहला	d̪ ɛː ʱ l ɑː
नवाब	n ə ʋ ɑː b
विस्थापन	ʋ ɪ s t̪ʰ ɑː p ə n
अपेक्षित	ə p eː k ʃ ɪ t̪
फेंक	pʰ eː ŋ k
गतिज	ɡ ə t̪ ɪ d͡ʒ
मेहरबानी	m ɛː ʱ ɾ b ɑː n iː
अरसा	ə ɾ s ɑː
समर्थक	s ə m ə ɾ t̪ʰ ə k
दौड़	d̪ ɔː ɽ
रूढ़िवाद	ɾ uː ɽ ʱ ɪ ʋ ɑː d̪
अनुनासिक	ə n ʊ n ɑː s ɪ k
जीरा	d͡ʒ iː ɾ ɑː
गांजा	ɡ ãː n̪ d ʒ aː
वंटन	ʋ ə n ʈ ə n
आवक	ɑː ʋ ə k
सांप्रदायिकता	s ɑː m p ɾ ə d̪ ɑː j ɪ k t̪ ɑː
आमुख	ɑː m ʊ kʰ
सम्मिलित	s ə m m ɪ l ɪ t̪
बाबू	b ɑː b uː
दूध	d̪ uː d̪ ʱ
आँच	ɑ̃ː t͡ʃ
पीएम	p iː eː m
आप	aː p
असुंदर	ə s ʊ n d̪ ə ɾ
कटाई	k ə ʈ ɑː iː
हीटर	ɦ iː ʈ ə ɾ
तैंतीस	t̪ ɛː n t̪ iː s
मिज़ाज	m ɪ z ɑː d͡ʒ
उन्यासी	ʊ n j ɑː s iː
सरफ़रोश	s ə ɾ f ə ɾ oː ʃ
उलटा	ʊ l ʈ ɑː
चौहत्तर	t͡ʃ ɔː ɦ ə t̪ t̪ ə ɾ
यमुना	j ə m ʊ n ɑː
क्षमा	k ʃ ə m ɑː
शू	ʃ uː
शिमला	ʃ ɪ m l ɑː
शान्ति	ʃ ɑː n t̪ iː
युद्धक	j ʊ d̪ d̪ ʱ ə k
कोदो	k oː d̪ oː
चंद्रमा	t͡ʃ ə n d̪ ɾ ə m ɑː
माँदा	m ɑ̃ː d̪ ɑː
गज	ɡ ə d͡ʒ
छेदना	t͡ʃʰ eː d̪ n ɑː
कमाई	k ə m ɑː iː
झूठ	d͡ʒ ʱ uː ʈʰ
वृक्ष	ʋ ɾ ɪ k ʃ
तुर्क	t̪ ʊ ɾ k
शावक	ʃ ɑː ʋ ə k
चूची	t͡ʃ uː t͡ʃ iː
वनों	ʋ ə n õː
अध्यक्षता	ə d̪ ʱ j ə k ʃ t̪ ɑː
आश्रम	ɑː ʃ ɾ ə m
कीमिया	k iː m iː j ɑː
गुनाह	ɡ ʊ n ɑː ʱ
धान	d̪ ʱ ɑː n
हैती	ɦ ɛː t̪ iː
सुप्रभात	s ʊ p ɾ ə b ʱ ɑː t̪
मिल	m ɪ l
यंत्रीकृत	j ə n t̪ ɾ iː k ɾ ɪ t̪
झील	d͡ʒ ʱ iː l
भाजपा	b ʱ ɑː d͡ʒ p ɑː
कोण	k oː n
गृहमंत्री	ɡ ɾ ɪ ʱ m ə n t̪ ɾ iː
पिरिच	p ɪ ɾ ɪ t͡ʃ
दूकान	d̪ uː k ɑː n
उदजन	ʊ d̪ d͡ʒ ə n
टेढ़ापन	ʈ eː ɽ ʱ ɑː p ə n
मेंढक	m eː n ɖ ʱ ə k
लौआ	l ɔː ɑː
पूँछ	p ũː t͡ʃʰ
आर्मेनियन	ɑː ɾ m eː n iː j ə n
मास	m ɑː s
मठ	m ə ʈʰ
जौ	d͡ʒ ɔː
पादप	p ɑː d̪ ə p
भारोत्तोलन	b ʱ ɑː ɾ oː t̪ t̪ oː l ə n
सत्यापन	s ə t̪ j ɑː p ə n
नामक	n ɑː m ə k
चौबीस	t͡ʃ ɔː b iː s
कविता	k ə ʋ ɪ t̪ ɑː
वैराग्य	ʋ ɛː ɾ ɑː ɡ j
पटरी	p ə ʈ ɾ iː
हड़बड़ी	ɦ ə ɽ b ə ɽ iː
अनुष्ठान	ə n ʊ ʃ ʈʰ ɑː n
मसीहा	m ə s iː ɦ ɑː
असैनिक	ə s ɛː n ɪ k
निंदा	n ɪ n d̪ ɑː
उदासी	ʊ d̪ ɑː s iː
सलाउद्दीन	s ə l ɑː ʊ d̪ d̪ iː n
प्रण	p ɾ ə n
अच्छा	ə t͡ʃ t͡ʃʰ ɑː
पछताना	p ə t͡ʃʰ t̪ ɑː n ɑː
ब्रिटिश	b ɾ ɪ ʈ ɪ ʃ
आई	ɑː iː
नाल	n ɑː l
पेप्सी	p eː p s iː
हंगुल	ɦ ə ŋ ɡ ʊ l
बुलबुला	b ʊ l b ʊ l ɑː
दूरबीन	d̪ uː ɾ b iː n
डोनट	ɖ oː n ə ʈ
समालोचना	s ə m ɑː l oː t͡ʃ n ɑː
हँसी	ɦ ə̃ s iː
अभाव	ə b ʱ ɑː ʋ
सहबद्ध	s ɛː ʱ b ə d̪ d̪ ʱ
क्रमबद्ध	k ɾ ə m b ə d̪ d̪ ʱ
मिलीभगत	m ɪ l iː b ʱ ə ɡ ə t̪
बढ़ावा	b ə ɽ ʱ ɑː ʋ ɑː
तर्क	t̪ ə ɾ k
एंड्रॉइड	eː n ɖ ɾ ɔː ɪ ɖ
सिलवाना	s ɪ l ʋ ɑː n ɑː
रोज़ाना	ɾ oː z ɑː n ɑː
पतला	p ə t̪ l ɑː
गाजर	ɡ ɑː d͡ʒ ə ɾ
मुंसिफ़ाना	m ʊ n s ɪ f ɑː n ɑː
सूआ	s uː ɑː
त्वरण	t̪ ʋ ə ɾ ə n
बुर्जुआ	b ʊ ɾ d͡ʒ ʊ ɑː
लालायित	l ɑː l ɑː j ɪ t̪
सकत	s ə k ə t̪
लिंगानुपात	l ɪ ŋ ɡ ɑː n ʊ p ɑː t̪
दरमियानी	d̪ ə ɾ m iː j ɑː n iː
सन्	s ə n
व्यास	ʋ j ɑː s
आवेदन	ɑː ʋ eː d̪ ə n
आकर्षण	ɑː k ə ɾ ʃ ə n
बालपन	b ɑː l p ə n
मोंटेनीगरो	m oː n ʈ eː n iː ɡ ɾ oː
माजूफल	m ɑː d͡ʒ uː pʰ ə l
अवतल	ə ʋ t̪ ə l
चोंच	t͡ʃ oː ɲ t͡ʃ
शरीफ़	ʃ ə ɾ iː f
नव्वे	n ə ʋ ʋ eː
सर्दी	s ə ɾ d̪ iː
डेरा	ɖ eː ɾ ɑː
मज़लूम	m ə z l uː m
कुशल	k ʊ ʃ ə l
सर्विस	s ə ɾ ʋ ɪ s
एहतजाज	eː ʱ t̪ ə d͡ʒ ɑː d͡ʒ
सर	s ə ɾ
केपटाउन	k eː p ʈ ɑː ʊ n
पौराणिक	p ɔː ɾ ɑː n ɪ k
कंकड़	k ə ŋ k ə ɽ
फ़ैज़ाबाद	f ɛː z ɑː b ɑː d̪
हथियारबंद	ɦ ə t̪ʰ iː j ɑː ɾ b ə n d̪
कासा	k ɑː s ɑː
मुक्तिवादी	m ʊ k t̪ ɪ ʋ ɑː d̪ iː
अधीरता	ə d̪ ʱ iː ɾ t̪ ɑː
छन	t͡ʃʰ ə n
उपाधि	ʊ p ɑː d̪ ʱ iː
नायब	n ɑː j ə b
सिंहासन	s ɪ ŋ ɡ ʱ ɑː s ə n
कुख्यात	k ʊ kʰ j ɑː t̪
बहिर्वेशन	b ə ɦ ɪ ɾ ʋ eː ʃ ə n
निनानवे	n ɪ n ɑː n ʋ eː
साक्षात्कार	s ɑː k ʃ ɑː t̪ k ɑː ɾ
जलजनित	d͡ʒ ə l d͡ʒ ə n ɪ t̪
बोट	b oː ʈ
अंतड़ी	ə n t̪ ɽ iː
प्रतीकात्मक	p ɾ ə t̪ iː k ɑː t̪ m ə k
त्रिज्या	t̪ ɾ ɪ d͡ʒ j ɑː
एकतरफ़ा	eː k t̪ ə ɾ f ɑː
अगला	ə ɡ l ɑː
स्पष्टतः	s p ə ʃ ʈ ə t̪ əʰ
निखारना	n ɪ kʰ ɑː ɾ n ɑː
जल्द	d͡ʒ ə l d̪
पाथना	p ɑː t̪ʰ n ɑː
प्रश्नोत्तर	p ɾ ə ʃ n oː t̪ t̪ ə ɾ
दोष	d̪ oː ʃ
लड़ना	l ə ɽ n ɑː
पछाड़ना	p ə t͡ʃʰ ɑː ɽ n ɑː
पेचकस	p eː t͡ʃ k ə s
बाज़ीचा	b ɑː z iː t͡ʃ ɑː
समय	s ə m ə j
जोधपुर	d͡ʒ oː d̪ ʱ p ʊ ɾ
कंधा	k ə n d̪ ʱ ɑː
संकलक	s ə ŋ k ə l ə k
खाई	kʰ ɑː iː
फ़ौजी	f ɔː d͡ʒ iː
सो	s oː
बचाना	b ə t͡ʃ ɑː n ɑː
सरीसृप	s ə ɾ iː s ɾ ɪ p
पराठा	p ə ɾ ɑː ʈʰ ɑː
पखवाड़ा	p ə kʰ ʋ ɑː ɽ ɑː
अभिलाषा	ə b ʱ ɪ l ɑː ʃ ɑː
ना	n ɑː
पूर्वकथन	p uː ɾ ʋ ə k t̪ʰ ə n
कनाडा	k ə n ɑː ɖ ɑː
धर्मस्थल	d̪ ʱ ə ɾ m s t̪ʰ ə l
लागत	l ɑː ɡ ə t̪
बीवी	b iː ʋ iː
सैलाब	s ɛː l ɑː b
पधारना	p ə d̪ ʱ ɑː ɾ n ɑː
पट्टा	p ə ʈ ʈ ɑː
रणनीतिक	ɾ ə n n iː t̪ ɪ k
यूक्रेन	j uː k ɾ eː n
बैसाखी	b ɛː s ɑː kʰ iː
तर्ज़	t̪ ə ɾ z
थाईलैंड	t̪ʰ ɑː iː l ɛː n ɖ
मलाई	m ə l ɑː iː
जिमीकंद	d͡ʒ ɪ m iː k ə n d̪
चित्र	t͡ʃ ɪ t̪ ɾ
चौताल	t͡ʃ ɔː t̪ ɑː l
शुक्राणु	ʃ ʊ k ɾ ɑː n uː
थोपना	t̪ʰ oː p n ɑː
घबराहट	ɡ ʱ ə b ɾ ɑː ɦ ə ʈ
स्त्रीत्व	s t̪ ɾ iː t̪ ʋ ə
फ़ीलपाँव	f iː l p ɑ̃ː ʋ
जिज्ञासा	d͡ʒ ɪ ɡ j ɑː s ɑː
स्वामित्व	s ʋ ɑː m ɪ t̪ ʋ
इंजीनियरी	ɪ ɲ d͡ʒ iː n iː j ə ɾ iː
कैंडी	k ɛː n ɖ iː
जीतना	d͡ʒ iː t̪ n ɑː
परिपाटी	p ə ɾ ɪ p ɑː ʈ iː
ट्यूनिशिया	ʈ j uː n ɪ ʃ iː j ɑː
गिरगिट	ɡ ɪ ɾ ɡ ɪ ʈ
ऊदबिलाव	uː d̪ b ɪ l ɑː ʋ
इस्तीफ़ा	ɪ s t̪ iː f ɑː
विनती	ʋ ɪ n t̪ iː
बहलाना	b ɛː ʱ l ɑː n ɑː
ओछा	oː t͡ʃʰ ɑː
पशु	p ə ʃ uː
ऋणदाता	ɾ ɪ n d̪ ɑː t̪ ɑː
भ्रष्टाचार	b ʱ ɾ ə ʃ ʈ ɑː t͡ʃ ɑː ɾ
रैनबसेरा	ɾ ɛː n b ə s eː ɾ ɑː
पुराण	p ʊ ɾ ɑː n
उन्हें	ʊ n ɦ ẽ
अनुस्वार	ə n ʊ s ʋ ɑː ɾ
पाटन	p ɑː ʈ ə n
बयालीस	b ə j ɑː l iː s
बाँस	b ɑ̃ː s
मेहनत	m eː ʱ n ə t̪
बंबई	b ə m b ə iː
परछाईं	p ə ɾ t͡ʃʰ ɑː ĩː
शृंखला	ʃ ɾ ɪ ŋ kʰ l ɑː
लौंडा	l ɔː n ɖ ɑː
पंचशील	p ə ɲ t͡ʃ ʃ iː l
साज़िश	s ɑː z ɪ ʃ
संबोधित	s ə m b oː d̪ ʱ ɪ t̪
पलक	p ə l ə k
शक्य	ʃ ə k j
पलटवार	p ə l ə ʈ ʋ ɑː ɾ
प्रधानाचार्य	p ɾ ə d̪ ʱ ɑː n ɑː t͡ʃ ɑː ɾ j
पताका	p ə t̪ ɑː k ɑː
बस्ता	b ə s t̪ ɑː
परे	p ə ɾ eː
चाव	t͡ʃ ɑː ʋ
वर्ण	ʋ ə ɾ n
विकिमीडिया	ʋ ɪ k ɪ m iː ɖ iː j ɑː
गैंडा	ɡ ɛː n ɖ ɑː
अपरिचित	ə p ə ɾ ɪ t͡ʃ ɪ t̪
बड़बड़ाना	b ə ɽ b ə ɽ ɑː n ɑː
कछारी	k ə t͡ʃʰ ɑː ɾ iː
भर	b ʱ ə ɾ
निस्सार	n ɪ s s ɑː ɾ
आक्रामक	ɑː k ɾ ɑː m ə k
मटका	m ə ʈ k ɑː
टिकना	ʈ ɪ k n ɑː
हिमस्खलन	ɦ ɪ m s kʰ ə l ə n
गरेबान	ɡ ə ɾ eː b ɑː n
इजाज़त	ɪ d͡ʒ ɑː z ə t̪
जून	d͡ʒ uː n
उफ़	ʊ f
खेद	kʰ eː d̪
मूलतः	m uː l t̪ əʰ
लाभदायक	l ɑː b ʱ d̪ ɑː j ə k
चढ़ाई	t͡ʃ ə ɽ ʱ ɑː iː
ईर्ष्या	iː ɾ ʃ j ɑː
हैज़ा	ɦ ɛː z ɑː
धुलना	d̪ ʱ ʊ l n ɑː
इकनाली	ɪ k n ɑː l iː
स्नातकोत्तर	s n ɑː t̪ ə k oː t̪ t̪ ə ɾ
पपनी	p ə p n iː
अस्पृश्य	ə s p ɾ ɪ ʃ j ə
आस	ɑː s
कटहल	k ə ʈʰ ə l
अप्रकाशित	ə p ɾ ə k ɑː ʃ ɪ t̪
गाँडू	ɡ ɑ̃ː ɖ uː
सीनेट	s iː n eː ʈ
कामोन्माद	k aː m o n̪ m aː d̪
ग्वाला	ɡ ʋ ɑː l ɑː
विरोध	ʋ ɪ ɾ oː d̪ ʱ
बवाल	b ə ʋ ɑː l
लिस्ट	l ɪ s ʈ
चश्मा	t͡ʃ ə ʃ m ɑː
क्षेत्रीय	k ʃ eː t̪ ɾ iː j
प्राप्ति	p ɾ ɑː p t̪ iː
खादी	kʰ ɑː d̪ iː
अनुपात	ə n ʊ p ɑː t̪
अक्स	ə k s
फिटकरी	pʰ ɪ ʈ k ə ɾ iː
जर्जर	d͡ʒ ə ɾ d͡ʒ ə ɾ
घुटना	ɡ ʱ ʊ ʈ n ɑː
इज़हार	ɪ z ɦ ɑː ɾ
वियतनाम	ʋ iː j ə t̪ n ɑː m
छुपना	t͡ʃʰ ʊ p n ɑː
अति	ə t̪ iː
यांत्रिक	j ɑː n t̪ ɾ ɪ k
भगवा	b ʱ ə ɡ ʋ ɑː
लब	l ə b
अजगर	ə d͡ʒ ɡ ə ɾ
तीर	t̪ iː ɾ
जिन	d͡ʒ ɪ n
सर्किल	s ə ɾ k ɪ l
उंगली	ʊ ŋ ɡ l iː
ग्राहक	ɡ ɾ ɑː ɦ ə k
उन्मूलन	ʊ n m uː l ə n
मेवा	m eː ʋ ɑː
बर्मिंघम	b ə ɾ m ɪ ŋ ɡ ʱ ə m
छियासी	t͡ʃʰ iː j ɑː s iː
ईसाई	iː s ɑː iː
व्यायाम	ʋ j ɑː j ɑː m
प्रतिस्पर्धा	p ɾ ə t̪ ɪ s p ə ɾ d̪ ʱ ɑː
सुकून	s ʊ k uː n
लड़की	l ə ɽ k iː
कार्यसमिति	k ɑː ɾ j s ə m ɪ t̪ iː
अंशतः	ə n ʃ t̪ əʰ
त्रिभुज	t̪ ɾ ɪ b ʱ ʊ d͡ʒ
पारसेक	p ɑː ɾ s eː k
प्रोस्टेट	p ɾ oː s ʈ eː ʈ
हस्तक्षेप	ɦ ə s t̪ ə k ʃ eː p
नेस्तनाबूद	n eː s t̪ ə n ɑː b uː d̪
धरोहर	d̪ ʱ ə ɾ oː ɦ ə ɾ
अक्खा	ə k kʰ ɑː
आलपीन	ɑː l p iː n
प्रकांड	p ɾ ə k ɑː n ɖ
गोंद	ɡ oː n d̪
इमारत	ɪ m ɑː ɾ ə t̪
युद्ध	j ʊ d̪ d̪ ʱ
सुबोध	s ʊ b oː d̪ ʱ
बारहखड़ी	b ɑː ɾ ɛː ʱ kʰ ə ɽ iː
ऊब	uː b
निराहार	n ɪ ɾ ɑː ɦ ɑː ɾ
इससे	ɪ s s eː
झमेला	d͡ʒ ʱ ə m eː l ɑː
हताशा	ɦ ə t̪ ɑː ʃ ɑː
पीला	p iː l ɑː
पौधा	p ɔː d̪ ʱ ɑː
पसली	p ə s l iː
कुंजी	k ʊ ɲ d͡ʒ iː
यिर्मियाह	j ɪ ɾ m i j a ɦ
घना	ɡ ʱ ə n ɑː
शरणार्थी	ʃ ə ɾ n ɑː ɾ t̪ʰ iː
कम्बोडिया	k ə m b oː ɖ iː j ɑː
सहभागी	s ɛː ʱ b ʱ ɑː ɡ iː
सिर	s ɪ ɾ
फुसफुसाना	pʰ ʊ s pʰ ʊ s ɑː n ɑː
समर्पण	s ə m ə ɾ p ə n
अलापना	ə l ɑː p n ɑː
हिस्सेदारी	ɦ ɪ s s eː d̪ ɑː ɾ iː
सदाबहार	s ə d̪ ɑː b ə ɦ ɑː ɾ
पिछड़ा	p ɪ t͡ʃʰ ɽ ɑː
ज़िक्र	z ɪ k ɾ
काँख	k ɑ̃ː kʰ
नी	n iː
चंद्रग्रहण	t͡ʃ ə n d̪ ɾ ə ɡ ɾ ɛː ʱ n
अंटार्कटिका	ə n ʈ ɑː ɾ k ʈ ɪ k ɑː
सर्वोच्च	s ə ɾ ʋ oː t͡ʃ t͡ʃ
हीन	ɦ iː n
ताकि	t̪ ɑː k iː
पिंजड़ा	p ɪ ɲ d͡ʒ ɽ ɑː
पाठ्यपुस्तक	p ɑː ʈʰ j ə p ʊ s t̪ ə k
सरकार	s ə ɾ k ɑː ɾ
क्योटो	k j oː ʈ oː
छोरी	t͡ʃʰ oː ɾ iː
पीना	p iː n̪ ɑː
प्याऊ	p j ɑː uː
उपजना	ʊ p ə d͡ʒ n ɑː
शलभ	ʃ ə l ə b ʱ
ऊनी	uː n iː
रसना	ɾ ə s n ɑː
पाशा	p ɑː ʃ ɑː
मतलब	m ə t̪ l ə b
चीन	t͡ʃ iː n
अलबम	ə l b ə m
वाष्पीकरण	ʋ ɑː ʃ p iː k ə ɾ ə n
बाज़ू	b ɑː z uː
नारीत्व	n ɑː ɾ iː t̪ ʋ
बाटना	b ɑː ʈ n ɑː
ईश	iː ʃ
स्मार्टफ़ोन	s m ɑː ɾ ʈ f oː n
मूँग	m ũː ɡ
मनोविदलता	m ə n oː ʋ ɪ d̪ ə l t̪ ɑː
उत्पादन	ʊ t̪ p ɑː d̪ ə n
मटर	m ə ʈ ə ɾ
नशा	n ə ʃ ɑː
अतिशयोक्ति	ə t̪ ɪ ʃ j oː k t̪ iː
जस्ता	d͡ʒ ə s t̪ ɑː
प्रबंधक	p ɾ ə b ə n d̪ ʱ ə k
भांग	b ʱ ɑː ŋ ɡ
सचित्र	s ə t͡ʃ ɪ t̪ ɾ
पंखा	p ə ŋ kʰ ɑː
बाँह	b ɑ̃ː ʱ
ठेला	ʈʰ eː l ɑː
इलेक्ट्रॉन	ɪ l eː k ʈ ɾ ɔː n
लोचा	l oː t͡ʃ ɑː
सूचक	s uː t͡ʃ ə k
टपोरी	ʈ ə p oː ɾ iː
नहाना	n ə ɦ ɑː n ɑː
पंक्ति	p ə ŋ k t̪ iː
अग्निशस्त्र	ə ɡ n iː ʃ ə s t̪ ɾ
सप्तक	s ə p t̪ ə k
संतोषी	s ə n t̪ oː ʃ iː
चोखा	t͡ʃ oː kʰ ɑː
जाल	d͡ʒ ɑː l
स्वस्तिक	s ʋ ə s t̪ ɪ k
अर्ध	ə ɾ d̪ ʱ
अयोध्या	ə j oː d̪ ʱ j ɑː
छर्रा	t͡ʃʰ ə ɾ ɾ ɑː
गत	ɡ ə t̪
मंसब	m ə n s ə b
नैन	n ɛː n
संरक्षणवाद	s ə n ɾ ə k ʃ ə n ʋ ɑː d̪
इरादा	ɪ ɾ ɑː d̪ ɑː
तृष्णा	t̪ ɾ ɪ ʃ n ɑː
आंगन	ɑː ŋ ɡ ə n
अदाकार	ə d̪ ɑː k ɑː ɾ
शादी	ʃ ɑː d̪ iː
क्षण	k ʃ ə n
अमानत	ə m ɑː n ə t̪
ज़र्रा	z ə ɾ ɾ ɑː
अजेंडा	ə d͡ʒ eː n ɖ ɑː
सृष्टि	s ɾ ɪ ʃ ʈ iː
बचना	b ə t͡ʃ n ɑː
ज़लज़ला	z ə l z ə l ɑː
धनुर्विद्या	d̪ ʱ ə n ʊ ɾ ʋ ɪ d̪ j ɑː
अनुभवी	ə n ʊ b ʱ ə ʋ iː
बरामद	b ə ɾ ɑː m ə d̪
सरी	s ə ɾ iː
साँई	s ɑ̃ː iː
सुल्टाना	s ʊ l ʈ ɑː n ɑː
मान्यता	m ɑː n j ə t̪ ɑː
परवाज़	p ə ɾ ʋ ɑː z
पट्टी	p ə ʈ ʈ iː
दिव्यांग	d̪ ɪ ʋ j ɑː ŋ ɡ
द्रविड़	d̪ ɾ ə ʋ ɪ ɽ
अमल	ə m ə l
जकार्ता	d͡ʒ ə k ɑː ɾ t̪ ɑː
प्रचंड	p ɾ ə t͡ʃ ə n ɖ
ज़ात	z ɑː t̪
आज़र्बैजान	ɑː z ə ɾ b ɛː d͡ʒ ɑː n
ऐनिमे	ɛː n ɪ m eː
होनहार	ɦ oː n ɦ ɑː ɾ
झोंपड़ा	d͡ʒ ʱ oː m p ɽ ɑː
विडूर	ʋ ɪ ɖ uː ɾ
संपादकीय	s ə m p ɑː d̪ ə k iː j
ज़ाया	z ɑː j ɑː
आपबीती	ɑː p b iː t̪ iː
पहले	p ɛː ʱ l eː
टेढ़ा	ʈ eː ɽ ʱ ɑː
मुख्यधारा	m ʊ kʰ j ə d̪ ʱ ɑː ɾ ɑː
कूटनीति	k uː ʈ n iː t̪ iː
जिल्द	d͡ʒ ɪ l d̪
ढेर	ɖ ʱ eː ɾ
चरण	t͡ʃ ə ɾ ə n
मोती	m oː t̪ iː
भर्ती	b ʱ ə ɾ t̪ iː
टीम	ʈ iː m
आदाब	ɑː d̪ ɑː b
अर्ज़	ə ɾ z
राशिफल	ɾ ɑː ʃ ɪ pʰ ə l
दृढ़	d̪ ɾ ɪ ɽ ʱ
सार्थ	s ɑː ɾ t̪ʰ
मोमो	m oː m oː
अजिल्द	ə d͡ʒ ɪ l d̪
पार्क	p ɑː ɾ k
आर्मेनिया	ɑː ɾ m eː n iː j ɑː
सहज	s ɛ ɦ ɛ d͡ʒ
नागरिकता	n aː ɡ r i k ə t̪ aː
अनातोली	ə n ɑː t̪ oː l iː
मूतना	m uː t̪ n ɑː
विष्णु	ʋ ɪ ʃ n uː
कोलकाता	k oː l k ɑː t̪ ɑː
कोहेनूर	k oː ɦ eː n uː ɾ
लिंगायत	l ɪ ŋ ɡ ɑː j ə t̪
रुचिरा	ɾ ʊ t͡ʃ ɪ ɾ ɑː
आक्रामकता	ɑː k ɾ ɑː m ə k t̪ ɑː
श्रीलंका	ʃ ɾ iː l ə ŋ k ɑː
लोकसाहित्य	l oː k s ɑː ɦ ɪ t̪ j
लाख	l ɑː kʰ
प्रस्तुति	p ɾ ə s t̪ ʊ t̪ iː
साही	s ɑː ɦ iː
कहानी	k ə ɦ ɑː n iː
उपयोगी	ʊ p j oː ɡ iː
ध्यानपूर्वक	d̪ ʱ j ɑː n p uː ɾ ʋ ə k
स्थित	s t̪ʰ ɪ t̪
उजला	ʊ d͡ʒ l ɑː
मैसूर	m ɛː s uː ɾ
वृद्ध	ʋ ɾ ɪ d̪ d̪ ʱ
निरपेक्ष	n ɪ ɾ p eː k ʃ
मृत्यु	m ɾ ɪ t̪ j uː
सीमा	s iː m ɑː
सर्ब	s ə ɾ b
याचिका	j ɑː t͡ʃ ɪ k ɑː
स्वजन	s ʋ ə d͡ʒ ə n
जवार	d͡ʒ ə ʋ ɑː ɾ
झुर्रियाँ	d͡ʒ ʱ ʊ ɾ ɾ iː j ɑ̃ː
उपासक	ʊ p ɑː s ə k
भ्रूण	b ʱ ɾ uː n
मादरचोद	m ɑː d̪ ə ɾ t͡ʃ oː d̪
ऊफ़ा	uː f ɑː
चाभी	t͡ʃ ɑː b ʱ iː
मंज़िल	m ə n z ɪ l
शाही	ʃ ɑː ɦ iː
भूख	b ʱ uː kʰ
रे	ɾ eː
राँची	ɾ ɑ̃ː t͡ʃ iː
आर्थिकी	ɑː ɾ t̪ʰ ɪ k iː
दुर्भावना	d̪ ʊ ɾ b ʱ ɑː ʋ n ɑː
झड़प	d͡ʒ ʱ ə ɽ ə p
वितरण	ʋ ɪ t̪ ɾ ə n
असली	ə s l iː
कल्टी	k ə l ʈ iː
कृतज्ञ	k ɾ ɪ t̪ ə ɡ j
बोरियत	b oː ɾ iː j ə t̪
अधीर	ə d̪ ʱ iː ɾ
समेटना	s ə m eː ʈ n ɑː
लगान	l ə ɡ ɑː n
हँसिया	ɦ ə̃ s iː j ɑː
मोबिलिटी	m oː b ɪ l ɪ ʈ iː
जलज	d͡ʒ ə l ə d͡ʒ
शतक	ʃ ə t̪ ə k
रांची	ɾ ɑː ɲ t͡ʃ iː
क्रेता	k ɾ eː t̪ ɑː
पेन्सिलवेनिया	p eː n s ɪ l ʋ eː n iː j ɑː
खिलना	kʰ ɪ l n ɑː
नन्हा	n ə n ɦ ɑː
सफेद	s ə pʰ eː d̪
बहरीन	b ɛː ʱ ɾ iː n
बंदी	b ə n d̪ iː
डबलिन	ɖ ə b l ɪ n
गुरु	ɡ ʊ ɾ uː
असहयोग	ə s ə ʱ j oː ɡ
फ़िरौन	f ɪ ɾ ɔː n
रूबरू	ɾ uː b ɾ uː
बिजलीकरण	b ɪ d͡ʒ l iː k ə ɾ ə n
अंतर्गत	ə n t̪ ə ɾ ɡ ə t̪
अरदली	ə ɾ d̪ ə l iː
टोकरा	ʈ oː k ɾ ɑː
पौने	p ɔː n eː
कोथमीर	k oː t̪ʰ m iː ɾ
ऑक्सफ़ोर्ड	ɔː k s f oː ɾ ɖ
फ़ंतासी	f ə n t̪ ɑː s iː
बेटा	b eː ʈ ɑː
पूत	p uː t̪
नज्द	n ə d͡ʒ d̪
पोशाक	p oː ʃ ɑː k
अमिट	ə m ɪ ʈ
फ़रात	f ə ɾ ɑː t̪
आयत	ɑː j ə t̪
कोट	k oː ʈ
मेहमान	m eː ʱ m ɑː n
अलसाना	ə l s ɑː n ɑː
छायावाद	t͡ʃʰ ɑː j ɑː ʋ ɑː d̪
मधुमेह	m ə d̪ ʱ uː m eː ʱ
संप्रदाय	s ə m p ɾ ə d̪ ɑː j
स्थापत्य	s t̪ʰ ɑː p ə t̪ j
उत्तोलन	ʊ t̪ t̪ oː l ə n
पालक	p ɑː l ə k
सुखपूर्वक	s ʊ kʰ p uː ɾ ʋ ə k
हुम्मुस	ɦ ʊ m m ʊ s
प्याज	p j ɑː d͡ʒ
चाहत	t͡ʃ ɑː ɦ ə t̪
सूत	s uː t̪
पहरेदार	p ɛː ʱ ɾ eː d̪ ɑː ɾ
डेनमार्क	ɖ eː n m ɑː ɾ k
नाव	n ɑː ʋ
नर्मदा	n ə ɾ m ə d̪ ɑː
धकेलना	d̪ ʱ ə k eː l n ɑː
परिकलित्र	p ə ɾ ɪ k ə l ɪ t̪ ɾ
दीपक	d̪ iː p ə k
अम्माँ	ə m m ɑ̃ː
आण्विक	ɑː n ʋ ɪ k
थकावट	t̪ʰ ə k ɑː ʋ ə ʈ
ज़ेहन	z ɛː ʱ n
पक्का	p ə k k ɑː
वर्दीधारी	ʋ ə ɾ d̪ iː d̪ ʱ ɑː ɾ iː
पचाना	p ə t͡ʃ ɑː n ɑː
साहूकार	s ɑː ɦ uː k ɑː ɾ
बिरयानी	b ɪ ɾ j ɑː n iː
प्रतिमाह	p ɾ ə t̪ ɪ m ɑː ʱ
जातीय	d͡ʒ ɑː t̪ iː j
डाइनोसर	ɖ aː i n o s ə r
रंगरूट	ɾ ə ŋ ɡ ɾ uː ʈ
वर्णविपर्यास	ʋ ə ɾ n ə ʋ ɪ p ə ɾ j ɑː s
विभीषिका	ʋ ɪ b ʱ iː ʃ ɪ k ɑː
नस	n ə s
ऊपरी	uː p ɾ iː
डोर	ɖ oː ɾ
महायुद्ध	m ə ɦ ɑː j ʊ d̪ d̪ ʱ
शौकत	ʃ ɔː k ə t̪
फ़रमान	f ə ɾ m ɑː n
अविकारी	ə ʋ ɪ k ɑː ɾ iː
मूर्तिमान	m uː ɾ t̪ iː m ɑː n
आमवात	ɑː m ʋ ɑː t̪
ओहायो	oː ɦ ɑː j oː
मस्तिष्क	m ə s t̪ ɪ ʃ k
ऋषि	ɾ ɪ ʃ iː
बटोरना	b ə ʈ oː ɾ n ɑː
ज़मीनी	z ə m iː n iː
ईश्वर	iː ʃ ʋ ə ɾ
युग्मनज	j ʊ ɡ m ə n ə d͡ʒ
कॉमेडियन	k ɔː m eː ɖ iː j ə n
जिनका	d͡ʒ ɪ n k ɑː
पेशी	p eː ʃ iː
जनतंत्र	d͡ʒ ə n t̪ ə n t̪ ɾ
नियंत्रित	n iː j ə n t̪ ɾ ɪ t̪
सीढ़ी	s iː ɽ ʱ iː
च्वॉइस	t͡ʃ ʋ ɔː ɪ s
सूई	s uː iː
वहम	ʋ ə ʱ m
नोचना	n oː t͡ʃ n ɑː
प्रतिमा	p ɾ ə t̪ ɪ m ɑː
पैदाइशी	p ɛː d̪ ɑː ɪ ʃ iː
तौहीन	t̪ ɔː ɦ iː n
उरुमची	ʊ ɾ ʊ m t͡ʃ iː
कुश्ती	k ʊ ʃ t̪ iː
पंचायती	p ə ɲ t͡ʃ ɑː j ə t̪ iː
दाब	d̪ ɑː b
ऐश्वर्य	ɛː ʃ ʋ ə ɾ j
सुझाना	s ʊ d͡ʒ ʱ ɑː n ɑː
लेखा	l eː kʰ ɑː
मसीह	m ə s iː ʱ
आकाशवाणी	ɑː k ɑː ʃ ʋ ɑː n iː
पुतना	p ʊ t̪ n ɑː
देहरादून	d̪ eː ʱ ɾ ɑː d̪ uː n
मीत	m iː t̪
ताज़ा	t̪ ɑː z ɑː
मुनीम	m ʊ n iː m
गेरू	ɡ eː ɾ uː
अर्थपूर्ण	ə ɾ t̪ʰ ə p uː ɾ n
मौलवी	m ɔː l ʋ iː
संवाद	s ə m ʋ ɑː d̪
भाँजना	b ʱ ɑ̃ː d͡ʒ n ɑː
भूयाति	b ʱ uː j ɑː t̪ iː
व्युत्क्रम	ʋ j ʊ t̪ k ɾ ə m
देशभक्ति	d̪ eː ʃ b ʱ ə k t̪ iː
शारीरिक	ʃ ɑː ɾ iː ɾ ɪ k
वर्चुअल	ʋ ə ɾ t͡ʃ ʊ ə l
उद्भव	ʊ d̪ b ʱ ə ʋ
बुत	b ʊ t̪
कमिश्नर	k ə m ɪ ʃ n ə ɾ
देहरा	d̪ eː ʱ ɾ ɑː
कमेटी	k ə m eː ʈ iː
रसभरी	ɾ ə s b ʱ ə ɾ iː
अनुनासिकता	ə n ʊ n ɑː s ɪ k t̪ ɑː
राह	ɾ ɑː ʱ
फेंकना	pʰ eː ŋ k n ɑː
विश्वासघात	ʋ ɪ ʃ ʋ ɑː s ɡ ʱ ɑː t̪
कलमकारी	k ə l ə m k ɑː ɾ iː
रौज़न	ɾ ɔː z ə n
रुकना	ɾ ʊ k n ɑː
हथियार	ɦ ə t̪ʰ iː j ɑː ɾ
चुप्पी	t͡ʃ ʊ p p iː
कंबल	k ə m b ə l
खुलापन	kʰ ʊ l ɑː p ə n
आठवां	ɑː ʈʰ ʋ ɑ̃ː
गुमनाम	ɡ ʊ m n ɑː m
यानाति	j ɑː n ɑː t̪ iː
छलिया	t͡ʃʰ ə l iː j ɑː
निर्देशन	n ɪ ɾ d̪ eː ʃ ə n
डिमांड	ɖ ɪ m ɑː n ɖ
अर्जुन	ə ɾ d͡ʒ ʊ n
तबादला	t̪ ə b ɑː d̪ l ɑː
रिवाज़	ɾ ɪ ʋ ɑː z
कोठा	k oː ʈʰ ɑː
चंदा	t͡ʃ ə n d̪ ɑː
आतंकमय	ɑː t̪ ə ŋ k m ə j
बखान	b ə kʰ ɑː n
झगड़ालू	d͡ʒ ʱ ə ɡ ɽ ɑː l uː
सोवियत	s oː ʋ iː j ə t̪
सार्वभौमिक	s ɑː ɾ ʋ ə b ʱ ɔː m ɪ k
नेकदिल	n eː k d̪ ɪ l
बुआई	b ʊ ɑː iː
गलबाँही	ɡ ə l b ɑ̃ː ɦ iː
दलदल	d̪ ə l ə d̪ ə l
कवित्त	k ə ʋ ɪ t̪ t̪
गुणांक	ɡ ʊ n ɑː ŋ k
लिखाई	l ɪ kʰ ɑː iː
मातृभाषा	m ɑː t̪ ɾ ɪ b ʱ ɑː ʃ ɑː
कमोबेश	k ə m oː b eː ʃ
हड्डी	ɦ ə ɖ ɖ iː
चव्वन	t͡ʃ ə ʋ ʋ ə n
खरब	kʰ ə ɾ ə b
उज़बेक	ʊ z b eː k
प्रातः	p ɾ ɑː t̪ əʰ
लेटना	l e ʈ n a
ठिकाना	ʈʰ ɪ k ɑː n ɑː
दक्खिन	d̪ ə k kʰ ɪ n
अवध	ə ʋ ə d̪ ʱ
खिंचाव	kʰ ɪ ɲ t͡ʃ ɑː ʋ
प्रशासन	p ɾ ə ʃ ɑː s ə n
तनाव	t̪ ə n ɑː ʋ
धुंधला	d̪ ʱ ʊ n d̪ ʱ l ɑː
तटस्थ	t̪ ə ʈ ə s t̪ʰ
नवनीत	n ə ʋ n iː t̪
तंबोल	t̪ ə m b oː l
समर्थ	s ə m ə ɾ t̪ʰ
चौवन	t͡ʃ ɔː ʋ ə n
सदमा	s ə d̪ m ɑː
भूमिति	b ʱ uː m ɪ t̪ iː
तर्कशास्त्र	t̪ ə ɾ k ʃ ɑː s t̪ ɾ
पर्वत	p ə ɾ ʋ ə t̪
बावजूद	b ɑː ʋ d͡ʒ uː d̪
आईला	ɑː iː l ɑː
वरियाली	ʋ ə ɾ iː j ɑː l iː
नियमित	n iː j ə m ɪ t̪
झपकी	d͡ʒ ʱ ə p k iː
टिप्पणी	ʈ ɪ p p ə n iː
घेरना	ɡ ʱ eː ɾ n ɑː
श्वान	ʃ ʋ ɑː n
पैंसठ	p ɛː n s ə ʈʰ
तुंग	t̪ ʊ ŋ ɡ
कर्ता	k ə ɾ t̪ ɑː
मसल	m ə s ə l
हज़ार	ɦ ə z ɑː ɾ
बेज़बान	b eː z b ɑː n
चलवाना	t͡ʃ ə l ʋ ɑː n ɑː
बैर	b ɛː ɾ
अंग्रेज़ी	ə ŋ ɡ ɾ eː z iː
मछली	m ə t͡ʃʰ l iː
टोली	ʈ oː l iː
फल	pʰ ə l
अग्निशामक	ə ɡ n ɪ ʃ ɑː m ə k
साझेदारी	s ɑː d͡ʒ ʱ eː d̪ ɑː ɾ iː
मंडराना	m ə n ɖ ɾ ɑː n ɑː
दवाई	d̪ ə ʋ ɑː iː
पहला	p ɛː ʱ l ɑː
अभिक्रिया	ə b ʱ ɪ k ɾ iː j ɑː
सेटेलाईट	s eː ʈ eː l ɑː iː ʈ
लात	l ɑː t̪
बहुवचन	b ə ɦ ʊ ʋ ə t͡ʃ ə n
मुद्दा	m ʊ d̪ d̪ ɑː
मीठा	m iː ʈʰ ɑː
पिरमिड	p ɪ ɾ m ɪ ɖ
पेशा	p eː ʃ ɑː
उम्मीद्वार	ʊ m m iː d̪ ʋ ɑː ɾ
द्रव्यमान	d̪ ɾ ə ʋ j ə m ɑː n
वहशत	ʋ ə ʱ ʃ ə t̪
सम	s ə m
प्रस्ताव	p ɾ ə s t̪ ɑː ʋ
सर्वसम्मति	s ə ɾ ʋ s ə m m ə t̪ iː
सकना	s ə k n ɑː
संयंत्र	s ə̃ j ə n t̪ ɾ
लोकोक्ति	l oː k oː k t̪ iː
साइप्रस	s ɑː ɪ p ɾ ə s
निवासी	n ɪ ʋ ɑː s iː
बंदगी	b ə n d̪ ə ɡ iː
छुपाना	t͡ʃʰ ʊ p ɑː n ɑː
सलूक	s ə l uː k
समुच्चयबोधक	s ə m ʊ t͡ʃ t͡ʃ ə j b oː d̪ ʱ ə k
नटखट	n ə ʈ kʰ ə ʈ
छविमयी	t͡ʃʰ ə ʋ ɪ m ə j iː
उचक्का	ʊ t͡ʃ ə k k ɑː
बाद	b ɑː d̪
बापू	b ɑː p uː
ज़मीन	z ə m iː n
संश्लिष्ट	s ə n ʃ l ɪ ʃ ʈ
भूमिका	b ʱ uː m ɪ k ɑː
दुर्भावनापूर्ण	d̪ ʊ ɾ b ʱ ɑː ʋ n ɑː p uː ɾ n
अष्टभुज	ə ʃ ʈ b ʱ ʊ d͡ʒ
छूटना	t͡ʃʰ uː ʈ n ɑː
यूरेनियम	j uː ɾ eː n iː j ə m
पृथक्करण	p ɾ ɪ t̪ʰ ə k k ə ɾ ə n
मात्रक	m ɑː t̪ ɾ ə k
दस	d̪ ə s
मूंछ	m uː ɲ t͡ʃʰ
फ़ालतू	f ɑː l t̪ uː
बसना	b ə s n ɑː
कनिष्ठा	k ə n ɪ ʃ ʈʰ ɑː
अजायबघर	ə d͡ʒ ɑː j ə b ɡ ʱ ə ɾ
हरेक	ɦ ə ɾ eː k
रोड़ा	ɾ oː ɽ ɑː
भूलभुलैया	b ʱ uː l b ʱ ʊ l ə iː j ɑː
पढ़ना	p ə ɽ ʱ n ɑː
समकोण	s ə m k oː n
लाइम	l ɑː ɪ m
सिकोड़ना	s ɪ k oː ɽ n ɑː
टूथपेस्ट	ʈ uː t̪ʰ p eː s ʈ
उलझाना	ʊ l d͡ʒ ʱ ɑː n ɑː
विषयवस्तु	ʋ ɪ ʃ ə j ʋ ə s t̪ uː
संकट	s ə ŋ k ə ʈ
मानववाद	m ɑː n ə ʋ ʋ ɑː d̪
खींच	kʰ iː ɲ t͡ʃ
चूतड़	t͡ʃ uː t̪ ə ɽ
व्यक्त	ʋ j ə k t̪
हाय	ɦ ɑː j
हेलीकॉप्टर	ɦ eː l iː k ɔː p ʈ ə ɾ
बनवाना	b ə n ʋ ɑː n ɑː
नरभक्षी	n ə ɾ b ʱ ə k ʃ iː
निगम	n ɪ ɡ ə m
सहयोग	s ə ʱ j oː ɡ
बुक	b ʊ k
इडली	ɪ ɖ l iː
आराम	ɑː ɾ ɑː m
दाढ़	d̪ ɑː ɽ ʱ
लोकगीत	l oː k ɡ iː t̪
सारणी	s ɑː ɾ n iː
पूर्वी	p uː ɾ ʋ iː
तबाही	t̪ ə b ɑː ɦ iː
माचिस	m ɑː t͡ʃ ɪ s
बेसन	b eː s ə n
उपनायिका	ʊ p n ɑː j ɪ k ɑː
एकाएक	eː k ɑː eː k
बैठना	b ɛ ʈʰ n aː
आग	ɑː ɡ
दहन	d̪ ɛː ʱ n
वाष्पोत्सर्जन	ʋ ɑː ʃ p oː t̪ s ə ɾ d͡ʒ ə n
नत्थी	n ə t̪ t̪ʰ iː
उपभोग	ʊ p b ʱ oː ɡ
चुंबक	t͡ʃ ʊ m b ə k
कन्हैया	k ə n ɦ ə iː j ɑː
सरेआम	s ə ɾ eː ɑː m
शिश्न	ʃ ɪ ʃ n
सहस्रिमान	s ɛː ʱ s ɾ ɪ m ɑː n
खगोल	kʰ ə ɡ oː l
अर्ज़ी	ə ɾ z iː
अफ़ीमची	ə f iː m t͡ʃ iː
शरण	ʃ ə ɾ ə n
सामान	s ɑː m ɑː n
वंश	ʋ ə n ʃ
वंदना	ʋ ə n d̪ ə n ɑː
मोड़ी	m oː ɽ iː
लड़का	l ə ɽ k ɑː
व्यय	ʋ j ə j
सायबान	s ɑː j b ɑː n
दरमियान	d̪ ə ɾ m iː j ɑː n
कौमुदी	k ɔː m ʊ d̪ iː
मूल्य	m uː l j
अठहत्तर	ə ʈʰ ɦ ə t̪ t̪ ə ɾ
त्रिपुरा	t̪ ɾ ɪ p ʊ ɾ ɑː
अविचल	ə ʋ ɪ t͡ʃ ə l
संयुक्त	s ə̃ j ʊ k t̪
टंकण	ʈ ə ŋ k ə n
पुनःप्रवेश	p ʊ n əʰ p ɾ ə ʋ eː ʃ
मानस	m ɑː n ə s
पढ़ाई	p ə ɽ ʱ ɑː iː
झेलना	d͡ʒ ʱ eː l n ɑː
पदक	p ə d̪ ə k
पेट	p eː ʈ
सुस्वादु	s ʊ s ʋ ɑː d̪ uː
ठंडा	ʈʰ ə n ɖ ɑː
चालीस	t͡ʃ ɑː l iː s
नीड़ज	n iː ɽ ə d͡ʒ
जनाज़ा	d͡ʒ ə n ɑː z ɑː
भ्रूणता	b ʱ ɾ uː n t̪ ɑː
पड़ाना	p ə ɽ ɑː n ɑː
