pornește	p o r n e ʃ t e
antonim	a n t o n i m
ploaie	p lʷ a j e
limitară	l i m i t a r ə
sfârșeați	s f ɨ r ʃ j a t sʲ
mulțumiții	m u l t͡s u m i t͡s iː
cântând	k ɨ n t ɨ n d
limitase	l i m i t a s e
funcționaseși	f u n k t͡s i o n a s e ʃʲ
zăpușind	z ə p u ʃ i n d
tatuajelor	t a t u a ʒ e l o r
rânduri	r ɨ n d u rʲ
terminaseră	t e r m i n a s e r ə
protejaseră	p r o t e ʒ a s e r ə
moartă	m o̯ a r t ə
stimulezi	s t i m u l e zʲ
clăditelor	k l ə d i t e l o r
urinai	u r i n a j
foloseam	f o l o s j a m
zăpușeam	z ə p u ʃ j a m
iubiseră	j u b i s e r ə
citește	t ʃ i t e ʃ t e
întâlniților	ɨ n t ɨ l n i t͡s i l o r
deranjaseră	d e r a n ʒ a s e r ə
minut	m i n u t
cenzuram	t͡ʃ e n z u r a m
veștejită	v e ʃ t e ʒ i t ə
năluciseși	n ə l u t ʃ i s e ʃʲ
muista	m u i s t a
zăpușiserăți	z ə p u ʃ i s e r ə t sʲ
accelerezi	a k t͡ʃ e l e r e zʲ
plictisiseră	p l i k t i s i s e r ə
expoziție	e k s p o z i t͡s i e
îmbunătățitului	ɨ m b u n ə t ə t͡s i t u l u j
somaserăm	s o m a s e r ə m
fumaserăți	f u m a s e r ə t sʲ
scrum	s k r u m
sângerasem	s ɨ n d͡ʒ e r a s e m
tentam	t e n t a m
tale	t a l e
clădise	k l ə d i s e
dușmăneai	d u ʃ m ə n j a j
omniprezentele	o m n i p r e z e n t e l e
orgasme	o r ɡ a s m e
opriseră	o p r i s e r ə
urinat	u r i n a t
stimulă	s t i m u l ə
zonă	z o n ə
canale	k a n a l e
mulțumiți	m u l t͡s u m i t͡sʲ
dușmănești	d u ʃ m ə n e ʃ tʲ
libidinos	l i b i d i n o s
necăjise	n e k ə ʒ i s e
culoarea	k u l o̯ a r e̯ a
dacă	d a k ə
lipsea	l i p s j a
mâncând	m ɨ n k ɨ n d
frecat	f r e k a t
scald	s k a l d
cicatrice	t͡ʃ i k a t r i t͡ʃ e
oprească	o p r j a s k ə
șantajezi	ʃ a n t a ʒ e zʲ
grăbite	ɡ r ə b i t e
răpiserăm	r ə p i s e r ə m
apele	a p e l e
nălucitele	n ə l u t͡ʃ i t e l e
analizam	a n a l i z a m
fumăm	f u m ə m
creaserăți	k r e a s e r ə t sʲ
formarăm	f o r m a r ə m
tatua	t a t u a
mergem	m e r d͡ʒ e m
înzestreze	ɨ n z e s t r e z e
folosiși	f o l o s i ʃʲ
puneți	p u n e t͡sʲ
formam	f o r m a m
irațional	i r a t͡s i o n a l
ataraxia	a t a r a k s i a
pretutindeni	p r e t u t i n d e nʲ
clăditele	k l ə d i t e l e
cântăreței	k ɨ n t ə r e t͡s e j
formând	f o r m ɨ n d
delicios	d e l i t͡ʃ j o s
deranjară	d e r a n ʒ a r ə
întâlnirăți	ɨ n t ɨ l n i r ə t sʲ
forma	f o r m a
asurzit	a s u r z i t
exemplele	e ɡ z e m p l e l e
sodomizezi	s o d o m i z e zʲ
veștejisem	v e ʃ t e ʒ i s e m
prezentare	p r e z e n t a r e
acela	a t͡ʃ e l a
substantive	s u b s t a n t i v e
orientez	o r i e n t e z
masturbat	m a s t u r b a t
cătălin	k ə t ə l i n
italiancă	i t a l i a n k ə
pilotaseși	p i l o t a a s e ʃʲ
palme	p a l m e
ejaculă	e ʒ a k u l ə
grăbiseși	ɡ r ə b i s e ʃʲ
pornografii	p o r n o ɡ r a f iː
felații	f e l a t s iː
delirant	d e l i r a n t
îmbunătățire	ɨ m b u n ə t ə t͡s i r e
daneză	d a n e z ə
misteriosului	m i s t e r i o s u l u j
delimitau	d e l i m i t a w
știți	ʃ t i t͡sʲ
norii	n o r i
cioculescu	t ʃ o k u l e s k u
găsească	ɡ ə s j a s k ə
misterioaselor	m i s t e r i o̯ a s e l o r
evoluție	e v o l u t s i e
oprit	o p r i t
studie	s t u d j e
porniși	p o r n i ʃʲ
somați	s o m a t͡sʲ
acești	a t͡ʃ e ʃ tʲ
copleșitorii	k o p l e ʃ i t o r iː
pilotarăți	p i l o t a a r ə t sʲ
protejam	p r o t e ʒ a m
descrie	d e s k r i j e
numise	n u m i s e
masturbez	m a s t u r b e z
omenesc	o m e n e s k
alcoolici	a l k o o l i t͡ʃʲ
răpeam	r ə p j a m
masturbam	m a s t u r b a m
întâlneați	ɨ n t ɨ l n j a t sʲ
avansă	a v a n s ə
pornograficelor	p o r n o ɡ r a f i t͡ʃ e l o r
albulescu	a l b u l e s k u
republică	r e p u b l i k ə
lipsiserăți	l i p s i s e r ə t sʲ
călătorite	k ə l ə t o r i t e
îmbunătățească	ɨ m b u n ə t ə t s j a s k ə
futuși	f u t u ʃʲ
perfecte	p e r f e k t e
treabă	t r e̯ a b ə
citiserăți	t ʃ i t i s e r ə t sʲ
întărești	ɨ n t ə r e ʃ tʲ
găsiții	ɡ ə s i t͡s iː
sângerezi	s ɨ n d͡ʒ e r e zʲ
fu	f u
drăgulescu	d r ə ɡ u l e s k u
elogiu	e l o d͡ʒ i w
fereastră	f e r e̯ a s t r ə
răstigni	r ə s t i ɡ n i
dace	d a t͡ʃ e
opream	o p r j a m
continuat	k o n t i n w a t
drumuri	d r u m u rʲ
cartilaj	k a r t i l a ʒ
caracter	k a r a k t e r
îmbunătățind	ɨ m b u n ə t ə t s i n d
găsea	ɡ ə s j a
frecai	f r e k a j
șantajaserăm	ʃ a n t a ʒ a s e r ə m
controlase	k o n t r o l a s e
cum	k u m
lichidă	l i k i d ə
tatuară	t a t u a r ə
primeam	p r i m j a m
suedezi	s u e d e zʲ
sângerau	s ɨ n d͡ʒ e r a w
făcut	f ə k u t
somarăm	s o m a r ə m
supseseră	s u p s e s e r ə
șantajiștilor	ʃ a n t a ʒ i ʃ t i l o r
scriem	s k r i e m
dorinței	d o r i n t͡s e j
dus	d u s
supseserăți	s u p s e s e r ə t͡sʲ
someze	s o m e z e
sodomizași	s o d o m i z a ʃʲ
cartă	k a r t ə
cerui	t͡ʃ e r u j
discuție	d i s k u t s i ɛ
folosirăți	f o l o s i r ə t sʲ
bruia	b r u j a
regi	r e d͡ʒʲ
funcționau	f u n k t͡s i o n a w
trăi	t r ə i
vorbisem	v o r b i s e m
frumosului	f r u m o s u l u j
curului	k u r u l u j
iubind	j u b i n d
juisează	ʒ u i s e̯ a z ə
prietenie	p r i e t e n i e
gândi	ɡ ɨ n d i
răpit	r ə p i t
vigilență	v i d͡ʒ i l e n t͡s ə
demon	d e m o n
numiserăm	n u m i s e r ə m
beri	b e rʲ
funcționăm	f u n k t͡s i o n ə m
dușmănisem	d u ʃ m ə n i s e m
protejat	p r o t e ʒ a t
paradoxului	p a r a d o k s u l u j
bucă	b u k ə
ciocolată	t͡ʃ j o k o l a t ə
îmbrăca	ɨ m b r ə k a
nălucite	n ə l u t͡ʃ i t e
suveran	s u v e ɾ a n
ungaria	u n ɡ a r i a
delirurile	d e l i r u r i l e
clădite	k l ə d i t e
paupertate	p a u p e r t a t e
scrumiere	s k r u m i e r e
deranjă	d e r a n ʒ ə
frunză	f r u n z ə
primirăm	p r i m i r ə m
ignorai	i ɡ n o r a j
serenadă	s e r e n a d ə
fumase	f u m a s e
îmbunătățea	ɨ m b u n ə t ə t s j a
analizez	a n a l i z e z
asurzește	a s u r z e ʃ t e
sodomizați	s o d o m i z a t͡sʲ
acestora	a t͡ʃ e s t o r a
elemozină	e l e m o z i n ə
supseseși	s u p s e s e ʃʲ
mâncăm	m ɨ n k ə m
călătoreați	k ə l ə t o r j a t sʲ
macabru	m a k a b r u
testicule	t e s t i k u l e
sturz	s t u r z
balcoane	b a l k o̯ a n e
sfârșind	s f ɨ r ʃ i n d
pilotez	p i l o t a e z
anarhist	a n a r h i s t
uri	u rʲ
veștejea	v e ʃ t e ʒ e̯ a
supt	s u p t
grăbită	ɡ r ə b i t ə
fata	f a t a
portocal	p o ɾ t o k a l
clădind	k l ə d i n d
cenzurați	t͡ʃ e n z u r a t͡sʲ
gândește	ɡ ɨ n d e ʃ t e
oficial	o f i t ʃ i a l
păcurar	p ə k u r a r
fie	f i e
distrași	d i s t r a ʃʲ
dau	d a u
infinitate	i n f i n i t a t e
tentă	t e n t ə
iubeați	j u bʲ æ t͡sʲ
sexe	s e k s e
venisem	v e n i s e m
sodomizez	s o d o m i z e z
orientară	o r i e n t a r ə
boi	b o j
țaro	t͡s a r o
aveți	a v e t sʲ
piloteze	p i l o t a e z e
turiști	t u r i ʃ tʲ
ce	t͡ʃ e
mănânci	m ə n ɨ n t͡ʃʲ
șoptitelor	ʃ o p t i t e l o r
delimitând	d e l i m i t ɨ n d
danez	d a n e z
franțuzește	f r a n t͡s u z e ʃ t e
pregătiră	p r e ɡ ə t i r ə
asurziseși	a s u r z i s e ʃʲ
pregătiși	p r e ɡ ə t i ʃʲ
pregătiți	p r e ɡ ə t i t͡sʲ
veștejitei	v e ʃ t e ʒ i t e j
turcesc	t u r t͡ʃ e s k
întristați	ɨ n t r i s t a t͡sʲ
moldovenești	m o l d o v e n e ʃ tʲ
delimitezi	d e l i m i t e zʲ
deranjau	d e r a n ʒ a w
prietenă	p r i e t e n ə
finlandeză	f i n l a n d e z ə
torturaserăți	t o r t u r a s e r ə t sʲ
masturbaților	m a s t u r b a t͡s i l o r
masturbă	m a s t u r b ə
întâlnitului	ɨ n t ɨ l n i t u l u j
excavai	e k s k a v a j
deranjând	d e r a n ʒ ɨ n d
necunoscut	n e k u n o s k u t
perversitate	p e r v e r s i t a t e
delira	d e l i r a
active	a k t i v e
răpească	r ə p j a s k ə
pregătește	p r e ɡ ə t e ʃ t e
necăjitului	n e k ə ʒ i t u l u j
distrează	d i s t r j a z ə
răpea	r ə p j a
șantajate	ʃ a n t a ʒ a t e
copiii	k o p i j i
turist	t u r i s t
florina	f l o r i n a
șantajaseră	ʃ a n t a ʒ a s e r ə
interesant	i n t e r e s a n t
mulțumitei	m u l t͡s u m i t e j
întoarceți	ɨ n t w a r t͡ʃ e t͡sʲ
iluzoria	i l u z o r i a
lucrurilor	l u k r u r i l o r
folosite	f o l o s i t e
călătorise	k ə l ə t o r i s e
îmbunătățiseră	ɨ m b u n ə t ə t s i s e r ə
pornirăți	p o r n i r ə t sʲ
șoptite	ʃ o p t i t e
lipsisem	l i p s i s e m
minge	m i n d ʒ e
scălda	s k ə l d a
demoni	d e m o nʲ
fundamentali	f u n d a m e n t a lʲ
funcționez	f u n k t͡s i o n e z
apocalipsele	a p o k a l i p s e l e
modificata	m o d i f i k a t a
pilotară	p i l o t a a r ə
tatuajului	t a t u a ʒ u l u j
năluceați	n ə l u t ʃ j a t sʲ
câștigi	k ɨ ʃ t i d͡ʒʲ
șopteai	ʃ o p t j a j
botez	b o t e z
portabilitate	p o r t a b i l i t a t e
limbi	l i m b i
omniprezentelor	o m n i p r e z e n t e l o r
murit	m u r i t
văilor	v ə j l o r
futuți	f u t u t͡sʲ
urăsc	u r ə s k
evlavioși	e v l a v i o ʃʲ
delirasem	d e l i r a s e m
zăpadă	z ə p a d ə
drept	d r e p t
somași	s o m a ʃʲ
masturbaseră	m a s t u r b a s e r ə
rabat	r a b a t
băiețel	b ə j ɛ t s ɛ l
cuvinte	k u v i n t e
nălucind	n ə l u t ʃ i n d
zăpușirăți	z ə p u ʃ i r ə t sʲ
limitați	l i m i t a t͡sʲ
zgardă	z ɡ a r d ə
cerneală	t ʃ e r n e̯ a l ə
mor	m o r
conduce	k o n d u t͡ʃ e
cadavru	k a d a v r u
infix	i n f i k s
distracție	d i s t r a k t͡s i e
scrumierelor	s k r u m i e r e l o r
afinitate	a f i n i t a t e
fuseseși	f u s e s e ʃʲ
oltenia	o l t e n i a
înzestrând	ɨ n z e s t r ɨ n d
armăsarilor	a r m ə s a r i l o r
întâlnește	ɨ n t ɨ l n e ʃ t e
sexualelor	s e k s u a l e l o r
futuții	f u t u t͡s iː
ivorian	i v o r i a n
mărturisirăți	m ə r t u r i s i r ə t sʲ
kidnapping	k i d n a p i ŋ
frumusețe	f r u m u s e t s e
accelereze	a k t͡ʃ e l e r e z e
deranjeze	d e r a n ʒ e z e
vrem	v r e m
numeați	n u m j a t sʲ
părăsi	p ə r ə s i
astruca	a s t r u k a
cățea	k ə t s e̯ a
năluciseră	n ə l u t ʃ i s e r ə
lubrifia	l u b r i f i a
distrase	d i s t r a s e
prezervative	p r e z e r v a t i v e
sodomizaserăți	s o d o m i z a s e r ə t͡sʲ
asurzeai	a s u r z j a j
dușmăniserăți	d u ʃ m ə n i s e r ə t sʲ
oameni	o̯ a m e nʲ
ăștia	ə ʃ t j a
sodomizau	s o d o m i z a w
gândite	ɡ ɨ n d i t e
protejară	p r o t e ʒ a r ə
zăpușiseră	z ə p u ʃ i s e r ə
parca	p a r k a
cilibia	t ʃ i l i b i a
române	r o m ɨ n e
fețe	f e t s e
aștepta	a ʃ t e p t a
gravitaseră	ɡ r a v i t a s e r ə
mâine	m ɨ j n e
închide	ɨ n k i d e
terminase	t e r m i n a s e
dimineții	d i m i n e t s iː
tatuai	t a t u a j
francezi	f r a n t͡ʃ e zʲ
circumcide	t͡ʃ i r k u m t͡ʃ i d e
mici	m i t͡ʃʲ
întâlnisem	ɨ n t ɨ l n i s e m
șal	ʃ a l
gândiseră	ɡ ɨ n d i s e r ə
călătorind	k ə l ə t o r i n d
controlând	k o n t r o l ɨ n d
ejaculase	e ʒ a k u l a s e
mihai	m i h a j
masturbeze	m a s t u r b e z e
turtit	t u r t i t
întâlniserăți	ɨ n t ɨ l n i s e r ə t sʲ
întăritei	ɨ n t ə r i t e j
sodomizarăm	s o d o m i z a r ə m
gândiților	ɡ ɨ n d i t͡s i l o r
întâlnim	ɨ n t ɨ l n i m
familia	f a m i l i a
analizaseră	a n a l i z a s e r ə
os	o s
pornită	p o r n i t ə
cântăreților	k ɨ n t ə r e t͡s i l o r
șantajata	ʃ a n t a ʒ a t a
pornitului	p o r n i t u l u j
citiserăm	t ʃ i t i s e r ə m
abandonai	a b a n d o n a j
simple	s i m p l e
lumi	l u mʲ
negri	n e ɡ r i
formași	f o r m a ʃʲ
cumnate	k u m n a t e
cenzuraseși	t͡ʃ e n z u r a s e ʃʲ
bengalez	b e ŋ ɡ a l e z
excavat	e k s k a v a t
frumoșilor	f r u m o ʃ i l o r
diminețile	d i m i n e t s i l e
aerodrom	a e r o d r o m
deschis	d e s k i s
abandonez	a b a n d o n e z
bogdan	b o ɡ d a n
flexibilitate	f l e k s i b i l i t a t e
tovarăș	t o v a r ə ʃ
funcționat	f u n k t͡s i o n a t
mănușă	m ə n u ʃ ə
puța	p u t͡s a
coreea	k o r e j a
formaseși	f o r m a s e ʃʲ
lucian	l u t͡ʃ j a n
vorbită	v o r b i t ə
ejacula	e ʒ a k u l a
sexualilor	s e k s u a l i l o r
ucide	u t ʃ i d e
lună	l u n ə
apocaliptica	a p o k a l i p t i k a
îmbrăcat	ɨ m b r ə k a t
înghețată	ɨ ŋ ɡ e t s a t ə
nălucitelor	n ə l u t͡ʃ i t e l o r
beregate	b e r e ɡ a t e
mea	m e̯ a
analizați	a n a l i z a t͡sʲ
sodomizează	s o d o m i zʲ a z ə
întăriră	ɨ n t ə r i r ə
dănuț	d ə n u t͡s
accelerai	a k t͡ʃ e l e r a j
macabri	m a k a b r i
delirante	d e l i r a n t e
baligă	b a l i ɡ ə
aceștia	a t͡ʃ e ʃ t j a
urinarăm	u r i n a r ə m
gândim	ɡ ɨ n d i m
orientași	o r i e n t a ʃʲ
numeau	n u m j a w
grăbeam	ɡ r ə b j a m
boașe	b o̯ a ʃ e
zăpușita	z ə p u ʃ i t a
formatelor	f o r m a t e l o r
ironic	i r o n i k
monocrom	m o n o k r o m
gravitară	ɡ r a v i t a r ə
gravitat	ɡ r a v i t a t
mulțumita	m u l t͡s u m i t a
formau	f o r m a w
perfecteze	p e r f e k t e z e
trib	t r i b
seri	s e rʲ
funcționase	f u n k t͡s i o n a s e
călătoresc	k ə l ə t o r e s k
lăsa	l ə s a
narcotic	n a ɾ k o t i k
important	i m p o r t a n t
copia	k o p i a
fete	f e t e
socializa	s o t͡ʃ i a l i z a
deranjată	d e r a n ʒ a t ə
slovac	s l o v a k
tatuam	t a t u a m
scrumierei	s k r u m i e r e j
chelner	k e l n e r
haos	h a o s
floci	f l o t͡ʃʲ
hypnos	h i p n o s
sângeraseră	s ɨ n d͡ʒ e r a s e r ə
organizație	o r ɡ a n i z a t s i e
formalitate	f o r m a l i t a t e
observa	o p s e ɾ v a
suc	s u k
mulțumeai	m u l t s u m j a j
erotici	e r o t i t͡ʃʲ
abandonând	a b a n d o n ɨ n d
găsiserăm	ɡ ə s i s e r ə m
liniștit	l i n i ʃ t i t
întristarăm	ɨ n t r i s t a r ə m
macabra	m a k a b r a
reviste	r e v i s t e
vorbiserăm	v o r b i s e r ə m
sfârc	s f ɨ r k
corn	k o r n
prepoziție	p r e p o z i t͡s i e
gândac	ɡ ɨ n d a k
ăsteia	ə s t e j a
găsisem	ɡ ə s i s e m
grăbești	ɡ r ə b e ʃ tʲ
enigmatică	e n i ɡ m a t i k ə
gândiseși	ɡ ɨ n d i s e ʃʲ
copleși	k o p l e ʃ i
creat	k r e a t
pornesc	p o r n e s k
delimitați	d e l i m i t a t͡sʲ
mulțumiserăm	m u l t s u m i s e r ə m
asurzirăm	a s u r z i r ə m
chei	k e j
ger	d͡ʒ e r
foste	f o s t e
apocalips	a p o k a l i p s
minusculă	m i n u s k u l ə
tre	t r e
abia	a b j a
nălucea	n ə l u t ʃ j a
tentaseră	t e n t a s e r ə
pregătirăm	p r e ɡ ə t i r ə m
stimulau	s t i m u l a w
hamace	h a m a t͡ʃ e
asurzite	a s u r z i t e
funcționeze	f u n k t͡s i o n e z e
scrotali	s k r o t a lʲ
acasă	a k a s ə
controlaseși	k o n t r o l a s e ʃʲ
insulă	i n s u l ə
bestialitate	b e s t i a l i t a t e
delirarăm	d e l i r a r ə m
sugeați	s u d͡ʒ e̯ a t͡sʲ
pizda	p i z d a
sunet	s u n e t
alcoolică	a l k o o l i k ə
protejași	p r o t e ʒ a ʃʲ
specialitate	s p e t͡ʃ i a l i t a t e
drag	d r a ɡ
lubrifiant	l u b r i f i a n t
tatueze	t a t u e z e
găsii	ɡ ə s iː
abandona	a b a n d o n a
tură	t u r ə
reali	r e a lʲ
alfabete	a l f a b e t e
șantajatele	ʃ a n t a ʒ a t e l e
găsită	ɡ ə s i t ə
prezice	p r e z i t͡ʃ e
sângeraserăți	s ɨ n d͡ʒ e r a s e r ə t sʲ
expune	e k s p u n e
observație	o b s e ɾ v a t͡s i e
leg	l e ɡ
zăpușiții	z ə p u ʃ i t͡s iː
frecați	f r e k a t͡sʲ
evlavioșii	e v l a v i o ʃ iː
pion	p i o n
așadar	a ʃ a d a r
acceleraseși	a k t͡ʃ e l e r a s e ʃʲ
deveni	d e v e n i
lipsirăți	l i p s i r ə t sʲ
iubiserăm	j u b i s e r ə m
homosexualilor	h o m o s e k s u a l i l o r
dinți	d i n t͡sʲ
sinistre	s i n i s t r e
perioadă	p e r i o̯ a d ə
tatuași	t a t u a ʃʲ
șantajase	ʃ a n t a ʒ a s e
călătoriserăți	k ə l ə t o r i s e r ə t sʲ
ubicua	u b i k u a
daneze	d a n e z e
pregătitei	p r e ɡ ə t i t e j
sălbatice	s ə l b a t i t͡ʃ e
primita	p r i m i t a
prietenele	p r i e t e n e l e
tatuarăți	t a t u a r ə t sʲ
deliruri	d e l i r u rʲ
cerere	t͡ʃ e r e r e
mănuși	m ə n u ʃʲ
mărturisitelor	m ə r t u r i s i t e l o r
fișier	f i ʃ i e r
stupid	s t u p i d
clădeați	k l ə d j a t sʲ
muistă	m u i s t ə
moldova	m o l d o v a
lipseam	l i p s j a m
mulțumisem	m u l t s u m i s e m
analizând	a n a l i z ɨ n d
îți	ɨ t sʲ
sodomizam	s o d o m i z a m
necăjiților	n e k ə ʒ i t͡s i l o r
olandez	o l a n d e z
întristaserăți	ɨ n t r i s t a s e r ə t sʲ
cărți	k ə r t͡sʲ
sfârșiseși	s f ɨ r ʃ i s e ʃʲ
potabil	p o t a b i l
asurzită	a s u r z i t ə
numit	n u m i t
șantajiștii	ʃ a n t a ʒ i ʃ t iː
spargi	s p a r d͡ʒʲ
șantajistele	ʃ a n t a ʒ i s t e l e
gânditului	ɡ ɨ n d i t u l u j
termine	t e r m i n e
brazilian	b r a z i l i a n
distrezi	d i s t r e zʲ
după	d u p ə
fumau	f u m a w
creaserăm	k r e a s e r ə m
neomenește	n e o m e n e ʃ t e
numește	n u m e ʃ t e
opriților	o p r i t͡s i l o r
plictisiși	p l i k t i s i ʃʲ
evlavie	e v l a v i e
poloneză	p o l o n e z ə
cadavrului	k a d a v r u l u j
faptului	f a p t u l u j
casă	k a s ə
cocori	k o k o rʲ
necăjiră	n e k ə ʒ i r ə
folosească	f o l o s j a s k ə
grăbiră	ɡ r ə b i r ə
emil	e m i l
sugem	s u d͡ʒ e m
cream	k r e a m
nălucești	n ə l u t ʃ e ʃ tʲ
tare	t a r e
făcând	f ə k ɨ n d
învăța	ɨ n v ə t s a
pulilor	p u l i l o r
lipsește	l i p s e ʃ t e
mulțumiseși	m u l t s u m i s e ʃʲ
necăjim	n e k ə ʒ i m
mulțumite	m u l t͡s u m i t e
porniseși	p o r n i s e ʃʲ
masculine	m a s k u l i n e
elimini	e l i m i nʲ
lipsitele	l i p s i t e l e
muriți	m u r i t͡sʲ
capitula	k a p i t u l a
șantajăm	ʃ a n t a ʒ ə m
sângerară	s ɨ n d͡ʒ e r a r ə
ierburi	j e r b u rʲ
esență	e s e n t s ə
plictisii	p l i k t i s iː
supsei	s u p s e j
dezbrăca	d e z b r ə k a
întrebare	ɨ n t r e b a r e
sunetelor	s u n e t e l o r
călătorească	k ə l ə t o r j a s k ə
mort	m o r t
furăți	f u r ə t͡sʲ
opriți	o p r i t͡sʲ
întristeze	ɨ n t r i s t e z e
opri	o p r i
futuseră	f u t u s e r ə
analizarăm	a n a l i z a r ə m
înzestrați	ɨ n z e s t r a t͡sʲ
vorbește	v o r b e ʃ t e
larg	l a r ɡ
gândească	ɡ ɨ n d j a s k ə
culturi	k u l t u rʲ
șmecherie	ʃ m e k e r i e
usturoi	u s t̪ u ɾ o j
freci	f r e t͡ʃʲ
asurziți	a s u r z i t͡sʲ
balcanic	b a l k a n i k
întristau	ɨ n t r i s t a w
nominali	n o m i n a lʲ
delimitat	d e l i m i t a t
biserică	b i s e r i k ə
pornirăm	p o r n i r ə m
locvace	l o k v a t͡ʃ e
numere	n u m e r e
lipsise	l i p s i s e
întăream	ɨ n t ə r j a m
numită	n u m i t ə
părinte	p ə r i n t e
făceai	f ə t͡ʃ e̯ a j
plictisirăți	p l i k t i s i r ə t sʲ
furtuna	f u r t u n a
visător	v i s ə t o r
pornografice	p o r n o ɡ r a f i t͡ʃ e
folosit	f o l o s i t
citită	t͡ʃ i t i t ə
tatuajul	t a t u a ʒ u l
șoptiseră	ʃ o p t i s e r ə
insula	i n s u l a
foști	f o ʃ tʲ
fuseseră	f u s e s e r ə
polonez	p o l o n e z
slab	s l a b
misterioasă	m i s t e r i o̯ a s ə
necăjește	n e k ə ʒ e ʃ t e
români	r o m ɨ nʲ
minuscule	m i n u s k u l e
iluzoriilor	i l u z o r iː l o r
niculescu	n i k u l e s k u
studia	s t u d i a
zăpușeai	z ə p u ʃ j a j
întristă	ɨ n t r i s t ə
pretutindenea	p r e t u t i n d e nʲ æ
punem	p u n e m
puță	p u t s ə
delirau	d e l i r a w
perfecți	p e r f e k t͡sʲ
pătură	p ə t u r ə
busolă	b u s o l ə
perfectasem	p e r f e k t a s e m
frumuseților	f r u m u s e t s i l o r
an	a n
înzestrate	ɨ n z e s t r a t e
pornograficele	p o r n o ɡ r a f i t͡ʃ e l e
anonimi	a n o n i mʲ
numesc	n u m e s k
regină	r e d͡ʒ i n ə
întâlneam	ɨ n t ɨ l n j a m
căprior	k ə p r i o r
traduci	t r a d u t͡ʃʲ
găsind	ɡ ə s i n d
urinam	u r i n a m
nălucim	n ə l u t ʃ i m
sămânță	s ə m ɨ n t s ə
grăbise	ɡ r ə b i s e
întărită	ɨ n t ə r i t ə
cerbar	t͡ʃ e r b a r
pregătise	p r e ɡ ə t i s e
deranjaserăți	d e r a n ʒ a s e r ə t sʲ
bulgăresc	b u l ɡ ə r e s k
fetei	f e t e j
controlaserăți	k o n t r o l a s e r ə t sʲ
atrocitate	a t r o t͡ʃ i t a t e
rog	r o ɡ
pișa	p i ʃ a
mulțumeau	m u l t s u m j a w
supserăți	s u p s e r ə t͡sʲ
spovedeam	s p o v e d j a m
somnifer	s o m n i f e ɾ
feței	f e t s e j
clădită	k l ə d i t ə
stimulez	s t i m u l e z
întăritele	ɨ n t ə r i t e l e
obosit	o b o s i t
citească	t ʃ i t j a s k ə
spovedită	s p o v e d i t ə
regele	r e d͡ʒ e l e
sfârșiși	s f ɨ r ʃ i ʃʲ
pornind	p o r n i n d
susurare	s u s u r a r e
văi	v ə j
cenzurași	t͡ʃ e n z u r a ʃʲ
botezuri	b o t e z u rʲ
asexual	a s e k s u a l
promit	p r o m i t
opreau	o p r j a w
folosisem	f o l o s i s e m
oprim	o p r i m
promitem	p r o m i t e m
îmbunătățești	ɨ m b u n ə t ə t s e ʃ tʲ
numitei	n u m i t e j
întristaseră	ɨ n t r i s t a s e r ə
distrând	d i s t r ɨ n d
paradox	p a r a d o k s
tentaserăm	t e n t a s e r ə m
mărturisita	m ə r t u r i s i t a
albanez	a l b a n e z
gravitaseși	ɡ r a v i t a s e ʃʲ
centrală	t͡ʃ e n t ɾ a l ə
aalenian	aː l e n i a n
gravitaserăm	ɡ r a v i t a s e r ə m
delicioase	d e l i t͡ʃ j o̯ a s e
citiși	t ʃ i t i ʃʲ
bănui	b ə n u i
tatuase	t a t u a s e
revista	r e v i s t a
vizibilitate	v i z i b i l i t a t e
macabrelor	m a k a b r e l o r
catarg	k a t a r ɡ
cădea	k ə d e̯ a
controlară	k o n t r o l a r ə
tatuează	t a t u j a z ə
schizofrenie	s k i z o f r e n i e
sedus	s e d u s
apocaliptică	a p o k a l i p t i k ə
plictiseai	p l i k t i s j a j
creează	k r e e̯ a z ə
omniprezenta	o m n i p r e z e n t a
distraseși	d i s t r a s e ʃʲ
sfârșiți	s f ɨ r ʃ i t͡sʲ
pregătită	p r e ɡ ə t i t ə
cadavre	k a d a v r e
laptelui	l a p t e l u j
protejeze	p r o t e ʒ e z e
fața	f a t s a
folosita	f o l o s i t a
gândită	ɡ ɨ n d i t ə
asurzise	a s u r z i s e
întărisem	ɨ n t ə r i s e m
masturbatei	m a s t u r b a t e j
somnambul	s o m n a m b u l
perfectaseră	p e r f e k t a s e r ə
cititei	t͡ʃ i t i t e j
apocalipticii	a p o k a l i p t i t͡ʃ iː
întâlniși	ɨ n t ɨ l n i ʃʲ
arbust	a r b u s t
albaneze	a l b a n e z e
om	o m
reintroduce	r e i n t r o d u t ʃ e
opritele	o p r i t e l e
clar	k l a r
tați	t a t sʲ
iubește	j u b e ʃ t e
elizeele	e l i z eː l e
gravitarăm	ɡ r a v i t a r ə m
dușmăniși	d u ʃ m ə n i ʃʲ
latină	l a t i n ə
cuvântului	k u v ɨ n t u l u j
prime	p r i m e
castron	k a s t ɾ o n
știu	ʃ t i u
dezbrăcând	d e z b r ə k ɨ n d
limbile	l i m b i l e
apelor	a p e l o r
palma	p a l m a
pansexualitate	p a n s e k s u a l i t a t e
viața	v j a t s a
cenzurarăm	t͡ʃ e n z u r a r ə m
îmbăta	ɨ m b ə t a
patru	p a t r u
spovedirăți	s p o v e d i r ə t sʲ
deștepta	d e ʃ t e p t a
plictisiserăți	p l i k t i s i s e r ə t sʲ
fui	f u j
răpim	r ə p i m
sinistra	s i n i s t r a
frecau	f r e k a w
mâncasem	m ɨ n k a s e m
penisurilor	p e n i s u r i l o r
către	k ə t ɾ e
grăbiși	ɡ r ə b i ʃʲ
grăbirăți	ɡ r ə b i r ə t sʲ
întâiul	ɨ n t ɨ j u l
torturau	t o r t u r a w
ăla	ə l a
conjuncție	k o n ʒ u n k t͡s i e
pederaști	p e d e r a ʃ tʲ
eram	e r a m
harpist	h a r p i s t
torturează	t o r t u r j a z ə
găsitei	ɡ ə s i t e j
armăsar	a r m ə s a r
veri	v e rʲ
gândeai	ɡ ɨ n d j a j
cenzură	t͡ʃ e n z u r ə
asurziții	a s u r z i t͡s iː
sodomist	s o d o m i s t
creezi	k r e e zʲ
abandonase	a b a n d o n a s e
ferocitate	f e r o t͡ʃ i t a t e
fraternității	f r a t e r n i t ə t͡s iʲ
ejaculam	e ʒ a k u l a m
cer	t͡ʃ e r
iluzorie	i l u z o r i e
fumați	f u m a t͡sʲ
întării	ɨ n t ə r iː
pitic	p i t i k
cocoș	k o k o ʃ
numelor	n u m e l o r
stimulaserăm	s t i m u l a s e r ə m
vorbea	v o r bʲ æ
spovedirăm	s p o v e d i r ə m
mâncaserăți	m ɨ n k a s e r ə t͡sʲ
șantajat	ʃ a n t a ʒ a t
sănătate	s ə n ə t a t e
religie	r e l i d ʒ i e
dușmănite	d u ʃ m ə n i t e
mărturisitului	m ə r t u r i s i t u l u j
sfântă	s f ɨ n t ə
păcat	p ə k a t
dușmănii	d u ʃ m ə n iː
oceania	o t ʃ e̯ a n i a
plictiseală	p l i k t i s e a l ə
făceau	f ə t͡ʃ e̯ a w
iubite	j u b i t e
prietenilor	p r i e t e n i l o r
deranjaseși	d e r a n ʒ a s e ʃʲ
accelera	a k t ʃ e l e r a
lascivitate	l a s t͡ʃ i v i t a t e
gândiserăm	ɡ ɨ n d i s e r ə m
pregăteai	p r e ɡ ə t j a j
scrisoare	s k r i s o̯ a r e
animalitate	a n i m a l i t a t e
lipsiților	l i p s i t͡s i l o r
mărturisii	m ə r t u r i s iː
misterioși	m i s t e r i o ʃʲ
pregăteați	p r e ɡ ə t j a t sʲ
găseam	ɡ ə s j a m
dușmănitului	d u ʃ m ə n i t u l u j
delimitase	d e l i m i t a s e
erotică	e r o t i k ə
bărbie	b ə r b i e
delicioasă	d e l i t͡ʃ j o̯ a s ə
citiseși	t ʃ i t i s e ʃʲ
pinten	p i n t e n
protejez	p r o t e ʒ e z
șoptitele	ʃ o p t i t e l e
plictisind	p l i k t i s i n d
mei	m e j
furtună	f u r t u n ə
anatomie	a n a t o m i e
abandonaseși	a b a n d o n a s e ʃʲ
zăpușit	z ə p u ʃ i t
îmbunătățeau	ɨ m b u n ə t ə t s j a w
protejaserăți	p r o t e ʒ a s e r ə t͡sʲ
mâncase	m ɨ n k a s e
pot	p o t
întristase	ɨ n t r i s t a s e
genetic	d͡ʒ e n e t i k
analogie	a n a l o d͡ʒ i e
călătoritele	k ə l ə t o r i t e l e
pizdă	p i z d ə
mică	m i k ə
pedeapsă	p e dʲ æ p s ə
spovediseși	s p o v e d i s e ʃʲ
tatuaseră	t a t u a s e r ə
cenzuraseră	t͡ʃ e n z u r a s e r ə
iubeai	j u bʲ æ j
moment	m o m e n t
mișcare	m i ʃ k a r e
rădaște	r ə d a ʃ t e
analiză	a n a l i z ə
dea	dʲ æ
șantajelor	ʃ a n t a ʒ e l o r
avantaj	a v a n t a ʒ
cenzureze	t͡ʃ e n z u r e z e
somez	s o m e z
întristaserăm	ɨ n t r i s t a s e r ə m
ghiduri	ɡ i d u rʲ
sfânta	s f ɨ n t a
șantajista	ʃ a n t a ʒ i s t a
veștejiții	v e ʃ t e ʒ i t͡s iː
iubire	j u b i r e
găsirăți	ɡ ə s i r ə t sʲ
analizai	a n a l i z a j
zice	z i t ʃ e
știe	ʃ t i e
copleșitorului	k o p l e ʃ i t o r u l u j
orientăm	o r i e n t ə m
fumează	f u m j a z ə
asurzim	a s u r z i m
accelerasem	a k t͡ʃ e l e r a s e m
futeau	f u t e̯ a u
cenzura	t͡ʃ e n z u r a
duce	d u t͡ʃ e
controlăm	k o n t r o l ə m
arșinic	a r ʃ i n i k
ejaculând	e ʒ a k u l ɨ n d
folosiserăm	f o l o s i s e r ə m
urinaserăm	u r i n a s e r ə m
primiră	p r i m i r ə
armăsarii	a r m ə s a r iː
serile	s e r i l e
primite	p r i m i t e
sfârșeai	s f ɨ r ʃ j a j
nevăzut	n e v ə z u t
isus	i s u s
omniprezenților	o m n i p r e z e n t͡s i l o r
adăuga	a d ə u ɡ a
funcționa	f u n k t͡s i o n a
sărac	s ə r a k
comun	k o m u n
macabrele	m a k a b r e l e
înzestraseși	ɨ n z e s t r a s e ʃʲ
îmbunătățiși	ɨ m b u n ə t ə t s i ʃʲ
oprisem	o p r i s e m
întristezi	ɨ n t r i s t e zʲ
cosmin	k o s m i n
accelerând	a k t͡ʃ e l e r ɨ n d
vreți	v r e t sʲ
necăjeai	n e k ə ʒ j a j
primește	p r i m e ʃ t e
jurase	ʒ u r a s e
gândirăm	ɡ ɨ n d i r ə m
numelui	n u m e l u j
mulțumi	m u l t͡s u m i
fiind	f iː n d
băiețeii	b ə j e t s e j i
mănânc	m ə n ɨ n k
asta	a s t a
iubiserăți	j u b i s e r ə t͡sʲ
electroconductibilitate	e l e k t r o k o n d u k t i b i l i t a t e
rece	r e t͡ʃ e
șantajații	ʃ a n t a ʒ a t͡s iː
perineale	p e r i n e a l e
tentant	t e n t a n t
lingură	l i ŋ ɡ u r ə
eroticului	e r o t i k u l u j
omniprezentului	o m n i p r e z e n t u l u j
amariliși	a m a r i l i ʃʲ
scule	s k u l e
exemplelor	e ɡ z e m p l e l o r
găsiseră	ɡ ə s i s e r ə
ejaculez	e ʒ a k u l e z
mie	m i e
fonetici	f o n e t i t͡ʃʲ
adaptabilitate	a d a p t a b i l i t a t e
sugi	s u d͡ʒʲ
pornim	p o r n i m
analizau	a n a l i z a w
păun	p ə u n
găsiților	ɡ ə s i t͡s i l o r
secvențe	s e k v e n t͡s e
vorbiseră	v o r b i s e r ə
pilotaserăm	p i l o t a a s e r ə m
spermă	s p ɛ r m ə
ceh	t͡ʃ e x
nălucită	n ə l u t͡ʃ i t ə
complexe	k o m p l e k s e
porniseră	p o r n i s e r ə
pregătitelor	p r e ɡ ə t i t e l o r
orientând	o r i e n t ɨ n d
stupide	s t u p i d e
erotic	e r o t i k
poate	p o̯ a t e
rozmarin	r o z m a r i n
cerbice	t ʃ e r b i t ʃ e
lipsită	l i p s i t ə
grăbitei	ɡ r ə b i t e j
șoptiții	ʃ o p t i t͡s iː
fund	f u n d
adjective	a d ʒ e k t i v e
excavau	e k s k a v a w
copleșitoarele	k o p l e ʃ i t o̯ a r e l e
stimularăm	s t i m u l a r ə m
cenzurez	t͡ʃ e n z u r e z
zona	z o n a
salamură	s a l a m u r ə
peștilor	p e ʃ t i l o r
specificitate	s p e t͡ʃ i f i t͡ʃ i t a t e
fumaseră	f u m a s e r ə
umanitate	u m a n i t a t e
fostă	f o s t ə
democratic	d e m o k r a t i k
stimulași	s t i m u l a ʃʲ
asurzisem	a s u r z i s e m
reghin	r e ɡ i n
delimitarăți	d e l i m i t a r ə t sʲ
protejai	p r o t e ʒ a j
plictisita	p l i k t i s i t a
asurzitelor	a s u r z i t e l o r
anihila	a n i h i l a
suflete	s u f l e t e
cerea	t͡ʃ e rʲ æ
cosmina	c o s m i n a
orientați	o r i e n t a t͡sʲ
gânditele	ɡ ɨ n d i t e l e
murind	m u r i n d
mărturisiții	m ə r t u r i s i t͡s iː
gândit	ɡ ɨ n d i t
aminti	a m i n t i
abandonarăți	a b a n d o n a r ə t sʲ
tentantă	t e n t a n t ə
întâlnii	ɨ n t ɨ l n iː
anatema	a n a t e m a
formatului	f o r m a t u l u j
prepuțuri	p r e p u t͡s u rʲ
serilor	s e r i l o r
sodomizasem	s o d o m i z a s e m
pregătim	p r e ɡ ə t i m
frecași	f r e k a ʃʲ
frumoaselor	f r u m o̯ a s e l o r
coadă	kʷ a d ə
susur	s u s u r
futem	f u t e m
făcu	f ə k u
năluceai	n ə l u t ʃ j a j
citirăm	t ʃ i t i r ə m
asurzii	a s u r z iː
orientarăți	o r i e n t a r ə t sʲ
iudaism	j u d a i s m
futută	f u t u t ə
contrazis	k o n t r a z i s
nălucesc	n ə l u t ʃ e s k
romane	r o m a n e
frecă	f r e k ə
fețelor	f e t s e l o r
limitând	l i m i t ɨ n d
promisiune	p r o m i s i u n e
călătoream	k ə l ə t o r j a m
spui	s p u j
șoptirăm	ʃ o p t i r ə m
răpitului	r ə p i t u l u j
afgan	a f ɡ a n
atrocități	a t r o t͡ʃ i t ə t͡sʲ
pulelor	p u l e l o r
necăjiseră	n e k ə ʒ i s e r ə
fierbinte	f j e r b i n t e
sfârșii	s f ɨ r ʃ iː
frate	f r a t e
urinarăți	u r i n a r ə t sʲ
spovedit	s p o v e d i t
omenește	o m e n e ʃ t e
sugă	s u ɡ ə
porniții	p o r n i t͡s iː
protejă	p r o t e ʒ ə
deliraserăți	d e l i r a s e r ə t͡sʲ
cetățence	t͡ʃ e t ə t͡s e n t͡ʃ e
ubicuii	u b i k u iː
asurziserăm	a s u r z i s e r ə m
șopteați	ʃ o p t j a t sʲ
futeai	f u t e̯ a j
joc	ʒ o k
asupra	a s u p r a
masturbatele	m a s t u r b a t e l e
acestui	a t͡ʃ e s t u j
citita	t͡ʃ i t i t a
bibliotecă	b i b l i o t e k ə
scuzi	s k u zʲ
mori	m o rʲ
necăjească	n e k ə ʒ j a s k ə
întăriseră	ɨ n t ə r i s e r ə
sfârșirăm	s f ɨ r ʃ i r ə m
orientai	o r i e n t a j
protejăm	p r o t e ʒ ə m
hemoroid	h e m o r o j d
găozar	ɡ ə w z a r
spermei	s p e r m e j
or	o r
numiților	n u m i t͡s i l o r
scrotalilor	s k r o t a l i l o r
fundași	f u n d a ʃʲ
fumarăți	f u m a r ə t sʲ
poziție	p o z i t s i e
grăbiseră	ɡ r ə b i s e r ə
șantajară	ʃ a n t a ʒ a r ə
cenzuraserăm	t͡ʃ e n z u r a s e r ə m
numele	n u m e l e
tentați	t e n t a t͡sʲ
tentând	t e n t ɨ n d
porți	p o r t sʲ
folosirăm	f o l o s i r ə m
pun	p u n
gravitai	ɡ r a v i t a j
fututului	f u t u t u l u j
perfectaseși	p e r f e k t a s e ʃʲ
frumos	f r u m o s
diaconescu	d i a k o n e s k u
dușmăneau	d u ʃ m ə n j a w
șoptisem	ʃ o p t i s e m
sexuala	s e k s u a l a
clădiseră	k l ə d i s e r ə
cambodgia	k a m b o d͡ʒ i a
stimulăm	s t i m u l ə m
perineului	p e r i n e u l
apocalipticei	a p o k a l i p t i t͡ʃ e j
halucinație	h a l u t͡ʃ i n a t͡s i e
întâlnise	ɨ n t ɨ l n i s e
ataca	a t a k a
masturbarăți	m a s t u r b a r ə t͡sʲ
prepuț	p r ɛ p u t s
pașaport	p a ʃ a p o r t
rom	r o m
mărturisise	m ə r t u r i s i s e
călătoritei	k ə l ə t o r i t e j
torturași	t o r t u r a ʃʲ
înzestrăm	ɨ n z e s t r ə m
urăști	u r ə ʃ tʲ
abil	a b i l
porno	p o r n o
sodomizaseși	s o d o m i z a s e ʃʲ
sfârșită	s f ɨ r ʃ i t ə
întristând	ɨ n t r i s t ɨ n d
urinaseși	u r i n a s e ʃʲ
ejaculați	e ʒ a k u l a t͡sʲ
puteți	p u t e t͡sʲ
regina	r e d͡ʒ i n a
fapt	f a p t
dorințelor	d o r i n t͡s e l o r
vorbiră	v o r b i r ə
torturând	t o r t u r ɨ n d
cultura	k u l t u r a
orienta	o r i e n t a
pungi	p u n d͡ʒʲ
traducere	t r a d u t͡ʃ e r e
lucrez	l u k r e z
bunic	b u n i k
bănescu	b ɘ n e s k u
perinee	p e r i n eː
același	a t͡ʃ e l a ʃʲ
opresc	o p r e s k
torturase	t o r t u r a s e
mărturisiților	m ə r t u r i s i t͡s i l o r
găsise	ɡ ə s i s e
pianist	p i a n i s t
opriserăți	o p r i s e r ə t sʲ
gravitasem	ɡ r a v i t a s e m
grăbirăm	ɡ r ə b i r ə m
pregătea	p r e ɡ ə t j a
porniți	p o r n i t͡sʲ
formelor	f o r m e l o r
neutri	n e u t r i
mulțumeam	m u l t s u m j a m
discret	d i s k r e t
cotidian	k o t i d i a n
călinescu	k ə l i n e s k u
moldovenesc	m o l d o v e n e s k
tentasem	t e n t a s e m
primiserăm	p r i m i s e r ə m
urdă	u r d ə
narcotiza	n a r k o t i z a
legea	l e d͡ʒ e̯ a
genă	d͡ʒ e n ə
lins	l i n s
perfectase	p e r f e k t a s e
paraziți	p a r a z i t͡sʲ
stimulasem	s t i m u l a s e m
pregătiseră	p r e ɡ ə t i s e r ə
seduc	s e d u k
fulg	f u l ɡ
tastatură	t a s t a t u r ə
mingi	m i n d͡ʒʲ
fuseserăți	f u s e s e r ə t͡sʲ
genunchi	d ʒ e n u n kʲ
feminitate	f e m i n i t a t e
frontieră	f r o n t i e r ə
furculiță	f u r k u l i t͡s ə
sodomizăm	s o d o m i z ə m
tatuez	t a t u e z
iar	j a r
erau	e r a w
sorin	s o r i n
supseserăm	s u p s e s e r ə m
creași	k r e a ʃʲ
perfectăm	p e r f e k t ə m
publicitate	p u b l i t͡ʃ i t a t e
clădisem	k l ə d i s e m
lacrimă	l a k r i m ə
boș	b o ʃ
central	t͡ʃ e n t r a l
acceleraserăți	a k t͡ʃ e l e r a s e r ə t sʲ
delimitasem	d e l i m i t a s e m
dumitrescu	d u m i t r e s k u
analizat	a n a l i z a t
analizăm	a n a l i z ə m
vampiră	v a m p i r ə
șantajurile	ʃ a n t a ʒ u r i l e
normalitate	n o r m a l i t a t e
urineze	u r i n e z e
simpli	s i m p l i
teatru	t e̯ a t r u
telega	t e l ɛ ɡ a
complexități	c o m p l e k s i t ə t͡sʲ
cânt	k ɨ n t
amintește	a m i n t e ʃ t e
canadian	k a n a d i a n
întâlnită	ɨ n t ɨ l n i t ə
vieții	v j e t s iː
numiși	n u m i ʃʲ
deliram	d e l i r a m
zahărului	z a h ə r u l u j
veștejești	v e ʃ t e ʒ e ʃ tʲ
protejau	p r o t e ʒ a w
asurzeau	a s u r z j a w
făceam	f ə t͡ʃ e̯ a m
vorbii	v o r b iː
înțeles	ɨ n t s e l e s
clădirăți	k l ə d i r ə t sʲ
cântărețe	k ɨ n t ə r e t͡s e
funcționam	f u n k t͡s i o n a m
opiu	o p j u
enigmatice	e n i ɡ m a t i t͡ʃ e
exemplului	e ɡ z e m p l u l u i
nereal	n e r e a l
plictisită	p l i k t i s i t ə
scrumieră	s k r u m i e r ə
suedez	s u e d e z
înzestrai	ɨ n z e s t r a j
primească	p r i m e̯ a s k ə
perfectași	p e r f e k t a ʃʲ
perineelor	p e r i n eː l o r
ști	ʃ t i
pregătisem	p r e ɡ ə t i s e m
papi	p a pʲ
burtă	b u r t ə
sfârșești	s f ɨ r ʃ e ʃ tʲ
picolo	p i k o l o
mărturisi	m ə r t u r i s i
somam	s o m a m
întăriseși	ɨ n t ə r i s e ʃʲ
călătoriseși	k ə l ə t o r i s e ʃʲ
răpiseși	r ə p i s e ʃʲ
mioveni	m i o v ɛ nʲ
stimularăți	s t i m u l a r ə t sʲ
mânca	m ɨ n k a
sufletele	s u f l e t e l e
îi	ɨ j
proști	p r o ʃ tʲ
parazit	p a r a z i t
amarilisului	a m a r i l i s u l u j
numiră	n u m i r ə
sodomizară	s o d o m i z a r ə
slovacă	s l o v a k ə
citesc	t ʃ i t e s k
grăbii	ɡ r ə b iː
sodomizaților	s o d o m i z a t͡s i l o r
întâlniți	ɨ n t ɨ l n i t͡sʲ
băiețașii	b ə j e t s a ʃ iː
turnuri	t u r n u rʲ
boală	b w a l ə
oglindă	o ɡ l i n d ə
întăriți	ɨ n t ə r i t͡sʲ
nenorocitule	n e n o ɾ o t͡ʃ i t u l e
umani	u m a nʲ
ăsta	ə s t a
homosexuale	h o m o s e k s u a l e
călătorisem	k ə l ə t o r i s e m
substanțe	s u b s t a n t͡s e
numitelor	n u m i t e l o r
penă	p e n ə
frumoasei	f r u m o̯ a s e j
întărise	ɨ n t ə r i s e
maro	m a ɾ o
coi	k o j
erecție	ɛ r ɛ k t s i j ɛ
veștejit	v e ʃ t e ʒ i t
nuia	n u j a
șurubelniță	ʃ u r u b e l n i t s ə
susure	s u s u r e
câștigați	k ɨ ʃ t i ɡ a t͡sʲ
cuvintelor	k u v i n t e l o r
întristam	ɨ n t r i s t a m
resursă	r e s u r s ə
mulțumiseră	m u l t s u m i s e r ə
numisem	n u m i s e m
grăbita	ɡ r ə b i t a
îmbunătățiră	ɨ m b u n ə t ə t s i r ə
clădirăm	k l ə d i r ə m
călătorită	k ə l ə t o r i t ə
misterioșii	m i s t e r i o ʃ i j
analizase	a n a l i z a s e
pornograficului	p o r n o ɡ r a f i k u l u j
fumeze	f u m e z e
deranjaserăm	d e r a n ʒ a s e r ə m
întristat	ɨ n t r i s t a t
adăpa	a d ə p a
pălămidă	p ə l ə m i d ə
întâlniră	ɨ n t ɨ l n i r ə
azer	a z e r
perfect	p e r f e k t
sodomizeze	s o d o m i z e z e
zăpușii	z ə p u ʃ iː
răpiți	r ə p i t͡sʲ
unul	u n u l
bărbătesc	b ə r b ə t e s k
eroticelor	e r o t i t͡ʃ e l o r
vorbiși	v o r b i ʃʲ
cheie	k e j e
frecarăm	f r e k a r ə m
găsitului	ɡ ə s i t u l u j
sfârșeam	s f ɨ r ʃ j a m
pecunie	p e k u n i e
călătorește	k ə l ə t o r e ʃ t e
aburi	a b u r i
necăjitei	n e k ə ʒ i t e j
fețele	f e t s e l e
torturarăți	t o r t u r a r ə t sʲ
vioară	v i o̯ a ɾ ə
pregătitele	p r e ɡ ə t i t e l e
îmbunătățiți	ɨ m b u n ə t ə t͡s i t͡sʲ
poșetă	p o ʃ e t ə
întărea	ɨ n t ə r j a
fântână	f ɨ n t ɨ n ə
cititului	t͡ʃ i t i t u l u j
perfectai	p e r f e k t a j
folositelor	f o l o s i t e l o r
mulțumitelor	m u l t͡s u m i t e l o r
șantajuri	ʃ a n t a ʒ u rʲ
ubicuelor	u b i k u e l o r
cititele	t͡ʃ i t i t e l e
mulțumită	m u l t͡s u m i t ə
tatuă	t a t u ə
ubicuă	u b i k u ə
baia	b a j a
bardou	b a r d o w
veștejirăm	v e ʃ t e ʒ i r ə m
fac	f a k
iubească	j u b e̯ a s k ə
pregătesc	p r e ɡ ə t e s k
orientau	o r i e n t a w
știm	ʃ t i m
întăriserăți	ɨ n t ə r i s e r ə t sʲ
omniprezențelor	o m n i p r e z e n t s e l o r
eroticii	e r o t i t͡ʃ iː
distraseră	d i s t r a s e r ə
tatuaserăm	t a t u a s e r ə m
necăjiseși	n e k ə ʒ i s e ʃʲ
serii	s e r iː
erogen	e r o d͡ʒ e n
simplu	s i m p l u
unde	u n d e
sugea	s u d͡ʒ e̯ a
numiseși	n u m i s e ʃʲ
câmpina	k ɨ̯ m p i n a
năluciți	n ə l u t͡ʃ i t͡sʲ
buzărnescu	b u z ə r n e s k u
freacă	f rʲ æ k ə
boșului	b o ʃ u l u j
demnitate	d e m n i t a t e
limita	l i m i t a
întristai	ɨ n t r i s t a j
futui	f u t uʲ
cenzurai	t͡ʃ e n z u r a j
orientă	o r i e n t ə
iubim	j u b i m
făgăraș	f ə ɡ ə r a ʃ
întristez	ɨ n t r i s t e z
soț	s o t s
timpuri	t i m p u rʲ
întâlnească	ɨ n t ɨ l n j a s k ə
abandonează	a b a n d o n j a z ə
cirac	t͡ʃ i r a k
sugere	s u d͡ʒ e r e
întăreau	ɨ n t ə r j a w
grăbea	ɡ r ə b j a
clăditei	k l ə d i t e j
buca	b u k a
acelorași	a t͡ʃ e l o r a ʃʲ
masturbaseși	m a s t u r b a s e ʃʲ
răpirăm	r ə p i r ə m
pulă	p u l ə
visului	v i s u l u j
supseși	s u p s e ʃʲ
tatuau	t a t u a w
futurăți	f u t u r ə t͡sʲ
produce	p r o d u t ʃ e
slovenei	s l o v e n e j
norilor	n o r i l o r
deja	d e ʒ a
bărbătește	b ə r b ə t e ʃ t e
oprind	o p r i n d
tovărășie	t o v ə r ə ʃ i e
zăpușitului	z ə p u ʃ i t u l u j
sodomizând	s o d o m i z ɨ n d
nălucitei	n ə l u t͡ʃ i t e j
cartof	k a r t o f
avantaje	a v a n t a ʒ e
șoptim	ʃ o p t i m
sângeraserăm	s ɨ n d͡ʒ e r a s e r ə m
preludiu	p r e l u d j u
pădure	p ə d u ɾ e
șantajarăți	ʃ a n t a ʒ a r ə t͡sʲ
în	ɨ n
sodomizat	s o d o m i z a t
urinau	u r i n a w
creăm	k r e ə m
răbda	r ə b d a
ejaculai	e ʒ a k u l a j
citea	t ʃ i t j a
habar	h a b a r
tentante	t e n t a n t e
necăjiserăm	n e k ə ʒ i s e r ə m
îmbunătățirăm	ɨ m b u n ə t ə t s i r ə m
numerele	n u m e r e l e
așa	a ʃ a
îmbunătățita	ɨ m b u n ə t ə t͡s i t a
perfectează	p e r f e k t j a z ə
erogeni	e r o d ʒ e nʲ
limitaserăm	l i m i t a s e r ə m
gravitează	ɡ r a v i t j a z ə
distra	d i s t r a
biofizică	b i o f i z i k ə
gândita	ɡ ɨ n d i t a
penis	p e n i s
locuace	l o k w a t͡ʃ e
fraternitate	f r a t e r n i t a t e
vin	v i n
plictisisem	p l i k t i s i s e m
șantajiste	ʃ a n t a ʒ i s t e
jucărie	ʒ u k ə r i e
sodomizată	s o d o m i z a t ə
mulțumiților	m u l t͡s u m i t͡s i l o r
călătoreau	k ə l ə t o r j a w
sângeros	s ɨ n d͡ʒ e r o s
arșița	a r ʃ i t s a
lipsita	l i p s i t a
jachetă	ʒ a k e t ə
mușca	m u ʃ k a
mulțumit	m u l t s u m i t
bulbuca	b u l b u k a
excavând	e k s k a v ɨ n d
porniserăți	p o r n i s e r ə t sʲ
babă	b a b ə
promițând	p r o m i t s ɨ n d
găsitelor	ɡ ə s i t e l o r
copleșitoarea	k o p l e ʃ i t o̯ a r e̯ a
morcov	m o r k o v
numite	n u m i t e
nori	n o rʲ
prietenește	p r i e t e n e ʃ t e
câștig	k ɨ ʃ t i ɡ
funcționă	f u n k t͡s i o n ə
cumnat	k u m n a t
limbii	l i m b iː
modalitate	m o d a l i t a t e
haotic	h a o t i k
controlez	k o n t r o l e z
numi	n u m i
iubisem	j u b i s e m
îmbunătățeați	ɨ m b u n ə t ə t s j a t sʲ
excavași	e k s k a v a ʃʲ
citeați	t ʃ i t j a t sʲ
penisurile	p e n i s u r i l e
privi	p r i v i
întristasem	ɨ n t r i s t a s e m
plictiseau	p l i k t i s j a w
somaserăți	s o m a s e r ə t sʲ
pilotase	p i l o t a a s e
frumoșii	f r u m o ʃ i j
mulțumim	m u l t s u m i m
basma	b a s m a
lipsii	l i p s iː
rășină	ɾ ə ʃ i n ə
veștejiră	v e ʃ t e ʒ i r ə
sodomizații	s o d o m i z a t͡s iː
delirează	d e l i r e̯ a z ə
bestial	b e s t i a l
urinasem	u r i n a s e m
vergi	v e r d͡ʒʲ
primiseră	p r i m i s e r ə
avansa	a v a n s a
primii	p r i m iː
șoptiserăm	ʃ o p t i s e r ə m
porneam	p o r n j a m
croi	k r o i
funcționați	f u n k t͡s i o n a t͡sʲ
crucifica	k r u t͡ʃ i f i k a
găsesc	ɡ ə s e s k
făcui	f ə k u j
secvență	s e k v e n t s ə
manechinele	m a n e k i n e l e
formaserăm	f o r m a s e r ə m
accelerez	a k t͡ʃ e l e r e z
americance	a m e ɾ i k a n t͡ʃ e
sandviș	s a n d v i ʃ
veștejii	v e ʃ t e ʒ iː
sacoșă	s a k o ʃ ə
clara	k l a r a
somaseși	s o m a s e ʃʲ
vale	v a l e
stomac	s t o m a c
localitate	l o k a l i t a t e
sonet	s o n e t
înțelegeți	ɨ n t s e l e d ʒ e t sʲ
tentează	t e n t j a z ə
excavezi	e k s k a v e zʲ
orientat	o r i e n t a t
călătoreai	k ə l ə t o r j a j
șantajaseși	ʃ a n t a ʒ a s e ʃʲ
necăjiși	n e k ə ʒ i ʃʲ
tipe	t i p e
citit	t ʃ i t i t
pipi	p i p i
juisezi	ʒ u i s e zʲ
nimănui	n i m ə n u j
ajut	a ʒ u t
zonei	z o n e j
sacru	s a k r u
viezure	v j e z u r e
curvă	k u r v ə
controlasem	k o n t r o l a s e m
frecam	f r e k a m
deranjăm	d e r a n ʒ ə m
lua	l u a
pilotat	p i l o t a a t
veștejește	v e ʃ t e ʒ e ʃ t e
masturbator	m a s t u r b a t o r
eligibilitate	e l i d͡ʒ i b i l i t a t e
sângerând	s ɨ n d͡ʒ e r ɨ n d
amintesc	a m i n t e s k
ejaculaserăți	e ʒ a k u l a s e r ə t sʲ
brunei	b r u n e j
leoaică	l e o̯ w a i̯ k ə
vocală	v o k a l ə
săptămână	s ə p t ə m ɨ n ə
strungă	s t r u n ɡ ə
citeam	t ʃ i t j a m
acestea	a t ʃ e s t e̯ a
păianjenii	p ə j a n ʒ e n iː
nicicând	n i t͡ʃʲ k ɨ n d
mari	m a rʲ
autoritate	a u t o r i t a t e
sângerează	s ɨ n d͡ʒ e r j a z ə
slovenelor	s l o v e n e l o r
fată	f a t ə
albaneză	a l b a n e z ə
viețile	v j e t s i l e
dormim	d o r m i m
sfârșiră	s f ɨ r ʃ i r ə
dușmănească	d u ʃ m ə n j a s k ə
scrotalele	s k r o t a l e l e
formaseră	f o r m a s e r ə
mersi	m e ɾ s i
limitează	l i m i t j a z ə
graviteze	ɡ r a v i t e z e
înălțime	ɨ n ə l t͡s i m e
părintesc	p ə r i n t e s k
indiscreție	i n d i s k r e t͡s i e
întăriții	ɨ n t ə r i t͡s iː
rea	r e̯ a
mișca	m i ʃ k a
francez	f r a n t͡ʃ e z
asurzitului	a s u r z i t u l u j
ați	a t͡sʲ
intui	i n t u i
gândea	ɡ ɨ n d j a
portret	p o r t r e t
masturbând	m a s t u r b ɨ n d
acestor	a t͡ʃ e s t o r
folosiră	f o l o s i r ə
epocă	e p o k ə
întristăm	ɨ n t r i s t ə m
iubirile	j u b i r i l e
păpa	p ə p a
excavarăți	e k s k a v a r ə t sʲ
câștige	k ɨ ʃ t i d͡ʒ e
răpita	r ə p i t a
spovedește	s p o v e d e ʃ t e
zonelor	z o n e l o r
stimulară	s t i m u l a r ə
răpise	r ə p i s e
plictisiră	p l i k t i s i r ə
abandonați	a b a n d o n a t sʲ
asurzeați	a s u r z j a t sʲ
acoperi	a k o p e r i
înzestraseră	ɨ n z e s t r a s e r ə
mărturisitele	m ə r t u r i s i t e l e
cenzurau	t͡ʃ e n z u r a w
numitului	n u m i t u l u j
neîmbunătățit	n e ɨ m b u n ə t ə t͡s i t
pregătite	p r e ɡ ə t i t e
orientări	o r i e n t ə rʲ
jure	ʒ u r e
căprioară	k ə p r i o̯ a r ə
bună	b u n ə
grăbiților	ɡ r ə b i t͡s i l o r
fusese	f u s e s e
pulosului	p u l o s u l u j
mulțumise	m u l t s u m i s e
prosti	p r o s t i
măști	m ə ʃ tʲ
română	r o m ɨ n ə
întâlnite	ɨ n t ɨ l n i t e
iubise	j u b i s e
americană	a m e r i k a n ə
iluzoriile	i l u z o r iː l e
crunt	k r u n t
mărturisească	m ə r t u r i s j a s k ə
izvor	i z v o ɾ
controlat	k o n t r o l a t
stele	s t e l e
croația	k r o a t͡s i a
îmbunătățiserăți	ɨ m b u n ə t ə t s i s e r ə t sʲ
șoptiră	ʃ o p t i r ə
ecosistem	e k o s i s t e m
futurăm	f u t u r ə m
săi	s ə j
traduceri	t r a d u t ʃ e rʲ
folosiților	f o l o s i t͡s i l o r
cred	k r ɛ d
întristași	ɨ n t r i s t a ʃʲ
controlam	k o n t r o l a m
orice	o rʲ t͡ʃ e
plat	p l a t
veștejesc	v e ʃ t e ʒ e s k
mărturiseai	m ə r t u r i s j a j
iubești	j u b e ʃ tʲ
plictisiseși	p l i k t i s i s e ʃʲ
triste	t r i s t e
părinți	p ə r i n t͡sʲ
minoritate	m i n o r i t a t e
beata	b e̯ a t a
ubicuele	u b i k u e l e
ejaculezi	e ʒ a k u l e zʲ
juiseze	ʒ u i s ə z e
zăpușiși	z ə p u ʃ i ʃʲ
tatuarăm	t a t u a r ə m
dovedi	d o v e d i
gravitau	ɡ r a v i t a w
mănânce	m ə n ɨ n t͡ʃ e
bulgar	b u l ɡ a r
futu	f u t u
motive	m o t i v e
scrotale	s k r o t a l e
vorbeați	v o r bʲ æ t͡sʲ
întâlnitele	ɨ n t ɨ l n i t e l e
păltineni	p ɘ l t i n ɛ nʲ
zăpușiserăm	z ə p u ʃ i s e r ə m
foloseau	f o l o s j a w
lipseați	l i p s j a t sʲ
îmbunătățitelor	ɨ m b u n ə t ə t͡s i t e l o r
întâlniții	ɨ n t ɨ l n i t͡s iː
alege	a l e d͡ʒ e
macedoneancă	m a t͡ʃ e d o n e̯ a n k ə
iluzorii	i l u z o r iː
alte	a l t e
audacie	a u d a t͡ʃ i e
antarctica	a n t a r k t i k a
nemilă	n e m i l ə
veștejeai	v e ʃ t e ʒ e̯ a j
pregăteau	p r e ɡ ə t j a w
perfectând	p e r f e k t ɨ n d
frecarăți	f r e k a r ə t͡sʲ
clădiserăți	k l ə d i s e r ə t sʲ
mărturiseau	m ə r t u r i s j a w
reduce	r e̞ d̪ u t ʃ e̞
jos	ʒ o s
sloboz	s l o b o z
umane	u m a n e
excavez	e k s k a v e z
mărturisești	m ə r t u r i s e ʃ tʲ
dicționare	d i k t͡s i o n a r e
amsterdam	a m s t e r d a m
maturitate	m a t u r i t a t e
pregătiților	p r e ɡ ə t i t͡s i l o r
arbore	a r b o r e
simpla	s i m p l a
delirase	d e l i r a j
scroturi	s k r o t u rʲ
citise	t ʃ i t i s e
limitaseși	l i m i t a s e ʃʲ
zăpușeau	z ə p u ʃ j a w
băieței	b ə j e t͡s e j
urinaseră	u r i n a s e r ə
biblioteca	b i b l i o t e k a
șoptea	ʃ o p t j a
creați	k r e a t͡sʲ
dătător	d ə t ə t o r
zăpușim	z ə p u ʃ i m
paradoxuri	p a r a d o k s u rʲ
ciudat	t͡ʃ u d a t
limba	l i m b a
deranjarăți	d e r a n ʒ a r ə t sʲ
șarpe	ʃ a r p e
frecară	f r e k a r ə
mărturisite	m ə r t u r i s i t e
ubicuitate	u b i k u i t a t e
lipsiși	l i p s i ʃʲ
plictisești	p l i k t i s e ʃ tʲ
primeați	p r i m j a t sʲ
mărturisește	m ə r t u r i s e ʃ t e
ataraxio	a t a r a k s i o
găsitele	ɡ ə s i t e l e
mișto	m i ʃ t o
laptele	l a p t e l e
sperme	s p e r m e
somasem	s o m a s e m
orientare	o r i e n t a r e
ape	a p e
șansă	ʃ a n s ə
literă	l i t e r ə
flacără	f l a k ə r ə
făcuserăți	f ə k u s e r ə t͡sʲ
mărturisirăm	m ə r t u r i s i r ə m
somase	s o m a s e
copleșitoarei	k o p l e ʃ i t o̯ a r e j
călătorita	k ə l ə t o r i t a
mărturisită	m ə r t u r i s i t ə
veștejiseși	v e ʃ t e ʒ i s e ʃʲ
război	r ə z b o j
gândeam	ɡ ɨ n d j a m
protejaserăm	p r o t e ʒ a s e r ə m
grăbească	ɡ r ə b j a s k ə
cenzurezi	t͡ʃ e n z u r e zʲ
apocalipticelor	a p o k a l i p t i t͡ʃ e l o r
venerase	v e n e r a s e
beau	bʲ æ w
pregătiții	p r e ɡ ə t i t͡s iː
moldovenească	m o l d o v e n e̯ a s k ə
protejaseși	p r o t e ʒ a s e ʃʲ
pilotăm	p i l o t a ə m
proteja	p r o t e ʒ a
orientaseși	o r i e n t a s e ʃʲ
călătorești	k ə l ə t o r e ʃ tʲ
excitat	e k s t ʃ i t a t
voastră	v o̯ a s t r ə
perfectară	p e r f e k t a r ə
dușmănitele	d u ʃ m ə n i t e l e
africa	a f r i k a
distrară	d i s t r a r ə
folosi	f o l o s i
făcea	f ə t͡ʃ e̯ a
torturasem	t o r t u r a s e m
sfârșite	s f ɨ r ʃ i t e
șantajaților	ʃ a n t a ʒ a t͡s i l o r
lipsim	l i p s i m
iubiseși	j u b i s e ʃʲ
azerbaidjan	a z e r b a j d͡ʒ a n
veștejitele	v e ʃ t e ʒ i t e l e
spovediți	s p o v e d i t͡sʲ
canada	k a n a d a
înjurătură	ɨ n ʒ u r ə t u r ə
memorie	m e m o r i e
copiilor	k o p i j l o r
iubirăm	j u b i r ə m
dușmăniților	d u ʃ m ə n i t͡s i l o r
orientează	o r i e n t j a z ə
necăjita	n e k ə ʒ i t a
mănâncă	m ə n ɨ n k ə
masturbau	m a s t u r b a w
aici	a i t͡ʃʲ
stimulaseră	s t i m u l a s e r ə
transilvania	t r a n s i l v a n i a
vocale	v o k a l e
vulpe	v u l p e
evlavia	e v l a v i a
smochină	s m o k i n ə
protejarăm	p r o t e ʒ a r ə m
sodomizarăți	s o d o m i z a r ə t͡sʲ
halucinogen	h a l u t͡ʃ i n o d͡ʒ e n
comunitate	k o m u n i t a t e
cărticică	k ɘ̯ ʳ t i t͡ʃ i k ə
perfectați	p e r f e k t a t͡sʲ
oprii	o p r iː
scurtești	s k u r t ɛ ʃ tʲ
dezavantajos	d e z a v a n t a ʒ o s
gât	ɡ ɨ t
ghiuj	ɡ j u ʒ
delirăm	d e l i r ə m
analizasem	a n a l i z a s e m
limitau	l i m i t a w
găsim	ɡ ə s i m
delirară	d e l i r a r ə
izraelit	i z r a e l i t
îmbunătățește	ɨ m b u n ə t ə t s e ʃ t e
fuserăți	f u s e r ə t͡sʲ
spermele	s p e r m e l e
puțoi	p u t s o j
matematică	m a t e m a t i k ə
facilitate	f a t ʃ i l i t a t e
lipsiți	l i p s i t͡sʲ
lingura	l i ŋ ɡ u r a
soliditate	s o l i d i t a t e
ejacularăm	e ʒ a k u l a r ə m
sloveni	s l o v e nʲ
gândisem	ɡ ɨ n d i s e m
somarăți	s o m a r ə t sʲ
danezi	d a n e zʲ
produci	p r o d u t͡ʃʲ
acioaie	a t ʃ i w a j e
șoptirăți	ʃ o p t i r ə t sʲ
sexuali	s e k s u a lʲ
sufăr	s u f ə r
fii	f iː
clădeai	k l ə d j a j
gândești	ɡ ɨ n d e ʃ tʲ
găsita	ɡ ə s i t a
urinași	u r i n a ʃʲ
necăjeau	n e k ə ʒ j a w
clădi	k l ə d i
misterioase	m i s t e r i o̯ a s e
funicular	f u n i k u l a ʳ
sodomizatelor	s o d o m i z a t e l o r
grăbi	ɡ r ə b i
fantezia	f a n t e z i a
grăbind	ɡ r ə b i n d
dicționarului	d i k t͡s i o n a r u l u j
sugeau	s u d͡ʒ e̯ a w
criminal	k r i m i n a l
vorbesc	v o r b e s k
țării	t͡s ə r i
folosii	f o l o s iː
oprirăți	o p r i r ə t sʲ
albanezi	a l b a n e zʲ
mascul	m a s k u l
grăbește	ɡ r ə b e ʃ t e
pioni	p i o nʲ
culturilor	k u l t u r i l o r
rar	r a r
estoniană	e s t o n i a n ə
homosexuali	h o m o s e k s u a lʲ
tunet	t u n e t
molie	m o l i e
întâlnea	ɨ n t ɨ l n j a
bogat	b o ɡ a t
finlandei	f i n l a n d e j
călătoare	k ə l ə t o̯ a r e
bărbaților	b ə r b a t͡s i l o r
înzestrase	ɨ n z e s t r a s e
desigur	d e s i ɡ u r
abilă	a b i l ə
delir	d e l i r
urâm	u r ɨ m
lipseai	l i p s j a j
tatuajele	t a t u a ʒ e l e
primești	p r i m e ʃ tʲ
păros	p ə r o s
homosexualele	h o m o s e k s u a l e l e
lingurii	l i ŋ ɡ u r iː
ejaculasem	e ʒ a k u l a s e m
popularitate	p o p u l a r i t a t e
numiții	n u m i t͡s iː
harpă	h a r p ə
personalitate	p e r s o n a l i t a t e
înzestra	ɨ n z e s t r a
întărite	ɨ n t ə r i t e
aceiași	a t͡ʃ e j a ʃʲ
năluciserăm	n ə l u t ʃ i s e r ə m
misterioasa	m i s t e r i o̯ a s a
protejezi	p r o t e ʒ e zʲ
păianjenilor	p ə j a n ʒ e n i l o r
chilot	k i l o t͡sʲ
coreei	k o r eː j
cururi	k u r u rʲ
delireze	d e l i r e z e
controlarăți	k o n t r o l a r ə t sʲ
șantajai	ʃ a n t a ʒ a j
dinte	d i n t e
umiditate	u m i d i t a t e
pungă	p u n ɡ ə
șantajele	ʃ a n t a ʒ e l e
apa	a p a
asurzirăți	a s u r z i r ə t sʲ
mâncă	m ɨ n k ə
fumând	f u m ɨ n d
acuma	a k u m a
gravitați	ɡ r a v i t a t͡sʲ
vrei	v r e j
legi	l e d͡ʒʲ
franța	f r a n t͡s a
omniprezenții	o m n i p r e z e n t͡s iː
seșă	s e ʃ ə
simplitate	s i m p l i t a t e
copleșitori	k o p l e ʃ i t o rʲ
sălbatică	s ə l b a t i k ə
apocalipse	a p o k a l i p s e
creai	k r e a j
sugeai	s u d͡ʒ e̯ a j
zeu	z e w
bărbații	b ə r b a t͡s iː
anatemelor	a n a t e m e l o r
neamț	n e̯ a m t s
necăjind	n e k ə ʒ i n d
controla	k o n t r o l a
formaților	f o r m a t͡s i l o r
argintiu	a ɾ d͡ʒ i n t i w
neerlandeză	n e e r l a n d e z ə
mâncarăm	m ɨ n k a r ə m
frumoasă	f r u m o̯ a s ə
lipsiseră	l i p s i s e r ə
ofer	o f e r
păianjeni	p ə j a n ʒ e nʲ
mărturiseați	m ə r t u r i s j a t sʲ
distrat	d i s t r a t
creând	k r e ɨ n d
grăbiserăți	ɡ r ə b i s e r ə t sʲ
finlandez	f i n l a n d e z
veninos	v e n i n o s
exemplu	e ɡ z e m p l u
creativitate	k r e a t i v i t a t e
hamacuri	h a m a k u rʲ
uimitor	u j m i t o r
frumoase	f r u m o̯ a s e
clădeau	k l ə d j a w
opreați	o p r j a t sʲ
proci	p ɾ o t͡ʃʲ
sângerez	s ɨ n d͡ʒ e r e z
grăbeau	ɡ r ə b j a w
muntenia	m u n t e n i a
lucru	l u k r u
daci	d a t͡ʃʲ
animali	a n i m a lʲ
ejaculași	e ʒ a k u l a ʃʲ
frecaseși	f r e k a s e ʃʲ
perineul	p e r i n e u l
regilor	r e d͡ʒ i l o r
înzestram	ɨ n z e s t r a m
perineu	p e r i n e w
tenteze	t e n t e z e
erotica	e r o t i k a
exclusivitate	e k s k l u s i v i t a t e
veșnic	v e ʃ n i k
crearăm	k r e a r ə m
grăbitele	ɡ r ə b i t e l e
lituania	l i t u a n i a
sexuală	s e k s u a l ə
găseați	ɡ ə s j a t sʲ
câștigat	k ɨ ʃ t i ɡ a t
necăjesc	n e k ə ʒ e s k
lingi	l i n d ʒʲ
releu	r e l e u
dușmănesc	d u ʃ m ə n e s k
alcool	a l k o o l
hai	h a j
spovedeai	s p o v e d j a j
dicționarelor	d i k t͡s i o n a r e l o r
citii	t ʃ i t iː
tiran	t i r a n
aburit	a b u r i t
terminaserăm	t e r m i n a s e r ə m
mulțumii	m u l t s u m iː
spaniolește	s p a n i o l e ʃ t e
ușuratic	u ʃ u r a t i k
necăjisem	n e k ə ʒ i s e m
clădiți	k l ə d i t͡sʲ
înzestrată	ɨ n z e s t r a t ə
tricot	t r i k o t
răpiseră	r ə p i s e r ə
nălucitului	n ə l u t͡ʃ i t u l u j
iarăși	j a r ə ʃʲ
clădiseși	k l ə d i s e ʃʲ
clădim	k l ə d i m
mica	m i k a
surori	s u r o rʲ
veștejeau	v e ʃ t e ʒ e̯ a u
plictisitei	p l i k t i s i t e j
vedeți	v e d e t͡sʲ
plictisim	p l i k t i s i m
linge	l i n d ʒ e
dai	d a j
futut	f u t u t
gravitarăți	ɡ r a v i t a r ə t sʲ
milă	m i l ə
formase	f o r m a s e
funcționai	f u n k t͡s i o n a j
ejaculaserăm	e ʒ a k u l a s e r ə m
fumasem	f u m a s e m
veștejite	v e ʃ t e ʒ i t e
sălbatic	s ə l b a t i k
șopti	ʃ o p t i
pregătitului	p r e ɡ ə t i t u l u j
călătoriții	k ə l ə t o r i t͡s iː
unit	u n i t
tatăl	t a t ə l
orientarăm	o r i e n t a r ə m
piele	p j e l e
opritei	o p r i t e j
dimineților	d i m i n e t s i l o r
fluture	f l u t u r e
tânji	t ɨ n ʒ i
spovedi	s p o v e d i
asurzitele	a s u r z i t e l e
moscova	m o s k o v a
călătoriseră	k ə l ə t o r i s e r ə
deci	d e t͡ʃʲ
funcționează	f u n k t͡s i o n j a z ə
primesc	p r i m e s k
explicare	e k s p l i k a r e
borî	b o r ɨ
cenzurarăți	t͡ʃ e n z u r a r ə t sʲ
observații	o b s e r v a t͡s iː
scrotalei	s k r o t a l e j
înțelegi	ɨ n t͡s e l e d͡ʒʲ
șantajasem	ʃ a n t a ʒ a s e m
lovit	l o v i t
agentă	a d͡ʒ e n t ə
sexy	s e k s i
delimitară	d e l i m i t a r ə
arșiță	a r ʃ i t s ə
prieteni	p r i e t e nʲ
delirând	d e l i r ɨ n d
enigmatic	e n i ɡ m a t i k
sodomizaserăm	s o d o m i z a s e r ə m
somară	s o m a r ə
citiți	t͡ʃ i t i t͡sʲ
beam	bʲ a m
cenzurând	t͡ʃ e n z u r ɨ n d
lipsitei	l i p s i t e j
lucruri	l u k r u rʲ
acum	a k u m
primit	p r i m i t
zăpușisem	z ə p u ʃ i s e m
anatemă	a n a t e m ə
frumoasa	f r u m o̯ a s a
torturam	t o r t u r a m
acesta	a t͡ʃ e s t a
seducție	s e d u k t͡s i e
sânge	s ɨ n d͡ʒ e
ani	a nʲ
coleg	k o l e ɡ
clădească	k l ə d j a s k ə
îmbunătățitele	ɨ m b u n ə t ə t͡s i t e l e
deschide	d e s k i d e
japonez	ʒ a p o n e z
exist	e ɡ z i s t
abandonau	a b a n d o n a w
stimulaseși	s t i m u l a s e ʃʲ
facem	f a t͡ʃ e m
citirăți	t ʃ i t i r ə t sʲ
apocalipticilor	a p o k a l i p t i t͡ʃ i l o r
vei	v e j
călătoriților	k ə l ə t o r i t͡s i l o r
soarele	s o̯ a r e l e
lexem	l e k s e m
întristează	ɨ n t r i s t j a z ə
stimula	s t i m u l a
ironie	i r o n j e
sfinx	s f i n k s
homofob	h o m o f o b
găseai	ɡ ə s j a j
și	ʃ i
delirurilor	d e l i r u r i l o r
cântărețului	k ɨ n t ə r e t͡s u l u j
răpești	r ə p e ʃ tʲ
mărturisea	m ə r t u r i s j a
necăjiți	n e k ə ʒ i t͡sʲ
anonima	a n o n i m a
fiu	f i w
perineal	p e r i n e a l
examen	e ɡ z a m e n
mâncam	m ɨ n k a m
amurg	a m u ɾ ɡ
câștigă	k ɨ ʃ t i ɡ ə
urinezi	u r i n e zʲ
dorin	d o r i n
șantajează	ʃ a n t a ʒ j a z ə
harpe	h a r p e
călătoriși	k ə l ə t o r i ʃʲ
ajuns	a ʒ u n s
pornea	p o r n j a
necăjii	n e k ə ʒ iː
nălucească	n ə l u t ʃ j a s k ə
crizantemă	k r i z a n t e m ə
ling	l i ŋ ɡ
citiții	t͡ʃ i t i t͡s iː
fumaserăm	f u m a s e r ə m
plictisiților	p l i k t i s i t͡s i l o r
tatuăm	t a t u ə m
spital	s p i t a l
vutcă	v u t k ə
capacitate	k a p a t ʃ i t a t e
somnambuliști	s o m n a m b u l i ʃ tʲ
biofizician	b i o f i z i t͡ʃ j a n
culturii	k u l t u r iː
bulgărește	b u l ɡ ə r e ʃ t e
înzestrarăți	ɨ n z e s t r a r ə t sʲ
îmbunătățiții	ɨ m b u n ə t ə t͡s i t͡s iː
vaci	v a t͡ʃʲ
funcționași	f u n k t͡s i o n a ʃʲ
stăpân	s t ə p ɨ n
cultură	k u l t u r ə
făcuseși	f ə k u s e ʃʲ
abandonă	a b a n d o n ə
apei	a p e j
perfecta	p e r f e k t a
torturăm	t o r t u r ə m
spere	s p e r e
anusuri	a n u s u rʲ
fut	f u t
dormi	d o r m i
delimitaserăm	d e l i m i t a s e r ə m
glonț	ɡ l o n t͡s
dușmănirăți	d u ʃ m ə n i r ə t sʲ
năluceau	n ə l u t ʃ j a w
trabuc	t r a b u k
întărească	ɨ n t ə r j a s k ə
fanteziei	f a n t e z i e j
spovedeau	s p o v e d j a w
porneai	p o r n j a j
întărita	ɨ n t ə r i t a
dușmănită	d u ʃ m ə n i t ə
caraghios	k a r a ɡ j o s
plăcea	p l ə t͡ʃ e̯ a
agest	a d͡ʒ e s t
văd	v ə d
asurzitei	a s u r z i t e j
giacă	d ʒ j a k ə
opriseși	o p r i s e ʃʲ
vorbeai	v o r bʲ æ j
cadavrelor	k a d a v r e l o r
tatuaserăți	t a t u a s e r ə t sʲ
iubiră	j u b i r ə
cenzurasem	t͡ʃ e n z u r a s e m
grăbiți	ɡ r ə b i t͡sʲ
veștejitelor	v e ʃ t e ʒ i t e l o r
pornitelor	p o r n i t e l o r
mulți	m u l t͡sʲ
bucile	b u t ʃ i l ɛ
mila	m i l a
anonimă	a n o n i m ə
soli	s o lʲ
gravitaserăți	ɡ r a v i t a s e r ə t sʲ
dușmănitei	d u ʃ m ə n i t e j
îmbunătățită	ɨ m b u n ə t ə t͡s i t ə
era	j e r a
limităm	l i m i t ə m
sclav	s k l a v
capete	k a p e t e
îmbunătățim	ɨ m b u n ə t ə t s i m
perfectaserăm	p e r f e k t a s e r ə m
spoveditelor	s p o v e d i t e l o r
simulare	s i m u l a r e
prețuiești	p r e t͡s u i e ʃ tʲ
lacrima	l a k r i m a
apocalipselor	a p o k a l i p s e l o r
atmosferă	a t m o s f e r ə
sfârșiții	s f ɨ r ʃ i t͡s iː
sprânceană	s p r ɨ n t ʃ j æ n ə
anusului	a n u s u l u j
formaserăți	f o r m a s e r ə t͡sʲ
palimpseste	p a l i m p s e s t e
grăbiserăm	ɡ r ə b i s e r ə m
citind	t ʃ i t i n d
fumași	f u m a ʃʲ
discreție	d i s k r e t͡s i e
analizeze	a n a l i z e z e
ionuț	i o n u t͡s
găsiră	ɡ ə s i r ə
temelie	t e m e l i e
excavaseră	e k s k a v a s e r ə
coniac	k o n j a k
asurzesc	a s u r z e s k
spre	s p r e
împărăteasă	ɨ m p ə r ə t e̯ a s ə
răpiră	r ə p i r ə
năluciții	n ə l u t͡ʃ i t͡s iː
fumarăm	f u m a r ə m
bibescu	b i b e s k u
centrale	t͡ʃ e n t ɾ a l e
delirez	d e l i r e z
gândiserăți	ɡ ɨ n d i s e r ə t sʲ
dușmănise	d u ʃ m ə n i s e
apocalipticele	a p o k a l i p t i t͡ʃ e l e
dușmăni	d u ʃ m ə n i
felație	f e l a t s i e
spectral	s p e k t r a l
acestuia	a t͡ʃ e s t u j a
răpeai	r ə p j a j
ultimi	u l t i mʲ
clăditului	k l ə d i t u l u j
faceți	f a t͡ʃ e t͡sʲ
cânta	k ɨ n t a
tată	t a t ə
dușmăniții	d u ʃ m ə n i t͡s iː
narcotică	n a ɾ k o t i k ə
sodomizaseră	s o d o m i z a s e r ə
asurzeam	a s u r z j a m
alfabetelor	a l f a b e t e l o r
explicație	e k s p l i k a t͡s i e
rege	r e d͡ʒ e
masturbași	m a s t u r b a ʃʲ
cetățeancă	t͡ʃ e t ə t͡s e̯ a n k ə
excavaserăți	e k s k a v a s e r ə t sʲ
urinaserăți	u r i n a s e r ə t sʲ
clădești	k l ə d e ʃ tʲ
pornești	p o r n e ʃ tʲ
opreai	o p r j a j
numerelor	n u m e r e l o r
găsiserăți	ɡ ə s i s e r ə t sʲ
număr	n u m ə r
citeai	t ʃ i t j a j
coardă	k o̯ a r d ə
sodomizatului	s o d o m i z a t u l u j
pus	p u s
avansat	a v a n s a t
accelerează	a k t͡ʃ e l e r j a z ə
agent	a d ʒ e n t
îmbunătății	ɨ m b u n ə t ə t s iː
catalane	k a t a l a n e
mâncai	m ɨ n k a j
călătorii	k ə l ə t o r iː
masturbatului	m a s t u r b a t u l u j
răni	r ə n i
gânditei	ɡ ɨ n d i t e j
sexologie	s e k s o l o d ʒ i e
numiserăți	n u m i s e r ə t sʲ
urinați	u r i n a t͡sʲ
urăște	u r ə ʃ t e
oprești	o p r e ʃ tʲ
ejaculație	e ʒ a k u l a t͡s i e
răpitele	r ə p i t e l e
veștejiserăți	v e ʃ t e ʒ i s e r ə t͡sʲ
sper	s p e r
aducător	a d u k ə t o r
anarhistă	a n a r h i s t ə
pornise	p o r n i s e
cel	t ʃ e l
ștefănescu	ʃ t e f ə n e s k u
fură	f u r ə
fiți	f i t͡sʲ
torturat	t o r t u r a t
amorțit	a m o r t s i t
formai	f o r m a j
complex	k o m p l e k s
acceleraserăm	a k t͡ʃ e l e r a s e r ə m
sculă	s k u l ə
spoveditele	s p o v e d i t e l e
limitaserăți	l i m i t a s e r ə t sʲ
ejaculat	e ʒ a k u l a t
șoptind	ʃ o p t i n d
gravitate	ɡ r a v i t a t e
răpitei	r ə p i t e j
excavăm	e k s k a v ə m
norului	n o r u l u j
sodomizase	s o d o m i z a s e
întăriși	ɨ n t ə r i ʃʲ
boteza	b o t e z a
funcționaserăm	f u n k t͡s i o n a s e r ə m
lingurilor	l i ŋ ɡ u r i l o r
asurzi	a s u r z i
orientam	o r i e n t a m
apetisant	a p e t i s a n t
fapte	f a p t e
opritelor	o p r i t e l o r
sfârșisem	s f ɨ r ʃ i s e m
șantajată	ʃ a n t a ʒ a t ə
felația	f e l a t s i a
sodomizatei	s o d o m i z a t e j
primiților	p r i m i t͡s i l o r
fantezie	f a n t e z i e
aceleiași	a t͡ʃ e l e j a ʃʲ
vorbind	v o r b i n d
spovedea	s p o v e d j a
modificat	m o d i f i k a t
nălucirăm	n ə l u t ʃ i r ə m
fuseră	f u s e r ə
limitaseră	l i m i t a s e r ə
fututelor	f u t u t e l o r
fiică	f i j k ə
analizași	a n a l i z a ʃʲ
trebuie	t r e b u j e
fuți	f u t͡sʲ
vînt	v ɨ n t
somau	s o m a w
pilotai	p i l o t a a j
masturbase	m a s t u r b a s e
înjurături	ɨ n ʒ u r ə t u rʲ
nălucise	n ə l u t ʃ i s e
lsd	e l e s d e
crearăți	k r e a r ə t sʲ
proastă	p r o̯ a s t ə
creară	k r e a r ə
anateme	a n a t e m e
grăbitului	ɡ r ə b i t u l u j
formați	f o r m a t͡sʲ
zăpușiră	z ə p u ʃ i r ə
cerb	t͡ʃ e r b
seduce	s e d u t ʃ e
dezgusta	d e z ɡ u s t a
disponibilitate	d i s p o n i b i l i t a t e
amarilișilor	a m a r i l i ʃ i l o r
puțin	p u t͡s i n
senzualitate	s e n z u a l i t a t e
seduceți	s e d u t͡ʃ e t͡sʲ
morții	m o r t͡s iː
călătoriserăm	k ə l ə t o r i s e r ə m
spovedisem	s p o v e d i s e m
ușor	u ʃ o r
tub	t u b
eliminat	e l i m i n a t
admire	a d m i r e
urinând	u r i n ɨ n d
iluzoriului	i l u z o r j u l u j
tentăm	t e n t ə m
asurzita	a s u r z i t a
deliraserăm	d e l i r a s e r ə m
sacri	s a k r i
potabili	p o t a b i lʲ
pierdut	p j e r d u t
nor	n o r
iubiți	j u b i t͡sʲ
vede	v e d e
făcusem	f ə k u s e m
tari	t a rʲ
ceaușescu	t͡ʃ e̯ a u ʃ e s k u
asurzea	a s u r z j a
consoană	k o n s w a n ə
coșmar	k o ʃ m a ɾ
numească	n u m j a s k ə
penar	p e n a r
așteptat	a ʃ t e p t a t
baba	b a b a
văile	v ə j l e
visătoare	v i s ə t w a r e
înzestrasem	ɨ n z e s t r a s e m
zăpușite	z ə p u ʃ i t e
răpirăți	r ə p i r ə t sʲ
șantajez	ʃ a n t a ʒ e z
perete	p e r e t e
delimitaseră	d e l i m i t a s e r ə
scrie	s k r i e
futeți	f u t e t͡sʲ
tentat	t e n t a t
folositor	f o l o s i t o r
șoptească	ʃ o p t j a s k ə
anatemei	a n a t e m e j
spovedesc	s p o v e d e s k
pederastie	p ɛ d ɛ r a s t i j ɛ
cânți	k ɨ n t͡sʲ
sângerăm	s ɨ n d͡ʒ e r ə m
dușmănea	d u ʃ m ə n j a
curve	k u r v e
masiv	m a s i v
nici	n i t ʃʲ
gay	ɡ e j
seducem	s e d u t͡ʃ e m
pregătind	p r e ɡ ə t i n d
dunărea	d u n ə r e̯ a
șoptiți	ʃ o p t i t͡sʲ
istoricește	i s t o r i t͡ʃ e ʃ t e
scrotalelor	s k r o t a l e l o r
zăpușiseși	z ə p u ʃ i s e ʃʲ
stradă	s t r a d ə
ruta	r u t a
vadă	v a d ə
macabrei	m a k a b r e j
caldarâm	k a l d a r ɨ m
puloșii	p u l o ʃ iː
masturbatelor	m a s t u r b a t e l o r
sunetele	s u n e t e l e
controlezi	k o n t r o l e zʲ
găoază	ɡ ə w a z ə
bondar	b o n d a r
perfectarăm	p e r f e k t a r ə m
funcționaseră	f u n k t͡s i o n a s e r ə
macedonia	m a t͡ʃ e d o n i a
copleșitoarelor	k o p l e ʃ i t o̯ a r e l o r
găsit	ɡ ə s i t
pa	p a
mărturisiserăți	m ə r t u r i s i s e r ə t sʲ
vorbeam	v o r bʲ æ m
veștejiși	v e ʃ t e ʒ i ʃʲ
șanse	ʃ a n s e
decât	d e k ɨ t
narcotice	n a ɾ k o t i t͡ʃ e
primeai	p r i m j a j
nălucii	n ə l u t ʃ iː
dezechilibru	d e z e k i l i b r u
delimitam	d e l i m i t a m
votcă	v o t k ə
nude	n u d e
tentarăți	t e n t a r ə t sʲ
sângerai	s ɨ n d͡ʒ e r a j
iubirii	j u b i r iː
plictisit	p l i k t i s i t
pregătit	p r e ɡ ə t i t
piedestal	p j e d e s t a l
întristarăți	ɨ n t r i s t a r ə t sʲ
ceruse	t͡ʃ e r u s e
sorii	s o r iʲ
mărturisiși	m ə r t u r i s i ʃʲ
pește	p e ʃ t e
mulțumea	m u l t s u m j a
plictisește	p l i k t i s e ʃ t e
vorbeau	v o r bʲ æ u
gânditelor	ɡ ɨ n d i t e l o r
găsiți	ɡ ə s i t͡sʲ
mâncați	m ɨ ŋ k a t͡sʲ
funcție	f u n k t͡s i e
dușmănește	d u ʃ m ə n e ʃ t e
somând	s o m ɨ n d
jertfă	ʒ e r t f ə
primise	p r i m i s e
mâncaseră	m ɨ n k a s e r ə
orgasm	o r ɡ a s m
spovediserăți	s p o v e d i s e r ə t sʲ
circumcis	t ʃ i r k u m t ʃ i s
numim	n u m i m
smârc	s m ɨ r k
spovediră	s p o v e d i r ə
somăm	s o m ə m
taților	t a t͡s i l o r
constituționalitate	c o n s t i t u t͡s i o n a l i t a t e
fumam	f u m a m
veștejeați	v e ʃ t e ʒ e̯ a t͡sʲ
somă	s o m ə
futură	f u t u r ə
asurziților	a s u r z i t͡s i l o r
viii	v i j i
frec	f r e k
scrot	s k r o t
șoptește	ʃ o p t e ʃ t e
iarbă	j a r b ə
îmbunătățise	ɨ m b u n ə t ə t s i s e
colan	k o l a n
urinăm	u r i n ə m
ubicuei	u b i k u e j
macabrului	m a k a b r u l u j
iubit	j u b i t
șantajatelor	ʃ a n t a ʒ a t e l o r
întăritului	ɨ n t ə r i t u l u j
obez	o b e z
valahia	v a l a x i a
îmbunătățeai	ɨ m b u n ə t ə t s j a j
șantajului	ʃ a n t a ʒ u l u j
baltic	b a l t i k
delimitai	d e l i m i t a j
potcoavă	p o t k o̯ a v ə
lasciv	l a s t͡ʃ i v
ejaculator	e ʒ a k u l a t o r
geantă	d͡ʒ e̯ a n t ə
puț	p u t s
cururilor	k u r u r i l o r
copilului	k o p i l u l u j
protejarăți	p r o t e ʒ a r ə t͡sʲ
amaneta	a m a n e t a
sodomizata	s o d o m i z a t a
întâlnesc	ɨ n t ɨ l n e s k
cetățeană	t͡ʃ e t ə t͡s e̯ a n ə
părintește	p ə r i n t e ʃ t e
mărturisiserăm	m ə r t u r i s i s e r ə m
deranjase	d e r a n ʒ a s e
sfârșitului	s f ɨ r ʃ i t u l u j
negre	n e ɡ r e
forme	f o r m e
porniserăm	p o r n i s e r ə m
călătorea	k ə l ə t o r j a
perfectam	p e r f e k t a m
pizde	p i z d e
ultime	u l t i m e
omniprezente	o m n i p r e z e n t e
zăpușitei	z ə p u ʃ i t e j
contribuție	k o n t r i b u t͡s i e
necăjeați	n e k ə ʒ j a t sʲ
despre	d e s p r e
beregată	b e r e ɡ a t ə
citiră	t ʃ i t i r ə
orgasmic	o r ɡ a s m i k
abandonară	a b a n d o n a r ə
cadă	k a d ə
supsese	s u p s e s e
gard	ɡ a r d
veștejim	v e ʃ t e ʒ i m
insecuritate	i n s e k u r i t a t e
înzestrași	ɨ n z e s t r a ʃʲ
întăreați	ɨ n t ə r j a t sʲ
veșted	v e ʃ t e d
șantaje	ʃ a n t a ʒ e
răbdare	r ə b d a r e
citi	t ʃ i t i
inflorescență	i n f l o ɾ e s t ʃ e n t s ə
întâlnita	ɨ n t ɨ l n i t a
numitele	n u m i t e l e
ascuns	a s k u n s
evanghelie	e v a n ɡ e l i e
frumoși	f r u m o ʃʲ
spermelor	s p e r m e l o r
sexualele	s e k s u a l e l e
veștejiților	v e ʃ t e ʒ i t͡s i l o r
călătorirăm	k ə l ə t o r i r ə m
andorra	a n d o r a
tentase	t e n t a s e
rochie	r o k i e
întâlnit	ɨ n t ɨ l n i t
delimităm	d e l i m i t ə m
pornitei	p o r n i t e j
giuvaier	d͡ʒ i w v a j e r
ubicuului	u b i k u u l u j
noastră	n o̯ a s t r ə
lipsești	l i p s e ʃ tʲ
tații	t a t͡s iʲ
fetelor	f e t e l o r
pupa	p u p a
futuserăm	f u t u s e r ə m
primul	p r i m u l
lipsitului	l i p s i t u l u j
melanj	m e l a n ʒ
sodomizatele	s o d o m i z a t e l e
mărturisiră	m ə r t u r i s i r ə
copilă	k o p i l ə
folosind	f o l o s i n d
dreaptă	d r e̯ a p t ə
reale	r e a l e
distrau	d i s t r a w
aceluiași	a t͡ʃ e l u j a ʃʲ
masturbaserăm	m a s t u r b a s e r ə m
sfârșise	s f ɨ r ʃ i s e
abandonași	a b a n d o n a ʃʲ
frumuseții	f r u m u s e t s iː
pilotând	p i l o t a ɨ n d
primitei	p r i m i t e j
înzestră	ɨ n z e s t r ə
răspuns	ɾ ə s p u n s
bea	b e̯ a
gândiră	ɡ ɨ n d i r ə
tânăr	t ɨ n ə r
mâncași	m ɨ n k a ʃʲ
erogenă	e r o d͡ʒ e n ə
ușile	u ʃ i l e
anusurilor	a n u s u r i l o r
mâncară	m ɨ n k a r ə
excavă	e k s k a v ə
trandafir	t r a n d a f i r
șantajam	ʃ a n t a ʒ a m
frumuseți	f r u m u s e t sʲ
masturbații	m a s t u r b a t͡s iː
distrăm	d i s t r ə m
frați	f r a t͡sʲ
acid	a t͡ʃ i d
perineele	p e r i n eː l e
activitate	a k t i v i t a t e
fertilitate	f e r t i l i t a t e
remușcare	r e m u ʃ k a r e
felațiilor	f e l a t s iː l o r
cadavrele	k a d a v r e l e
pregăteam	p r e ɡ ə t j a m
visa	v i s a
dezavantaj	d e z a v a n t a ʒ
native	n a t i v e
zăpușise	z ə p u ʃ i s e
ploios	p l o j o s
erați	e r a t͡sʲ
limitai	l i m i t a j
peștelui	p e ʃ t e l u j
perineali	p e r i n e a lʲ
necăjit	n e k ə ʒ i t
vampiri	v a m p i rʲ
uși	u ʃʲ
fute	f u t e
resurse	r e s u r s e
zăpuși	z ə p u ʃ i
cenzurase	t͡ʃ e n z u r a s e
somezi	s o m e zʲ
azeri	a z e rʲ
primeau	p r i m j a w
moarte	m o̯ a r t e
sfârșirăți	s f ɨ r ʃ i r ə t sʲ
cărtărescu	k ə r t ə r e s k u
întărirăm	ɨ n t ə r i r ə m
fumară	f u m a r ə
frățește	f r ə t͡s e ʃ t e
răpisem	r ə p i s e m
dicționarele	d i k t͡s i o n a r e l e
mizericordie	m i z e r i k o r d i e
algerian	a l d͡ʒ e r i a n
noapte	n o̯ a p t e
evlaviile	e v l a v iː l e
prevesti	p r e v e s t i
masculinitate	m a s k u l i n i t a t e
acesteia	a t͡ʃ e s t e j a
găsiseși	ɡ ə s i s e ʃʲ
abandonaseră	a b a n d o n a s e r ə
vieților	v j e t s i l o r
place	p l a t͡ʃ e
prezervativ	p r e z e r v a t i v
aceste	a t͡ʃ e s t e
pilotă	p i l o t a ə
prietenii	p r i e t e n iː
omorî	o m o r ɨ
nud	n u d
masturbați	m a s t u r b a t͡sʲ
graniță	ɡ r a n i t͡s ə
ață	a t͡s ə
fututei	f u t u t e j
folosește	f o l o s e ʃ t e
delirați	d e l i r a t͡sʲ
formez	f o r m e z
manechine	m a n e k i n e
sodomizate	s o d o m i z a t e
deliră	d e l i r ə
zăpușea	z ə p u ʃ j a
memoria	m e m o r i a
bineînțeles	b i n e ɨ n t s e l e s
sângeram	s ɨ n d͡ʒ e r a m
sinagogă	s i n a ɡ o ɡ ə
gravitam	ɡ r a v i t a m
vorbirăți	v o r b i r ə t͡sʲ
scrumierele	s k r u m i e r e l e
pițipoancă	p i t s i p w a ŋ k ə
clădiră	k l ə d i r ə
bolnăvicios	b o l n ə v i t͡ʃ j o s
spovediților	s p o v e d i t͡s i l o r
evlaviosului	e v l a v i o s u l u j
majoritate	m a ʒ o r i t a t e
genetică	d͡ʒ e n e t i k ə
femeiește	f e m e j e ʃ t e
chin	c i n
făcurăm	f ə k u r ə m
gândii	ɡ ɨ n d iː
vârcolac	v ɨ r k o l a k
serenade	s e r e n a d e
clare	k l a r e
tai	t a j
asurziră	a s u r z i r ə
lipsiții	l i p s i t͡s iː
carte	k a r t e
dorm	d o r m
dincolo	d i n k o l o
săvârși	s ə v ɨ r ʃ i
nălucita	n ə l u t͡ʃ i t a
velocitate	v e l o t͡ʃ i t a t e
evlavioșilor	e v l a v i o ʃ i l o r
sfânt	s f ɨ n t
terminai	t e r m i n a j
mâncaserăm	m ɨ n k a s e r ə m
urâți	u r ɨ t͡sʲ
pregătească	p r e ɡ ə t j a s k ə
clădire	k l ə d i r e
futeați	f u t e̯ a t͡sʲ
frasin	f r a s i n
răpi	r ə p i
pilotezi	p i l o t a e zʲ
sărămură	s ə r ə m u r ə
nicidecum	n i t ʃʲ d e k u m
pregătii	p r e ɡ ə t iː
vorbească	v o r b e̯ a s k ə
faci	f a t͡ʃʲ
macabrilor	m a k a b r i l o r
oprita	o p r i t a
sângereze	s ɨ n d͡ʒ e r e z e
somnambulist	s o m n a m b u l i s t
nominale	n o m i n a l e
intern	i n t e r n
laba	l a b a
fi	f i
alfabetului	a l f a b e t u l u j
revistă	r e v i s t ə
aligator	a l i ɡ a t o r
sfârșească	s f ɨ r ʃ j a s k ə
coiot	k o j o t
plictisiții	p l i k t i s i t͡s iː
necăjite	n e k ə ʒ i t e
cetățeni	t͡ʃ e t ə t͡s e nʲ
vodcă	v o d k ə
abandonam	a b a n d o n a m
plajă	p l a ʒ ə
pizdar	p i z d a ɾ
sexual	s e k s u a l
pornisem	p o r n i s e m
accelerași	a k t͡ʃ e l e r a ʃʲ
dunăre	d u n ə r e
adjectiv	a d ʒ e k t i v
introduce	i n t r o d u t͡ʃ e
fetele	f e t e l e
speri	s p e rʲ
distrez	d i s t r e z
stupidități	s t u p i d i t ə t͡sʲ
controlă	k o n t r o l ə
tatuând	t a t u ɨ n d
formații	f o r m a t͡s iː
copii	k o p i j
sfârșiților	s f ɨ r ʃ i t͡s i l o r
vorbiseși	v o r b i s e ʃʲ
burete	b u r e t e
onestitate	o n e s t i t a t e
necăjea	n e k ə ʒ j a
sfârșitei	s f ɨ r ʃ i t e j
antagonic	a n t a ɡ o n i k
farfurie	f a ɾ f u ɾ i e
limitezi	l i m i t e zʲ
obrăznicie	o b r ə z n i t ʃ i e
ție	t s i e
coapsă	kʷ a p s ə
torturaseși	t o r t u r a s e ʃʲ
ejaculăm	e ʒ a k u l ə m
iubeau	j u bʲ æ u
creaseși	k r e a s e ʃʲ
buna	b u n a
buci	b u t ʃʲ
milos	m i l o s
narcotica	n a ɾ k o t i k a
dușmănim	d u ʃ m ə n i m
interacțiune	i n t e r a k t s i u n e
anatemele	a n a t e m e l e
neutre	n e u t r e
misterios	m i s t e r i o s
pornograficii	p o r n o ɡ r a f i t͡ʃ i j
salturi	s a l t u rʲ
eroticilor	e r o t i t͡ʃ i l o r
spania	s p a n j a
recunoscut	r e k u n o s k u t
porneați	p o r n j a t sʲ
jupui	ʒ u p u i
grăbit	ɡ r ə b i t
stimulam	s t i m u l a m
legământ	l e ɡ ə m ɨ n t
sugeam	s u d͡ʒ e̯ a m
sperai	s p e r a j
adorase	a d o r a s e
înzestrau	ɨ n z e s t r a w
sfârșim	s f ɨ r ʃ i m
drăguț	d r ə ɡ u t͡s
gândiții	ɡ ɨ n d i t͡s iː
masturbăm	m a s t u r b ə m
poartă	p o̯ a r t ə
anormalitate	a n o r m a l i t a t e
grăbitelor	ɡ r ə b i t e l o r
cenzurat	t͡ʃ e n z u r a t
primisem	p r i m i s e m
pornografie	p o r n o ɡ r a f i e
râu	r ɨ w
italia	i t a l i a
mulțumesc	m u l t͡s u m e s k
pornograficei	p o r n o ɡ r a f i t͡ʃ e j
sodomiză	s o d o m i z ə
dușmăniserăm	d u ʃ m ə n i s e r ə m
sunetului	s u n e t u l uʲ
dansat	d a n s a t
vultur	v u l t u r
va	v a
numeai	n u m j a j
spovediserăm	s p o v e d i s e r ə m
folositului	f o l o s i t u l u j
piepturi	p j e p t u rʲ
ghizi	ɡ i zʲ
lumini	l u m i nʲ
preejaculator	p r e e ʒ a k u l a t o r
șoptiserăți	ʃ o p t i s e r ə t sʲ
gândiți	ɡ ɨ n d i t͡sʲ
fusesem	f u s e s e m
limitași	l i m i t a ʃʲ
fumat	f u m a t
anțărț	a n t s ə r t s
muribund	m u r i b u n̪ d̪
baie	b a j e
sfârșiserăți	s f ɨ r ʃ i s e r ə t sʲ
deranjez	d e r a n ʒ e z
exista	e ɡ z i s t a
alcoolic	a l k o o l i k
năluciși	n ə l u t ʃ i ʃʲ
fusei	f u s e j
vampire	v a m p i r e
întărit	ɨ n t ə r i t
delirarăți	d e l i r a r ə t͡sʲ
mâncaseși	m ɨ n k a s e ʃʲ
pornii	p o r n iː
sept	s e p t
geană	d͡ʒ e̯ a n ə
îs	ɨ s
funcționarăți	f u n k t͡s i o n a r ə t sʲ
asurzească	a s u r z j a s k ə
abandonezi	a b a n d o n e zʲ
clădiții	k l ə d i t͡s iː
sau	s a w
negru	n e ɡ r u
vorbi	v o r b i
pornografica	p o r n o ɡ r a f i k a
numeam	n u m j a m
băiețașului	b ə j e t͡s a ʃ u l u j
folosesc	f o l o s e s k
clădeam	k l ə d j a m
ligament	l i ɡ a m e n t
vorbise	v o r b i s e
tatuaje	t a t w a ʒ e
apocaliptic	a p o k a l i p t i k
întăresc	ɨ n t ə r e s k
îmbunătățite	ɨ m b u n ə t ə t͡s i t e
excavaseși	e k s k a v a s e ʃʲ
odată	o d a t ə
pornografiilor	p o r n o ɡ r a f iː l o r
cere	t͡ʃ e r e
primim	p r i m i m
faptele	f a p t e l e
delimitează	d e l i m i t j a z ə
întâlnitelor	ɨ n t ɨ l n i t e l o r
părți	p ə r t͡sʲ
atrocitățile	a t r o t͡ʃ i t ə t͡s i l e
republica	r e p u b l i k a
prioritate	p r i j o r i t a t e
dorință	d o r i n t͡s ə
ejaculaseră	e ʒ a k u l a s e r ə
mile	m i l e
virgulă	v i r ɡ u l ə
neprotejat	n e p r o t e ʒ a t
regine	r e d͡ʒ i n e
avid	a v i d
prietenei	p r i e t e n e j
sperma	s p e r m a
rodie	r o d i e
donație	d o n a t͡s i e
înțelegem	ɨ n t͡s e l e d͡ʒ e m
apă	a p ə
răpii	r ə p iː
controleze	k o n t r o l e z e
dragostea	d r a ɡ o s t e̯ a
sprâncene	s p r ɨ n t ʃ e n e
hotărî	h o t ə r ɨ
ramură	ɾ a m u ɾ ə
hamac	h a m a k
prezervativele	p r e z e r v a t i v e l e
penisului	p e n i s u l u j
distractiv	d i s t r a k t i v
pornitele	p o r n i t e l e
tatuat	t a t u a t
oprea	o p r j a
răpiserăți	r ə p i s e r ə t sʲ
țara	t s a r a
întristaseși	ɨ n t r i s t a s e ʃʲ
pilotasem	p i l o t a a s e m
distram	d i s t r a m
analizarăți	a n a l i z a r ə t sʲ
caos	k a o s
masturbate	m a s t u r b a t e
perfectat	p e r f e k t a t
conformitate	c o n f o r m i t a t e
dușmănitelor	d u ʃ m ə n i t e l o r
primiseși	p r i m i s e ʃʲ
homofobie	h o m o f o b i e
șantajând	ʃ a n t a ʒ ɨ n d
furi	f u rʲ
calitate	c a l i t a t e
antonescu	a n t o n e s k u
sângeră	s ɨ n d͡ʒ e r ə
manechin	m a n e k i n
modifica	m o d i f i k a
ataraxic	a t a r a k s i k
primind	p r i m i n d
capabilitate	c a p a b i l i t a t e
vampir	v a m p i r
anonim	a n o n i m
gândeau	ɡ ɨ n d j a w
freca	f r e k a
limitarăți	l i m i t a r ə t sʲ
scrotală	s k r o t a l ə
vedea	v e d e̯ a
cunoscu	k u n o s k u
deranjasem	d e r a n ʒ a s e m
relativitate	r e l a t i v i t a t e
deranjarăm	d e r a n ʒ a r ə m
abandonaserăți	a b a n d o n a s e r ə t sʲ
copleșitorilor	k o p l e ʃ i t o r i l o r
creez	k r e e z
ușa	u ʃ a
torturaserăm	t o r t u r a s e r ə m
sângerarăți	s ɨ n d͡ʒ e r a r ə t sʲ
purta	p u r t a
indiscrete	i n d i s k r e t e
vargă	v a r ɡ ə
scalzi	s k a l zʲ
mărturisiseră	m ə r t u r i s i s e r ə
numind	n u m i n d
excaveze	e k s k a v e z e
dă	d ə
folosiții	f o l o s i t͡s iː
reginele	r e d͡ʒ i n e l e
note	n o t e
misterioșilor	m i s t e r i o ʃ i l o r
năluciserăți	n ə l u t ʃ i s e r ə t sʲ
îmbunătățirăți	ɨ m b u n ə t ə t s i r ə t sʲ
șopteam	ʃ o p t j a m
spoveditului	s p o v e d i t u l u j
apocaliptice	a p o k a l i p t i t͡ʃ e
grăbeați	ɡ r ə b j a t sʲ
primită	p r i m i t ə
cumnați	k u m n a t͡sʲ
masturbata	m a s t u r b a t a
veștejita	v e ʃ t e ʒ i t a
ceri	t ʃ e rʲ
lindic	l i n d i k
iubită	j u b i t ə
plictisite	p l i k t i s i t e
macabrii	m a k a b r i j
valea	v a lʲ e̯ a
saramură	s a r a m u r ə
căcat	k ə k a t
furnică	f u r n i k ə
mărturisind	m ə r t u r i s i n d
supsesem	s u p s e s e m
ungur	u ŋ ɡ u r
răpind	r ə p i n d
evlaviei	e v l a v i e j
pricolici	p r i k o l i t͡ʃʲ
banița	b a nʲ t͡s a
bumbac	b u m b a k
fantezii	f a n t e z iː
studiai	s t u d j a j
homosexualului	h o m o s e k s u a l u l u j
haiduc	h a j d u k
veștejiseră	v e ʃ t e ʒ i s e r ə
folosise	f o l o s i s e
îmbunătățesc	ɨ m b u n ə t ə t s e s k
descoperire	d ɛ s k o p ɛ r i r ɛ
oprirăm	o p r i r ə m
pregăti	p r e ɡ ə t i
dumnezeu	d u m n e z e w
furăm	f u r ə m
dușmăneați	d u ʃ m ə n j a t sʲ
citisem	t ʃ i t i s e m
evlavioasei	e v l a v i o̯ a s e j
pornografilor	p o r n o ɡ r a f i l o r
înzestrarăm	ɨ n z e s t r a r ə m
anonime	a n o n i m e
perfectez	p e r f e k t e z
orientaserăm	o r i e n t a s e r ə m
controlaseră	k o n t r o l a s e r ə
limitam	l i m i t a m
slovenului	s l o v e n u l u j
îmbunătățit	ɨ m b u n ə t ə t s i t
explica	e k s p l i k a
gravitând	ɡ r a v i t ɨ n d
coaie	kʷ a j e
tatuaj	t a t u a ʒ
distră	d i s t r ə
limitez	l i m i t e z
băiețaș	b ə j ɛ t s a ʃ
stimuleze	s t i m u l e z e
pornografului	p o r n o ɡ r a f u l u j
slovenilor	s l o v e n i l o r
elveția	e l v e t͡s i a
suflet	s u f l e t
înzestraserăți	ɨ n z e s t r a s e r ə t sʲ
cazan	k a z a n
vagin	v a d͡ʒ i n
vorbiți	v o r b i t͡sʲ
venin	v e n i n
evlavioase	e v l a v i o̯ a s e
frecaserăm	f r e k a s e r ə m
sumer	s u m e ɾ
funcționezi	f u n k t͡s i o n e zʲ
muri	m u r i
folosea	f o l o s j a
deranjam	d e r a n ʒ a m
băiețași	b ə j e t͡s a ʃʲ
scrotal	s k r o t a l
asia	a s i a
lipsească	l i p s j a s k ə
deranjași	d e r a n ʒ a ʃʲ
plictisitelor	p l i k t i s i t e l o r
primitului	p r i m i t u l u j
controlaserăm	k o n t r o l a s e r ə m
tentau	t e n t a w
ubicuilor	u b i k u i l o r
mobil	m o b i l
cumva	k u m v a
funcționând	f u n k t͡s i o n ɨ n d
perfectaserăți	p e r f e k t a s e r ə t sʲ
personaje	p e r s o n a ʒ e
ultimul	u l t i m u l
formatei	f o r m a t e j
pregătiserăm	p r e ɡ ə t i s e r ə m
lup	l u p
homosexualii	h o m o s e k s u a l iʲ
formezi	f o r m e zʲ
clădita	k l ə d i t a
românești	r o m ɨ n e ʃ tʲ
cataloniei	k a t a l o n i e j
juisez	ʒ u i s e z
moldovean	m o l d o v e̯ a n
șoptești	ʃ o p t e ʃ tʲ
știi	ʃ t iː
elimina	e l i m i n a
lingurile	l i ŋ ɡ u r i l e
pornograf	p o r n o ɡ r a f
mărturisit	m ə r t u r i s i t
excavarăm	e k s k a v a r ə m
stimulează	s t i m u l j a z ə
omniprezenți	o m n i p r e z e n t͡sʲ
numirăți	n u m i r ə t sʲ
dușmăniră	d u ʃ m ə n i r ə
înțelege	ɨ n t s e l e d ʒ e
găseau	ɡ ə s j a w
promisiuni	p r o m i s i u nʲ
necăjirăți	n e k ə ʒ i r ə t sʲ
nume	n u m e
evlavioasele	e v l a v i o̯ a s e l e
real	r e a l
zăpușitele	z ə p u ʃ i t e l e
constantinescu	k o n s t a n t i n e s k u
portocală	p o r t o k a l ə
excavează	e k s k a v j a z ə
poponar	p o p o n a r
zăcea	z ə t ʃ j æ
lucreze	l u k r e z e
primiserăți	p r i m i s e r ə t sʲ
ușilor	u ʃ i l o r
interveni	i n t e r v e n i
catalană	k a t a l a n ə
veștejirăți	v e ʃ t e ʒ i r ə t͡sʲ
seduci	s e d u t͡ʃʲ
numai	n u m a j
disponibil	d i s p o n i b i l
popescu	p o p e s k u
întărirăți	ɨ n t ə r i r ə t sʲ
apocaliptici	a p o k a l i p t i t͡ʃʲ
misterioasele	m i s t e r i o̯ a s e l e
dobrescu	d o b r e s k u
necăjiții	n e k ə ʒ i t͡s iː
vino	v i n o
folosiseră	f o l o s i s e r ə
slovena	s l o v e n a
țări	t s ə rʲ
grăbeai	ɡ r ə b j a j
enigmatici	e n i ɡ m a t i t͡ʃʲ
juisa	ʒ u i s a
porneau	p o r n j a w
gravitași	ɡ r a v i t a ʃʲ
primirăți	p r i m i r ə t sʲ
găsești	ɡ ə s e ʃ tʲ
sorilor	s o r i l o r
deliraseră	d e l i r a s e r ə
clădiși	k l ə d i ʃʲ
sedu	s e d u
mărturisisem	m ə r t u r i s i s e m
vulvă	v u l v ə
homosexuală	h o m o s e k s u a l ə
comporta	k o m p o r t a
dușmăniseși	d u ʃ m ə n i s e ʃʲ
sângerarăm	s ɨ n d͡ʒ e r a r ə m
feminin	f e m i n i n
pilotaserăți	p i l o t a a s e r ə t sʲ
fă	f ə
păianjen	p ə j a n ʒ e n
șantajatului	ʃ a n t a ʒ a t u l u j
masturbară	m a s t u r b a r ə
folosiserăți	f o l o s i s e r ə t sʲ
îmi	ɨ mʲ
înzestrară	ɨ n z e s t r a r ə
elasticitate	e l a s t i t͡ʃ i t a t e
năstăsescu	n ə s t ə s e s k u
nălucisem	n ə l u t ʃ i s e m
omniprezentă	o m n i p r e z e n t ə
mâncat	m ɨ n k a t
huligan	h u l i ɡ a n
mulțumească	m u l t s u m j a s k ə
spovedita	s p o v e d i t a
sexualei	s e k s u a l e j
iubiri	j u b i rʲ
numărului	n u m ə r u l u j
finitate	f i n i t a t e
pornească	p o r n j a s k ə
pilotam	p i l o t a a m
stimulai	s t i m u l a j
sloven	s l o v e n
testicul	t e s t i k u l
gravita	ɡ r a v i t a
ejaculară	e ʒ a k u l a r ə
futuserăți	f u t u s e r ə t͡sʲ
orgastic	o r ɡ a s t i k
iași	j a ʃʲ
nativa	n a t i v a
citite	t͡ʃ i t i t e
plug	p l u ɡ
laboare	l a b o a r e
prietenelor	p r i e t e n e l o r
formară	f o r m a r ə
ești	j e ʃ tʲ
vedem	v e d e m
masturbată	m a s t u r b a t ə
știință	ʃ t i i n t͡s ə
îmbunătăți	ɨ m b u n ə t ə t s i
îngeri	ɨ n d ʒ e rʲ
năluciților	n ə l u t͡ʃ i t͡s i l o r
răpiților	r ə p i t͡s i l o r
juisăm	ʒ u i s ə m
șantaj	ʃ a n t a ʒ
pornit	p o r n i t
ubicui	u b i k u j
fanteziilor	f a n t e z iː l o r
catalan	k a t a l a n
tatuezi	t a t u e zʲ
pandora	p a n d o r a
rusia	r u s i a
apocalipticului	a p o k a l i p t i k u l u j
noroc	n o r o k
reginelor	r e d͡ʒ i n e l o r
plictisitele	p l i k t i s i t e l e
primiși	p r i m i ʃʲ
dezgust	d e z ɡ u s t
gravitase	ɡ r a v i t a s e
atrocității	a t r o t ʃ i t ə t s iː
începe	ɨ n t ʃ e p e
descărca	d e s k ə r k a
afix	a f i k s
mele	m e l e
asurzind	a s u r z i n d
scrotala	s k r o t a l a
formăm	f o r m ə m
prietenului	p r i e t e n u l u j
iubirilor	j u b i r i l o r
băiețelului	b ə j e t͡s e l u l u j
spovedise	s p o v e d i s e
podea	p o d e̯ a
arăta	a r ə t a
generație	d͡ʒ e n e r a t͡s i e
substanță	s u b s t a n t͡s ə
fost	f o s t
frecaseră	f r e k a s e r ə
analizară	a n a l i z a r ə
formei	f o r m e j
sângerași	s ɨ n d͡ʒ e r a ʃʲ
întâlnești	ɨ n t ɨ l n e ʃ tʲ
slovenele	s l o v e n e l e
spoveditei	s p o v e d i t e j
cenzurăm	t͡ʃ e n z u r ə m
abile	a b i l e
macabră	m a k a b r ə
revoluție	ɾ e v o l u t͡s i e
stimulând	s t i m u l ɨ n d
delimitaserăți	d e l i m i t a s e r ə t sʲ
mulțumeați	m u l t s u m j a t sʲ
frățesc	f r ə t͡s e s k
bulgară	b u l ɡ a r ə
familie	f a m i l i e
mărturisim	m ə r t u r i s i m
șantajurilor	ʃ a n t a ʒ u r i l o r
necăjirăm	n e k ə ʒ i r ə m
pornita	p o r n i t a
futute	f u t u t e
gândesc	ɡ ɨ n d e s k
însușire	ɨ n s u ʃ i r ɛ
pornograficilor	p o r n o ɡ r a f i t͡ʃ i l o r
futuse	f u t u s e
făcuserăm	f ə k u s e r ə m
haiduci	h a j d u t ʃʲ
numiți	n u m i t͡sʲ
păianjenului	p ə j a n ʒ e n u l u j
tentaserăți	t e n t a s e r ə t sʲ
sobă	s o b ə
buc	b u k
formasem	f o r m a s e m
simplifica	s i m p l i f i k a
șoptitei	ʃ o p t i t e j
fuserăm	f u s e r ə m
excavam	e k s k a v a m
liniști	l i n i ʃ t i
pilotează	p i l o t a j a z ə
promite	p r o m i t e
spovedești	s p o v e d e ʃ tʲ
fildeș	f i l d e ʃ
amarilișii	a m a r i l i ʃ iː
soare	s o̯ a r e
orienteze	o r i e n t e z e
întărește	ɨ n t ə r e ʃ t e
sfârșitelor	s f ɨ r ʃ i t e l o r
boașelor	b o̯ a ʃ e l o ɾ
distrarăți	d i s t r a r ə t sʲ
șantajistului	ʃ a n t a ʒ i s t u l u j
somează	s o m j a z ə
foloseați	f o l o s j a t sʲ
vorbă	v o r b ə
șoptită	ʃ o p t i t ə
călătoriră	k ə l ə t o r i r ə
sufletului	s u f l e t u l u j
pornografică	p o r n o ɡ r a f i k ə
dezavantaja	d e z a v a n t a ʒ a
umeraș	u m e r a ʃ
sarcastic	s a r k a s t i k
folosiți	f o l o s i t͡sʲ
cumnată	k u m n a t ə
băiețașilor	b ə j e t s a ʃ i l o r
perfectezi	p e r f e k t e zʲ
mulțumitele	m u l t͡s u m i t e l e
pederast	p ɛ d ɛ r a s t
șantajeze	ʃ a n t a ʒ e z e
copleșitoare	k o p l e ʃ i t o̯ a r e
asurzești	a s u r z e ʃ tʲ
delimitez	d e l i m i t e z
delirului	d e l i r u l u j
spovediții	s p o v e d i t͡s iː
oprită	o p r i t ə
pune	p u n e
omniprezentei	o m n i p r e z e n t e j
delicioși	d e l i t͡ʃ j o ʃʲ
numiseră	n u m i s e r ə
clădii	k l ə d iː
pulei	p u l e j
vrut	v r u t
coapse	k o̯ a p s e
mărturisesc	m ə r t u r i s e s k
torturară	t o r t u r a r ə
