ab	a b
abatir	a b a t ɪ r
abergofiant	a b ɛ r ɡ ɔ v j a n t
abertawe	a b ɛ r t a u̯ ɛ
aberthu	a b ɛ r θ i
ac	a k
ach	aː χ
achosaf	a χ oː s a v
achosi	a χ ɔ s i
actiaf	a k t j a v
acti	a k t i
actio	a k t j ɔ
acw	a k u
ad	aː d
adarydda	a d a r ə ð a
adawed	a d a u̯ ɛ d
addawa	a ð a u̯ a
addoldy	a ð ɔ l d i
addolgar	a ð ɔ l ɡ a r
addoliad	a ð ɔ l j a d
addurno	a ð ɪ r n ɔ
addysgu	a ð ə s ɡ i
adeilad	a d e i̯ l a d
adfer	a d v ɛ r
adferf	a d v ɛ r v
adio	a d j ɔ
adlaw	a d l a u̯
adnabyddi	a d n a b ə ð i
adnabyddus	a d n a b ə ð ɪ s
adnabyddwch	a d n a b ə ð ʊ χ
adolygu	a d ɔ l ə ɡ i
adran	a d r a n
adre	a d r ɛ
adrodd	a d r ɔ ð
adroddiad	a d r ɔ ð j a d
adwaen	a d w a i̯ n
adwaenai	a d w e i̯ n a i̯
adwaenant	a d w e i̯ n a n t
adwaenech	a d w e i̯ n ɛ χ
adwaenem	a d w e i̯ n ɛ m
adwaenent	a d w e i̯ n ɛ n t
adwaenir	a d w e i̯ n ɪ r
adwaenit	a d w e i̯ n ɪ t
adwaenom	a d w e i̯ n ɔ m
adwaenost	a d w e i̯ n ɔ s d
adwaenwch	a d w e i̯ n ʊ χ
adwaenwn	a d w e i̯ n ʊ n
adwaenynt	a d w e i̯ n ɪ n t
adweinaf	a d w e i̯ n a v
adweini	a d w e i̯ n i
adweinid	a d w e i̯ n ɪ d
adweinir	a d w e i̯ n ɪ r
adwen	a d w ɛ n
adwthio	a d ʊ θ j ɔ
aech	a i̯ χ
aed	a i̯ d
aeled	e i̯ l ɛ d
aelod	e i̯ l ɔ d
aelwyd	e i̯ l ʊ i̯ d
aem	a i̯ m
aent	a i̯ n t
aeron	e i̯ r ɔ n
aethai	e i̯ θ a i̯
aethant	e i̯ θ a n t
aethech	e i̯ θ ɛ χ
aethem	e i̯ θ ɛ m
aethid	e i̯ θ ɪ d
aethom	e i̯ θ ɔ m
aethost	e i̯ θ ɔ s d
aethpwyd	e i̯ θ p ʊ i̯ d
aethwn	e i̯ θ ʊ n
afallen	a v a ɬ ɛ n
af	aː v
affrica	a f r ɪ k a
aflwyddiannus	a v l ʊ i̯ ð j a n ɪ s
afonfarch	a v ɔ n v a r χ
agoriad	a ɡ ɔ r j a d
aidd	a i̯ ð
aifft	a i̯ f t
ail	a i̯ l
aillt	a i̯ ɬ d
ailosod	a i̯ l ɔ s ɔ d
air	a i̯ r
ais	a i̯ s
ait	a i̯ t
âl	aː l
alban	a l b a n
alla	a ɬ a
allan	a ɬ a n
allant	a ɬ a n t
allen	a ɬ ɛ n
aller	a ɬ ɛ r
allo	a ɬ ɔ
allor	a ɬ ɔ r
allt	a ɬ t
allwthio	a ɬ ʊ θ j ɔ
almaenwr	a l m e i̯ n ʊ r
almanac	a l m a n a k
alwminiwm	a l ʊ m ɪ n j ʊ m
am	a m
amcan	a m k a n
amddiffynnaf	a m ð ɪ f ə n a v
amgyffred	a m ɡ ə f r ɛ d
amgylchedd	a m ɡ ə l χ ɛ ð
amlwg	a m l ʊ ɡ
amnewid	a n n ɛ u̯ ɪ d
amobr	a m ɔ b r
amod	a m ɔ d
amrant	a m r a n t
amrantiad	a m r a n t j a d
amrwd	a m r ʊ d
amrywedd	a m r ɪ u̯ j ɛ ð
amrywio	a m r ɪ u̯ j ɔ
amrywiol	a m r ɪ u̯ j ɔ l
amser	a m s ɛ r
amwythig	a m ʊ i̯ θ ɪ ɡ
anabl	a n a b l
anabledd	a n a b l ɛ ð
anadlu	a n a d l i
ân	aː n
aneiriol	a n e i̯ r j ɔ l
anffurfiol	a n f ɪ r v j ɔ l
angen	a ŋ ɛ n
angheuol	a ŋ h e i̯ ɔ l
anghofio	a ŋ h ɔ v j ɔ
anghofrwydd	a ŋ h ɔ v r ʊ i̯ ð
anghofuster	a ŋ h ɔ v ɪ s d ɛ r
anghydfod	a ŋ h ə d v ɔ d
anghydradd	a ŋ h ə d r a ð
anghydraddoldeb	a ŋ h ə d r a ð ɔ l d ɛ b
anghyfartal	a ŋ h ə v a r t a l
anghyfreithlon	a ŋ h ə v r e i̯ θ l ɔ n
anghymreig	a ŋ h ə m r e i̯ ɡ
anghymreigio	a ŋ h ə m r e i̯ ɡ j ɔ
anghywir	a ŋ h ə u̯ ɪ r
angladd	a ŋ l a ð
angof	a ŋ ɔ v
angyles	a ŋ ə l ɛ s
anner	a n ɛ r
annerbyniol	a n ɛ r b ə n j o l
annerch	a n ɛ r χ
annog	a n ɔ ɡ
annwyd	a n ʊ i̯ d
anrheg	a n r̥ ɛ ɡ
ansawdd	a n s a u̯ ð
ânt	aː n t
antimoni	a n t ɪ m ɔ n i
ap	a p
arbed	a r b ɛ d
archfarchnad	a r χ v a r χ n a d
arddaf	a r ð a v
arddwrn	a r ð ʊ r n
aren	aː r ɛ n
arestio	a r ɛ s t j ɔ
arfedd	a r v ɛ ð
arfer	a r v ɛ r
arglwydd	a r ɡ l ʊ i̯ ð
arholi	a r h ɔ l i
arhosaf	a r h ɔ s a v
ariannog	a r j a n ɔ ɡ
arllwys	a r ɬ ʊ i̯ s
armenia	a r m ɛ n j a
arna	a r n a
arnat	a r n a t
arni	a r n i
arosfa	a r ɔ s v a
arthan	a r θ a n
arweiniad	a r w e i̯ n j a d
arweinydd	a r w e i̯ n ɪ ð
arweinyddion	a r w e i̯ n ə ð j ɔ n
asid	a s ɪ d
asyn	a s ɪ n
ata	a t a
atal	a t a l
atalnod	a t a l n ɔ d
at	a t
athrawes	a θ r a u̯ ɛ s
ati	a t i
ato	a t ɔ
aton	a t ɔ n
aur	a i̯ r
awchus	a u̯ χ ɪ s
awdl	a u̯ d l
awen	a u̯ ɛ n
awgrym	a u̯ ɡ r ɪ m
awgrymiad	a u̯ ɡ r ə m j a d
awgrymu	a u̯ ɡ r ə m i
awn	a u̯ n
awr	a u̯ r
awst	a u̯ s d
awydd	a u̯ ɪ ð
awyr	a u̯ ɪ r
bach	b aː χ
bachgennyn	b a χ ɡ ɛ n ɪ n
bae	b a i̯
baedd	b a i̯ ð
baet	b a i̯ t
baith	b a i̯ θ
ban	b a n
bangor	b a ŋ ɡ ɔ r
banjo	b a n d͡ʒ ɔ
barcud	b a r k ɪ d
bardd	b a r ð
barfog	b a r v ɔ ɡ
barn	b a r n
barnu	b a r n i
baroted	b a r ɔ t ɛ d
bas	b aː s
baw	b a u̯
bawdd	b a u̯ ð
bawn	b a u̯ n
bedd	b eː ð
bedr	b ɛ d r
bedwen	b ɛ d w ɛ n
beichiog	b e i̯ χ j ɔ ɡ
belffast	b ɛ l f a s d
bengwin	b ɛ ŋ ɡ w ɪ n
ber	b ɛ r
berf	b ɛ r v
beth	b eː θ
birmingham	b ə r m ɪ ŋ h a m
blaidd	b l a i̯ ð
blanced	b l a ŋ k ɛ d
ble	b l eː
blin	b l iː n
blith	b l iː θ
boch	b oː χ
bochdew	b ɔ χ d ɛ u̯
bod	b oː d
bodd	b oː ð
bol	b ɔ l
bôm	b oː m
bôn	b oː n
bondigrybwyll	b ɔ n d ɪ ɡ r ə b ʊ i̯ ɬ
bopty	b ɔ p t i
bord	b ɔ r d
bordydd	b ɔ r d ɪ ð
brad	b r aː d
braf	b r aː v
braich	b r a i̯ χ
brain	b r a i̯ n
brân	b r aː n
braster	b r a s t ɛ r
brathu	b r a θ i
brechdan	b r ɛ χ d a n
brecwast	b r ɛ k w a s t
bresych	b r ɛ s ɪ χ
bresychen	b r ɛ s ə χ ɛ n
brexit	b r ɛ k s ɪ t
bri	b r iː
brics	b r ɪ k s
bricyll	b r ɪ k ɪ ɬ
brig	b r iː ɡ
briw	b r ɪ u̯
brochion	b r ɔ χ j ɔ n
bron	b r ɔ n
bronwen	b r ɔ n w ɛ n
brown	b r o u̯ n
brwyn	b r ʊ i̯ n
bryfed	b r ə v ɛ d
brys	b r iː s
bryste	b r ɪ s t ɛ
budd	b iː ð
bûm	b iː m
bum	b ɪ m
bur	b iː r
buwch	b ɪ u̯ χ
bwced	b ʊ k ɛ d
bwlch	b ʊ l χ
bwrdd	b ʊ r ð
bwyd	b ʊ i̯ d
bychan	b ə χ a n
byd	b iː d
byddi	b ə ð i
byddwch	b ə ð ʊ χ
byddwn	b ə ð ʊ n
byr	b ɪ r
bysell	b ə s ɛ ɬ
bysellfwrdd	b ə s ɛ ɬ v ʊ r ð
byth	b ɪ θ
byw	b ɪ u̯
bywiog	b ɪ u̯ j ɔ ɡ
cach	k aː χ
cactws	k a k t ʊ s
cadd	k aː ð
cadernid	k a d ɛ r n i d
cad	k aː d
cadnawes	k a d n a u̯ ɛ s
cadno	k a d n ɔ
caed	k a i̯ d
caeir	k e i̯ ɪ r
caem	k a i̯ m
caen	k a i̯ n
caergrawnt	k a i̯ r ɡ r a u̯ n t
caerhirfryn	k a i̯ r h ɪ r v r ɪ n
caer	k a i̯ r
caerloyw	k a i̯ r l ɔ i̯ u
caerlŷr	k a i̯ r l iː r
caerwrangon	k a i̯ r w r a ŋ ɔ n
caffai	k a f a i̯
caffed	k a f ɛ d
caffent	k a f ɛ n t
caffer	k a f ɛ r
caffîn	k a f iː n
cafiar	k a v j a r
cafiâr	k a v j aː r
cain	k a i̯ n
caint	k a i̯ n t
cais	k a i̯ s
cait	k a i̯ t
ca	k aː
calenigion	k a l ɛ n ɪ ɡ j ɔ n
caleted	k a l ɛ t ɛ d
calon	k a l ɔ n
calsiwm	k a l s j ʊ m
camgymeriad	k a m ɡ ə m ɛ r j a d
camu	k a m i
cangarŵ	k a ŋ ɡ a r uː
canghellor	k a ŋ h ɛ ɬ ɔ r
canhwyllbren	k a n h ʊ i̯ ɬ b r ɛ n
canlyniad	k a n l ə n j a d
canolbarth	k a n ɔ l b a r θ
cansen	k a n s ɛ n
cant	k a n t
capel	k a p ɛ l
carbon	k a r b ɔ n
carfil	k a r v ɪ l
carnedd	k a r n ɛ ð
carreg	k a r ɛ ɡ
carsi	k a r s i
carthen	k a r θ ɛ n
cartre	k a r t r ɛ
carwr	k a r ʊ r
casáu	k a s a i̯
casgen	k a s ɡ ɛ n
casglu	k a s ɡ l i
cath	k aː θ
cato	k a t ɔ
cawl	k a u̯ l
cawr	k a u̯ r
caws	k a u̯ s
cbac	k b a k
cefnog	k ɛ v n ɔ ɡ
ceg	k eː ɡ
cei	k e i̯
ceillgwd	k e i ɬ ɡ ʊ d
ceinach	k e i̯ n a χ
ceirios	k e i̯ r j ɔ s
ceir	k e i̯ r
celli	k ɛ ɬ i
cell	k ɛ ɬ
celynnen	k ɛ l ə n ɛ n
cen	k ɛ n
cerdded	k ɛ r ð ɛ d
cerdd	k ɛ r ð
cer	k ɛ r
cesar	k ɛ s a r
chad	χ aː d
chaen	χ a i̯ n
chaffed	χ a f ɛ d
chaffer	χ a f ɛ r
chain	χ a i̯ n
chais	χ a i̯ s
chalenigion	χ a l ɛ n ɪ ɡ j ɔ n
chalon	χ a l ɔ n
chansen	χ a n s ɛ n
chant	χ a n t
chân	χ aː n
char	χ a r
chastell	χ a s d ɛ ɬ
chas	χ aː s
chato	χ a t ɔ
chaws	χ a u̯ s
chdi	χ d iː
chei	χ e i̯
chell	χ ɛ ɬ
chestyll	χ ɛ s d ɪ ɬ
chest	χ ɛ s t
ches	χ eː s
chi	χ iː
chlwb	χ l ʊ b
chlyw	χ l ɪ u̯
chly	χ l iː
chnwd	χ n uː d
choeg	χ ɔ i̯ ɡ
chor	χ ɔ r
chosyn	χ ɔ s ɪ n
christ	χ r ɪ s t
chrwth	χ r uː θ
chul	χ iː l
chusanu	χ ɪ s aː n i
chut	χ ɪ t
chwalu	χ w a l i
chwern	h w ɛ r n
chwi	χ w iː
chwrs	χ ʊ r s
chwyth	h w iː θ
chyfiawnder	χ ə v j a u̯ n d ɛ r
chyfreithiwr	χ ə v r e i̯ θ j ʊ r
chymorth	χ ə m ɔ r θ
chymru	χ ə m r i
cig	k iː ɡ
ci	k iː
cilbost	k ɪ l b ɔ s t
cilddant	k ɪ l ð a n t
cildroi	k ɪ l d r ɔ i̯
ciledrych	k ɪ l ɛ d r ɪ χ
cilgant	k ɪ l ɡ a n t
cil	k iː l
cilwen	k ɪ l w ɛ n
ciwdod	k ɪ u̯ d ɔ d
claf	k l aː v
clas	k l aː s
cledd	k l eː ð
clirio	k l ɪ r j ɔ
cloch	k l oː χ
cloddfa	k l ɔ ð v a
cloem	k l ɔ i̯ m
cloent	k l ɔ i̯ n t
cloi	k l ɔ i̯
clois	k l ɔ i̯ s
cloit	k l ɔ i̯ t
clo	k l oː
closed	k l ɔ s ɛ d
closet	k l ɔ s ɛ t
clou	k l ɔ i̯
clown	k l ɔ u̯ n
clustdlws	k l ɪ s d l ʊ s
clwt	k l ʊ t
clwyd	k l ʊ i̯ d
clymu	k l ə m i
clywaf	k l ə w a v
clyw	k l ɪ u̯
cnwd	k n uː d
cobra	k ɔ b r a
coch	k oː χ
coeden	k ɔ i̯ d ɛ n
coegog	k ɔ i̯ ɡ ɔ ɡ
coelcerth	k ɔ i̯ l k ɛ r θ
coel	k ɔ i̯ l
coffi	k ɔ f i
cofia	k ɔ v j a
cofiem	k ɔ v j ɛ m
cofio	k ɔ v j ɔ
cofiwn	k ɔ v j ʊ n
cof	k oː v
cofnodion	k ɔ v n ɔ d j ɔ n
cofnod	k ɔ v n ɔ d
colfen	k ɔ l v ɛ n
colli	k ɔ ɬ i
collnod	k ɔ ɬ n ɔ d
coma	k ɔ m a
condemnio	k ɔ n d ɛ m n j ɔ
conwy	k ɔ n ʊ i̯
copog	k ɔ p ɔ ɡ
corff	k ɔ r f
corgi	k ɔ r ɡ i
corgwn	k ɔ r ɡ ʊ n
cor	k ɔ r
côr	k oː r
corn	k ɔ r n
cosyn	k ɔ s ɪ n
crair	k r a i̯ r
cramen	k r a m ɛ n
cred	k r eː d
cref	k r eː v
crempog	k r ɛ m p ɔ ɡ
creto	k r ɛ t ɔ
crist	k r ɪ s t
criw	k r ɪ u̯
croeniog	k r ɔ i̯ n j ɔ ɡ
croesair	k r ɔ i̯ s a i̯ r
croesffordd	k r ɔ i̯ s f ɔ r ð
croesgad	k r ɔ i̯ s ɡ a d
croeshoelio	k r ɔ i̯ s h ɔ i̯ l j ɔ
croesi	k r ɔ i̯ s i
croestorri	k r ɔ i̯ s d ɔ r i
crog	k r oː ɡ
croglen	k r ɔ ɡ l ɛ n
cromlech	k r ɔ m l ɛ χ
cronni	k r ɔ n i
croth	k r oː θ
crwn	k r ʊ n
crwth	k r uː θ
crwyn	k r ʊ i̯ n
crychydd	k r ə χ ɪ ð
cryf	k r iː v
crymu	k r ə m i
crynu	k r ə n i
crynwr	k r ə n ʊ r
crynwyr	k r ə n w ɪ r
cucumer	k ɪ k ɪ m ɛ r
cuddio	k ɪ ð j o
cu	k iː
cul	k iː l
cusan	k ɪ s a n
cut	k ɪ t
cwb	k ʊ b
cwestiwn	k w ɛ s t j ʊ n
cwis	k w ɪ s
cwm	k ʊ m
cwmpas	k ʊ m p a s
cwmpawd	k ʊ m p a u̯ d
cwmwd	k ʊ m ʊ d
cwmwl	k ʊ m ʊ l
cwningen	k ʊ n ɪ ŋ ɛ n
cŵn	k uː n
cwpwrdd	k ʊ p ʊ r ð
cwsg	k ʊ s ɡ
cwta	k ʊ t a
cwtiar	k ʊ t j a r
cwymp	k ʊ ɪ̯ m p
cwyn	k ʊ i̯ n
cwyno	k ʊ i̯ n ɔ
cwyr	k ʊ i̯ r
cydbreswylwyr	k iː d b r ɛ s ʊ i̯ l w ɪ r
cyfarch	k ə v a r χ
cyfarchol	k ə v a r χ ɔ l
cyfarfod	k ə v a r v ɔ d
cyfathrach	k ə v a θ r a χ
cyfddydd	k ə v ð ɪ ð
cyfforddus	k ə f ɔ r ð ɪ s
cyffwrdd	k ə f ʊ r ð
cyffylog	k ə f ə l ɔ ɡ
cyfieithu	k ə v j e i̯ θ i
cyfieithydd	k ə v j e i̯ θ ɪ ð
cyfle	k ə v l ɛ
cyflwr	k ə v l ʊ r
cyflwyno	k ə v l ʊ i̯ n ɔ
cyfnewid	k ə v n ɛ u̯ ɪ d
cyfnod	k ə v n ɔ d
cyfnos	k ə v n ɔ s
cyfoethog	k ə v ɔ i̯ θ ɔ ɡ
cyfreithiwr	k ə v r e i̯ θ j ʊ r
cyfrifiant	k ə v r ɪ v j a n t
cyfrin	k ə v r ɪ n
cyfrol	k ə v r ɔ l
cyfrwy	k ə v r ʊ i̯
cyfrwyo	k ə v r ʊ i̯ ɔ
cyfyng	k ə v ɪ ŋ
cyhyd	k ə h iː d
cyhydnos	k ə h ə d n ɔ s
cyhyr	k ə h ɪ r
cyhyrog	k ə h ə r ɔ ɡ
cylchu	k ə l χ i
cylion	k ə l j ɔ n
cyll	k ɪ ɬ
cymal	k ə m a l
cymorthion	k ə m ɔ r θ j ɔ n
cymorth	k ə m ɔ r θ
cymraes	k ə m r a i̯ s
cymru	k ə m r i
cymryd	k ə m r ɪ d
cymry	k ə m r i
cynddrwg	k ə n ð r ʊ ɡ
cyngor	k ə ŋ ɔ r
cynhadledd	k ə n h a d l ɛ ð
cynhaeaf	k ə n h aː i̯ a v
cynhorthwy	k ə n h ɔ r θ ʊ i̯
cynhyrchu	k ə n h ə r χ i
cŷn	k iː n
cyn	k ɪ n
cynnig	k ə n ɪ ɡ
cynnud	k ə n ɪ d
cynnull	k ə n ɪ ɬ
cynnwrf	k ə n ʊ r ə v
cynnwys	k ə n ʊ i̯ s
cynnydd	k ə n ɪ ð
cynnyrch	k ə n ɪ r χ
cyntedd	k ə n t ɛ ð
cyrchu	k ə r χ i
cysylltiad	k ə s ə ɬ d j a d
cysylltu	k ə s ə ɬ d i
cywir	k ə u̯ ɪ r
da	d aː
dad	d aː d
dadiol	d a d j ɔ l
dadl	d a d l
dadleuol	d a d l e i̯ ɔ l
dadleuon	d a d l e i̯ ɔ n
dadwreiddio	d a d ʊ r ɛ i̯ ð j ɔ
daearfoch	d e i̯ a r v ɔ χ
dail	d a i̯ l
dalcen	d a l k ɛ n
dal	d a l
dâl	d aː l
dalfa	d a l v a
dalia	d a l j a
daliaf	d a l j a v
dan	d a n
dân	d aː n
danfon	d a n v ɔ n
dangos	d a ŋ ɡ ɔ s
dant	d a n t
darian	d a r j a n
darllen	d a r ɬ ɛ n
darlunio	d a r l ɪ n j ɔ
darpar	d a r p a r
datblygiad	d a t b l ə ɡ j a d
dathlu	d a θ l i
datys	d a t ɪ s
daw	d a u̯
dawn	d a u̯ n
ddail	ð a i̯ l
ddant	ð a n t
ddarllen	ð a r ɬ ɛ n
ddathlu	ð a θ l i
dde	ð eː
ddegfed	ð ɛ ɡ v ɛ d
ddeilen	ð e i̯ l ɛ n
ddeng	ð ɛ ŋ
ddeset	ð ɛ s ɛ t
ddeuddeg	ð e i̯ ð ɛ ɡ
ddeuddegfed	ð e i̯ ð ɛ ɡ v ɛ d
ddolis	ð ɔ l i z
ddos	ð oː s
dduw	ð ɪ u̯
ddyn	ð iː n
decaf	d ɛ k a v
deddfu	d ɛ ð v i
de	d eː
deffro	d ɛ f r ɔ
degfed	d ɛ ɡ v ɛ d
dei	d e i̯
deigr	d e i̯ ɡ r
deigrod	d e i̯ ɡ r ɔ d
deigryn	d e i̯ ɡ r ɪ n
deng	d ɛ ŋ
derbyn	d ɛ r b ɪ n
derbyniad	d ɛ r b ə n j a d
derbyniol	d ɛ r b ə n j o l
derbynneb	d ɛ r b ə n ɛ b
derwen	d ɛ r w ɛ n
desen	d ɛ s ɛ n
deses	d ɛ s ɛ s
deset	ð ɛ s ɛ t
deuddeg	d e i̯ ð ɛ ɡ
deuddegfed	d e i̯ ð ɛ ɡ v ɛ d
deunydd	d ə i̯ n ɪ ð
deusaith	d e i̯ s a i̯ θ
dewch	d ɛ u̯ χ
dewed	d ɛ u̯ ɛ d
dewi	d ɛ u̯ i
deyrnaddoliant	d e i̯ r n a ð ɔ l j a n t
diarhebion	d i a r h ɛ b j ɔ n
diddordeb	d ɪ ð ɔ r d ɛ b
di	d iː
didranc	d ɪ d r a ŋ k
difetha	d ɪ v ɛ θ a
digwyddaf	d ɪ ɡ w ə ð a f
digwydd	d ɪ ɡ w ɪ ð
dileu	d ɪ l e i̯
dillad	d ɪ ɬ a d
dim	d ɪ m
dirmyg	d ɪ r m ɪ ɡ
dirmygus	d ɪ r m ə ɡ ɪ s
disgybl	d ɪ s ɡ ɪ b l
diwedd	d ɪ u̯ ɛ ð
do'ch	d oː χ
dod	d oː d
doeddech	d ɔ i̯ ð ɛ χ
doedden	d ɔ i̯ ð ɛ n
doeddet	d ɔ i̯ ð ɛ t
doem	d ɔ i̯ m
doen	d ɔ i̯ n
doer	d ɔ i̯ r
dof	d oː v
dogfen	d ɔ ɡ v ɛ n
doid	d ɔ i̯ d
doir	d ɔ i̯ r
dois	d ɔ i̯ s
doit	d ɔ i̯ t
dòl	d ɔ l
dolffin	d ɔ l f ɪ n
doli	d ɔ l i
do'n	d oː n
dorra	d ɔ r a
dorrent	d ɔ r ɛ n t
dorrid	d ɔ r ɪ d
dorsen	d ɔ r s ɛ n
dowd	d o u̯ d
down	d o u̯ n
drawant	d r a u̯ a n t
dre	d r eː
droen	d r ɔ i̯ n
droet	d r ɔ i̯ t
droid	d r ɔ i̯ d
dros	d r ɔ s
drown	d r o u̯ n
drwg	d r uː ɡ
drws	d r uː s
drwydded	d r ʊ i̯ ð ɛ d
drwy	d r ʊ i̯
dry	d r iː
du	d iː
dug	d iː ɡ
duw	d ɪ u̯
dwfr	d ʊ v r
dwg	d uː ɡ
dwyieithog	d ʊ i̯ j e i̯ θ ɔ ɡ
dwyn	d ʊ i̯ n
dwys	d ʊ i̯ s
dwyt	d ʊ i̯ t
dybarth	d ə b a r θ
dyblu	d ə b l i
dy	d ə
dŷ	d iː
dydw	d ə d u
dydy	d ə d i
dyfeiswraig	d ə v e i̯ s w r a i̯ ɡ
dyffryn	d ə f r ɪ n
dyfi	d ə v i
dyfnion	d ə v n j ɔ n
dyfrdwy	d ə v r d ʊ i̯
dyfrfarch	d ə v r v a r χ
dyfrgi	d ə v r ɡ i
dyfynnod	d ə v ə n ɔ d
dylan	d ə l a n
dylanwad	d ə l a n w a d
dylu	d ə l ɪ
dyma	d ə m a
dyn	d iː n
dynladdiad	d iː n l a ð j a d
dynleiddiad	d iː n l e i̯ ð j a d
dyr	d ɪ r
dysgwr	d ə s ɡ ʊ r
ebargofiant	ɛ b a r ɡ ɔ v j a n t
ebrill	ɛ b r ɪ ɬ
ebychnod	ɛ b ə χ n ɔ d
ecogyfeillgar	ɛ k ɔ ɡ ə v e i̯ ɬ ɡ a r
edfryd	ɛ d v r ɪ d
edliw	ɛ d l ɪ u̯
edn	ɛ d n
edrych	ɛ d r ɪ χ
edwyn	ɛ d w ɪ n
efengylu	ɛ v ɛ ŋ ə l i
ef	eː v
efrog	ɛ v r ɔ ɡ
egwyddor	ɛ ɡ ʊ i̯ ð ɔ r
eiddew	e i ð ɛ u̯
eid	e i̯ d
eilir	e i̯ l ɪ r
eira	e i̯ r a
eir	e i̯ r
eiriadurwyr	e i̯ r j a d ɪ r w ɪ r
eirin	e i̯ r ɪ n
eirlithrad	e i r l ɪ θ r a d
eirlys	e i̯ r l ɪ s
eirth	e i̯ r θ
eisteddle	e i̯ s d ɛ ð l ɛ
êl	eː l
elfed	ɛ l v ɛ d
elfen	ɛ l v ɛ n
eliffant	ɛ l ɪ f a n t
elli	ɛ ɬ i
elltydd	ɛ ɬ d ɪ ð
elsai	ɛ l s a i̯
elsech	ɛ l s ɛ χ
elsem	ɛ l s ɛ m
elsent	ɛ l s ɛ n t
elsid	ɛ l s ɪ d
elsit	ɛ l s ɪ t
elswn	ɛ l s ʊ n
elwa	ɛ l w a
emrys	ɛ m r ɪ s
enfys	ɛ n v ɪ s
engyl	ɛ ŋ ɪ l
ennill	ɛ n ɪ ɬ
erchyll	ɛ r χ ɪ ɬ
erfyn	ɛ r v ɪ n
ergyd	ɛ r ɡ ɪ d
es	eː s
esgid	ɛ s ɡ ɪ d
esgyrn	ɛ s ɡ ɪ r n
estron	ɛ s d r ɔ n
euog	e i̯ ɔ ɡ
euthum	e i̯ θ ɪ m
ewch	ɛ ʊ̯ χ
ewin	ɛ u̯ ɪ n
fab	v aː b
fach	v aː χ
fadfall	v a d v a ɬ
faet	v a i̯ t
fag	v aː ɡ
faint	v a i̯ n t
fair	v a i̯ r
fam	m a m
fampir	v a m p ɪ r
farn	v a r n
fathemateg	v a θ ɛ m a t ɛ ɡ
fawn	v a u̯ n
fawrth	v a u̯ r θ
fechan	v eː χ a n
fedra	v ɛ d r a
felly	v ɛ ɬ i
fel	v ɛ l
ferch	v ɛ r χ
fersiwn	v ɛ r ʃ ʊ n
fether	v ɛ θ ɛ r
fe	v eː
ffa	f aː
ffair	f a i̯ r
ffenestri	f ɛ n ɛ s d r i
ffilm	f ɪ l m
fflapjac	f l a p d͡ʒ a k
ffoi	f o i̯
ffon	f ɔ n
ffôn	f oː n
ffowlyn	f o u̯ l ɪ n
ffrancwr	f r a ŋ k ʊ r
ffrancwyr	f r a ŋ k w ɪ r
ffrengig	f r ɛ ŋ ɪ ɡ
ffres	f r ɛ ʃ
ffrind	f r ɪ n d
ffrwchnedd	f r ʊ χ n ɛ ð
ffrwd	f r uː d
ffrwyth	f r ʊ i̯ θ
ffurf	f ɪ r v
ffurfio	f ɪ r v j ɔ
ffurfiol	f ɪ r v j ɔ l
ffwciaf	f ʊ k j a v
ffwrcho	f ʊ r χ ɔ
ffwrn	f ʊ r n
ffyn	f ɪ n
ficer	v ɪ k ɛ r
fil	v iː l
flaidd	v l a i̯ ð
flin	v l iː n
foes	v ɔ i̯ s
fol	v ɔ l
fôr	v oː r
fo	v oː
frân	v r aː n
frecwast	v r ɛ k w a s t
frith	v r iː θ
fri	v r iː
froch	v r oː χ
fron	v r ɔ n
fwg	v uː ɡ
fwyd	v ʊ i̯ d
fwy	v ʊ i̯
fyr	v ɪ r
fys	v iː s
gach	ɡ aː χ
gad	ɡ aː d
gadawed	ɡ a d a u̯ ɛ d
gadd	ɡ aː ð
gaeafgysgu	ɡ e i̯ a v ɡ ə s ɡ i
gaed	ɡ a i̯ d
gaf	ɡ aː v
gaffai	ɡ a f a i̯
gaffed	ɡ a f ɛ d
gaffel	ɡ a f ɛ l
gaffent	ɡ a f ɛ n t
gaffer	ɡ a f ɛ r
gafrewig	ɡ a v r ɛ w ɪ ɡ
gain	ɡ a i̯ n
gaint	ɡ a i̯ n t
gair	ɡ a i̯ r
gais	ɡ a i̯ s
gait	ɡ a i̯ t
gâl	ɡ aː l
galennig	ɡ a l ɛ n ɪ ɡ
galeted	ɡ a l ɛ t ɛ d
galla	ɡ a ɬ a
gallan	ɡ a ɬ a n
gallant	ɡ a ɬ a n t
galled	ɡ a ɬ ɛ d
gallen	ɡ a ɬ ɛ n
galler	ɡ a ɬ ɛ r
galli	ɡ a ɬ i
gallo	ɡ a ɬ ɔ
gallu	ɡ a ɬ i
galon	ɡ a l ɔ n
gân	ɡ aː n
gansai	ɡ a n s a i̯
gar	ɡ a r
gardd	ɡ a r ð
gas	ɡ aː s
gastell	ɡ a s d ɛ ɬ
gath	ɡ aː θ
gato	ɡ a t ɔ
gawn	ɡ a u̯ n
gaws	ɡ a u̯ s
gefeilles	ɡ ɛ v e i̯ ɬ ɛ s
gei	ɡ e i̯
gelli	ɡ ɛ ɬ i
gellygen	ɡ ɛ ɬ ə ɡ ɛ n
gêm	ɡ eː m
gemwaith	ɡ ɛ m w a i̯ θ
gên	ɡ eː n
ger	ɡ ɛ r
gestyll	ɡ ɛ s d ɪ ɬ
glân	ɡ l aː n
glasach	ɡ l a s a χ
glased	ɡ l a s ɛ d
glasgoch	ɡ l a s ɡ ɔ χ
glas	ɡ l aː s
glaswellt	ɡ l a s w ɛ ɬ d
glew	ɡ l ɛ u̯
glin	ɡ l iː n
glo	ɡ l oː
glwb	ɡ l ʊ b
glyw	ɡ l ɪ u̯
gna	ɡ n aː
gnawn	ɡ n a u̯ n
gnei	ɡ n e i̯
gnwd	ɡ n uː d
goddrych	ɡ ɔ ð r ɪ χ
goddrychol	ɡ ɔ ð r ə χ ɔ l
goeg	ɡ ɔ i̯ ɡ
gof	ɡ oː v
gofynnod	ɡ ɔ v ə n ɔ d
gogledd	ɡ ɔ ɡ l ɛ ð
gogs	ɡ ɔ ɡ z
golchi	ɡ ɔ l χ i
gôl	ɡ oː l
golygfeydd	ɡ ɔ l ə ɡ v e i̯ ð
gorchaw	ɡ ɔ r χ a u̯
gorchuddio	ɡ ɔ r χ ɪ ð j ɔ
gorffennaf	ɡ ɔ r f ɛ n a v
gorffen	ɡ ɔ r f ɛ n
gorfodtref	ɡ ɔ r v ɔ d t r ɛ v
goriad	ɡ ɔ r j a d
gorlifaf	ɡ ɔ r l iː v a v
gorllewin	ɡ ɔ r ɬ ɛ u̯ ɪ n
gorsaf	ɡ ɔ r s a v
gorwel	ɡ ɔ r w ɛ l
gosyn	ɡ ɔ s ɪ n
graff	ɡ r a f
grawnwin	ɡ r a u̯ n w ɪ n
greto	ɡ r ɛ t ɔ
grêt	ɡ r eː t
grist	ɡ r ɪ s t
grug	ɡ r iː ɡ
grwth	ɡ r uː θ
gu	ɡ iː
gusan	ɡ ɪ s a n
gut	ɡ ɪ t
gwag	ɡ w aː ɡ
gwain	ɡ w a i̯ n
gwair	ɡ w a i̯ r
gwalch	ɡ w a l χ
gwallt	ɡ w a ɬ d
gwario	ɡ w a r j ɔ
gwarthal	ɡ w a r θ a l
gwar	ɡ w a r
gwâr	ɡ w aː r
gwastraff	ɡ w a s d r a f
gwdihŵ	ɡ ʊ d ɪ h uː
gwella	ɡ w ɛ ɬ a
gwellt	ɡ w ɛ ɬ d
gwelsen	ɡ w ɛ l s ɛ n
gwenhwyfar	ɡ w ɛ n h ʊ i̯ v a r
gwen	ɡ w ɛ n
gwên	ɡ w eː n
gwenynen	ɡ w e n ə n ɛ n
gwerdd	ɡ w ɛ r ð
gwernog	ɡ w ɛ r n ɔ ɡ
gwern	ɡ w ɛ r n
gwerthu	ɡ w ɛ r θ i
gwerth	ɡ w ɛ r θ
gwesty	ɡ w ɛ s t i
gwin	ɡ w iː n
gwir	ɡ w iː r
gwledd	ɡ w l eː ð
gwleidyddol	ɡ w l e i̯ d ə ð ɔ l
gwlych	ɡ w l iː χ
gwraidd	ɡ w r a i̯ ð
gwreiddiadur	ɡ ʊ r ɛ i̯ ð j a d ɪ r
gwrs	ɡ ʊ r s
gwrthrychol	ɡ ʊ r θ r ə χ ɔ l
gwrthrych	ɡ ʊ r θ r ɪ χ
gwrthwynebair	ɡ ʊ r θ w ɪ n ɛ b a i̯ r
gŵr	ɡ uː r
gwyach	ɡ ʊ i̯ a χ
gwyar	ɡ ʊ i̯ a r
gwyched	ɡ w ə χ ɛ d
gwych	ɡ w iː χ
gwydden	ɡ w ɪ ð ɛ n
gwyddion	ɡ w ə ð j ɔ n
gwyddon	ɡ w ə ð ɔ n
gwŷdd	ɡ w iː ð
gwyfyn	ɡ w ə v ɪ n
gwy	ɡ ʊ i̯
gwylan	ɡ ʊ i̯ l a n
gŵyl	ɡ ʊ i̯ l
gŵyll	ɡ ʊ i̯ ɬ
gwyllon	ɡ w ə ɬ ɔ n
gwyllt	ɡ w ɪ ɬ d
gwŷl	ɡ w iː l
gwynedd	ɡ u i̯ n ɛ ð
gwyneth	ɡ w ɪ n ɛ θ
gwynnach	ɡ w ə n a χ
gwynt	ɡ w ɪ n t
gwŷn	ɡ w iː n
gwyn	ɡ w ɪ n
gwyrdd	ɡ w ɪ r ð
gŵyr	ɡ ʊ i̯ r
gwŷr	ɡ w iː r
gwys	ɡ w iː s
gŵyth	ɡ ʊ i̯ θ
gyfiawnder	ɡ ə v j a u̯ n d ɛ r
gyfreithiwr	ɡ ə v r e i̯ θ j ʊ r
gymorth	ɡ ə m ɔ r θ
gyrraf	ɡ ə r a v
gyrru	ɡ ə r i
gyrrwr	ɡ ə r ʊ r
hadeilad	h a d e i̯ l a d
hadolygu	h a d ɔ l ə ɡ i
hadran	h a d r a n
hadwaenent	h a d w e i̯ n ɛ n t
haelwyd	h e i̯ l ʊ i̯ d
haen	h a i̯ n
haf	h aː v
hail	h a i̯ l
hais	h a i s
halibalŵ	h a l ɪ b a l uː
hamod	h a m ɔ d
hamser	h a m s ɛ r
hances	h a n k ɛ s
hanfon	h a n v ɔ n
hangen	h a ŋ ɛ n
hanner	h a n ɛ r
hannwyd	h a n ʊ i̯ d
hapus	h a p ɪ s
harddach	h a r ð a χ
hardd	h a r ð
harglwydd	h a r ɡ l ʊ i̯ ð
harian	h a r j a n
harth	h a r θ
hatyr	h a t ɪ r
hawdd	h a u̯ ð
hawl	h a u̯ l
heb	h eː b
hedd	h eː ð
heddlu	h ɛ ð l i
heddwas	h ɛ ð w a s
heirdd	h e i̯ r ð
heisteddfod	h e i̯ s d ɛ ð v ɔ d
hel	h ɛ l
heliwm	h ɛ l j ʊ m
help	h ɛ l p
helygen	h ɛ l ə ɡ ɛ n
henffordd	h ɛ n f ɔ r ð
her	h ɛ r
heuldro	h e i̯ l d r ɔ
heulsaf	h e i̯ l s a v
hi	h iː
hir	h iː r
hoen	h ɔ i̯ n
hoffen	h ɔ f ɛ n
hoffet	h ɔ f ɛ t
hoff	h oː f
hoffi	h ɔ f i
hofran	h ɔ v r a n
hofrennydd	h ɔ v r ɛ n ɪ ð
holl	h oː ɬ
hon	h ɔ n
honno	h ɔ n ɔ
hoyw	h ɔ i̯ u
huddygl	h ɪ ð ɪ ɡ l
hud	h iː d
hun	h iː n
hwch	h uː χ
hwn	h ʊ n
hwnna	h ʊ n a
hwnnw	h ʊ n u
hwntw	h ʊ n t u
hwntws	h ʊ n t u z
hwyad	h ʊ i̯ a d
hwyl	h ʊ i̯ l
hwyr	h ʊ i̯ r
hwythfed	h ʊ i̯ θ v ɛ d
hych	h iː χ
hyfed	h ə v ɛ d
hylif	h ə l ɪ v
hynny	h ə n i
hynt	h ɪ n t
hysbys	h ə s b ɪ s
hysgi	h ə s ɡ i
hywel	h ə u̯ ɛ l
iach	j aː χ
iaith	j a i̯ θ
iarll	j a r ɬ
iawn	j a u̯ n
ichwi	ɪ χ w i
ieithoedd	j e i̯ θ ɔ i̯ ð
iesu	j ɛ s i
ieuanc	j e i̯ a ŋ k
ieuan	j e i̯ a n
imi	ɪ m i
im	ɪ m
in	ɪ n
inni	ɪ n i
isod	ɪ s ɔ d
iti	ɪ t i
it	ɪ t
iwan	ɪ u̯ a n
iwch	ɪ u̯ χ
iwrch	j ʊ r χ
i'w	ɪ u̯
jôc	d͡ʒ oː k
labovaidd	l a b ɔ v a i̯ ð
ladd	l aː ð
ladron	l a d r ɔ n
laith	l a i̯ θ
lan	l a n
lân	l aː n
lasach	l a s a χ
lasen	l a s ɛ n
lawio	l a u̯ j ɔ
lawn	l a u̯ n
ledled	l ɛ d l ɛ d
le	l eː
lerpwl	l ɛ r p ʊ l
letysen	l ɛ t ə s ɛ n
leuen	l e i̯ ɛ n
lifft	l ɪ f d
lindys	l ɪ n d ɪ s
lindysyn	l ɪ n d ə s ɪ n
lin	l iː n
lladd	ɬ aː ð
lladrad	ɬ a d r a d
lladron	ɬ a d r ɔ n
llaid	ɬ a i̯ d
llaith	ɬ a i̯ θ
llam	ɬ a m
llan	ɬ a n
llanelli	ɬ a n ɛ ɬ i
llasen	ɬ a s ɛ n
llau	ɬ a i̯
llawen	ɬ a u̯ ɛ n
llawn	ɬ a u̯ n
llawr	ɬ a u̯ r
llawysgrif	ɬ a u̯ ə s ɡ r ɪ v
llech	ɬ eː χ
lledieithog	ɬ ɛ d j e i̯ θ ɔ ɡ
lle	ɬ eː
llen	ɬ ɛ n
llên	ɬ eː n
llenydda	ɬ ɛ n ə ð a
llenyddol	ɬ ɛ n ə ð ɔ l
lleuad	ɬ e i̯ a d
lleuen	ɬ e i̯ ɛ n
llewod	ɬ ɛ u̯ ɔ d
llid	ɬ iː d
lliwyddion	ɬ ɪ u̯ ə ð j ɔ n
lliwydd	ɬ ɪ u̯ ɪ ð
llnau	ɬ n a i̯
lloc	ɬ ɔ k
lloer	ɬ ɔ i̯ r
llong	ɬ ɔ ŋ
llo	ɬ oː
llosgi	ɬ ɔ s ɡ i
llost	ɬ ɔ s d
llu	ɬ iː
llun	ɬ iː n
llus	ɬ iː s
llwch	ɬ uː χ
llwnc	ɬ ʊ ŋ k
llwyddo	ɬ ʊ i̯ ð ɔ
llwyd	ɬ ʊ i̯ d
llychlyn	ɬ ə χ l ɪ n
llychlynnaidd	ɬ ə χ l ə n a i̯ ð
llydan	ɬ ə d a n
llydaw	ɬ ə d a u̯
llyffant	ɬ ə f a n t
llyf	ɬ iː v
llyfu	ɬ ə v i
llygod	ɬ ə ɡ ɔ d
llygru	ɬ ə ɡ r i
llythyr	ɬ ə θ ɪ r
llyw	ɬ ɪ u̯
llywy	ɬ ə ʊ̯ i
lolfa	l ɔ l v a
lonciwr	l ɔ n k j ʊ r
lowri	l o u̯ r i
lydan	l ə d a n
lydaw	l ə d a u̯
lyf	l iː v
mab	m aː b
mach	m aː χ
madfall	m a d v a ɬ
mad	m aː d
maent	m a i̯ n t
maes	m a i̯ s
maestref	m e i s d r ɛ v
mag	m aː ɡ
mai	m a i̯
main	m a i̯ n
maint	m a i̯ n t
mair	m a i̯ r
malwod	m a l w ɔ d
mam	m a m
mamoth	m a m ɔ θ
mango	m a ŋ ɡ ɔ
man	m a n
march	m a r χ
marchog	m a r χ ɔ ɡ
masen	m a s ɛ n
mathemateg	m a θ ɛ m a t ɛ ɡ
math	m aː θ
mawrth	m a u̯ r θ
medd	m eː ð
medra	m ɛ d r a
medran	m ɛ d r a n
medren	m ɛ d r ɛ n
medro	m ɛ d r ɔ
mefusen	m ɛ v ɪ s ɛ n
mêl	m eː l
melon	m ɛ l ɔ n
melyngoch	m ɛ l ə ŋ ɡ ɔ χ
melynion	m ɛ l ə n j ɔ n
merch	m ɛ r χ
mercwri	m ɛ r k ʊ r i
mesur	m ɛ s ɪ r
methan	m ɛ θ a n
mether	m ɛ θ ɛ r
methi	m ɛ θ i
metho	m ɛ θ ɔ
methu	m ɛ θ i
mewnol	m ɛ u̯ n ɔ l
mhaith	m̥ a i̯ θ
mhengwin	m̥ ɛ ŋ ɡ w ɪ n
mhen	m̥ ɛ n
mheth	m̥ eː θ
mhobloedd	m̥ ɔ b l ɔ i̯ ð
mhont	m̥ ɔ n t
mhoptai	m̥ ɔ p t a i̯
mhopty	m̥ ɔ p t i
mhrif	m̥ r iː v
mhryfed	m̥ r ə v ɛ d
mhum	m̥ ɪ m
milcant	m i l k a n t
miliwn	m ɪ l j ʊ n
mil	m iː l
milwyr	m ɪ l w ɪ r
mislif	m ɪ s l ɪ v
mlaidd	m l a i̯ ð
moch	m oː χ
modd	m oː ð
mod	m oː d
modrwy	m ɔ d r ʊ i̯
moel	m ɔ i̯ l
moes	m ɔ i̯ s
mollt	m ɔ ɬ t
mol	m ɔ l
môn	m oː n
mordydd	m ɔ r d ɪ ð
môr	m oː r
motél	m ɔ t ɛ l
mrain	m r a i̯ n
mrân	m r aː n
mri	m r iː
mur	m iː r
mẁg	m ʊ ɡ
mwg	m uː ɡ
mwll	m ʊ ɬ
mwncïod	m ʊ ŋ k iː ɔ d
mwnt	m ʊ n t
mwyafrif	m ʊ i̯ a v r ɪ v
mwyalchen	m u i̯ a l χ ɛ n
mwyar	m ʊ i̯ a r
mwyd	m ʊ i̯ d
mwyeilch	m u i̯ e i̯ l χ
mwynach	m ʊ i̯ n a χ
mwynhau	m ʊ i̯ n h a i̯
myfyriwr	m ə v ə r j ʊ r
myfyrwyr	m ə v ə r w ɪ r
mynediad	m ə n ɛ d j a d
myned	m ə n ɛ d
mynwy	m ə n ʊ i̯
mynyddig	m ə n ə ð ɪ ɡ
myrddiwn	m ə r ð j ʊ n
myrdd	m ɪ r ð
myr	m ɪ r
nabl	n a b l
nadredd	n a d r ɛ ð
naet	n a i̯ t
nag	n a ɡ
nail	n a i̯ l
nai	n a i̯
nant	n a n t
nathlu	n a θ l i
nawfed	n a u̯ v ɛ d
naw	n a u̯
nawr	n a u̯ r
negfed	n ɛ ɡ v ɛ d
neidit	n e i̯ d ɪ t
nei	n e i̯
neithiwyr	n e i̯ θ j ʊ i̯ r
neng	n ɛ ŋ
nentydd	n ɛ n t ɪ ð
nerfus	n ɛ r v ɪ s
nerth	n ɛ r θ
nerthoedd	n ɛ r θ ɔ i̯ ð
neuadd	n e i̯ a ð
neuddegfed	n e i̯ ð ɛ ɡ v ɛ d
neud	n e i̯ d
newid	n ɛ u̯ ɪ d
newydd	n ɛ u̯ ɪ ð
newyn	n ɛ u̯ ɪ n
ngair	ŋ a i̯ r
ngâl	ŋ aː l
ngeiriadurwyr	ŋ e i̯ r j a d ɪ r w ɪ r
ngelli	ŋ ɛ ɬ i
nghad	ŋ̊ aː d
nghaint	ŋ̊ a i̯ n t
nghais	ŋ̊ a i̯ s
nghalenigion	ŋ̊ a l ɛ n ɪ ɡ j ɔ n
nghalennig	ŋ̊ a l ɛ n ɪ ɡ
nghalon	ŋ̊ a l ɔ n
nghân	ŋ̊ aː n
nghar	ŋ̊ a r
nghastell	ŋ̊ a s d ɛ ɬ
nghath	ŋ̊ aː θ
nghaws	ŋ̊ a u̯ s
nghell	ŋ̊ ɛ ɬ
nghestyll	ŋ̊ ɛ s d ɪ ɬ
nghi	ŋ̊ iː
nghlyw	ŋ̊ l ɪ u̯
nghosyn	ŋ̊ ɔ s ɪ n
nghrist	ŋ̊ r ɪ s t
nghrwth	ŋ̊ r uː θ
nghusan	ŋ̊ ɪ s a n
nghusanu	ŋ̊ ɪ s aː n i
nghut	ŋ̊ ɪ t
nghwrs	ŋ̊ ʊ r s
nghydbreswylwyr	ŋ̊ iː d b r ɛ s ʊ i̯ l w ɪ r
nghyfiawnder	ŋ̊ ə v j a u̯ n d ɛ r
nghyfreithiwr	ŋ̊ ə v r e i̯ θ j ʊ r
nghymorth	ŋ̊ ə m ɔ r θ
nghymru	ŋ̊ ə m r i
nglân	ŋ l aː n
nglasach	ŋ l a s a χ
nglased	ŋ l a s ɛ d
nglas	ŋ l aː s
nglawio	ŋ l a u̯ j ɔ
ngwain	ŋ w a i̯ n
ngwair	ŋ w a i̯ r
ngwario	ŋ w a r j ɔ
ngweddi	ŋ w eː ð i
ngwin	ŋ w iː n
ngwiwer	ŋ w ɪ u̯ ɛ r
ngwlad	ŋ w l aː d
ngŵr	ŋ uː r
ngwychach	ŋ w ə χ a χ
ngwych	ŋ w iː χ
ngwyddion	ŋ w ə ð j ɔ n
ngŵydd	ŋ ʊ ɪ̯ ð
ngwŷdd	ŋ w iː ð
ngŵyr	ŋ ʊ i̯ r
ngwys	ŋ w iː s
nhad	n̥ aː d
nhalcen	n̥ a l k ɛ n
nhâl	n̥ aː l
nhân	n̥ aː n
nheigr	n̥ e i̯ ɡ r
nheigrod	n̥ e i̯ ɡ r ɔ d
nhe	n̥ eː
nhewed	n̥ ɛ u̯ ɛ d
nhewi	n̥ ɛ u̯ i
nhi	n̥ iː
nhre	n̥ r eː
nhro	n̥ r oː
nhrwydded	n̥ r ʊ i̯ ð ɛ d
nhu	n̥ iː
nhŵr	n̥ uː r
nhŷ	n̥ iː
nid	n ɪ d
ni	n iː
nitrogen	n ɪ t r ɔ ɡ ɛ n
niwclear	n ɪ u̯ k l ɛ a r
niweidio	n ɪ u̯ e i̯ d j ɔ
niwliog	n ɪ u̯ l j ɔ ɡ
niwl	n ɪ u̯ l
nod	n oː d
nofio	n ɔ v j ɔ
nofiwr	n ɔ v j ʊ r
nofwraig	n ɔ v w r a i̯ ɡ
noli	n ɔ l i
nolis	n ɔ l i z
nôl	n oː l
nwyf	n ʊ i̯ v
nyrs	n ə r s
nyth	n iː θ
nythu	n ə θ i
oce	ɔ k ɛ
oddeutu	ɔ ð e i̯ t i
oddf	ɔ ð v
odl	ɔ d l
olddodiad	oː l ð ɔ d j a d
onnen	ɔ n ɛ n
paith	p a i̯ θ
pajamas	p a d͡ʒ a m a z
palmant	p a l m a n t
pam	p a m
pandai	p a n d a i̯
pandy	p a n d i
pan	p a n
pant	p a n t
pa	p aː
parc	p a r k
parddu	p a r ð i
parhau	p a r h a i̯
parotach	p a r ɔ t a χ
parth	p a r θ
pasg	p a s ɡ
pau	p a i̯
pawb	p a u̯ b
pedrongl	p ɛ d r ɔ ŋ l
pedrsill	p ɛ d r s ɪ ɬ
peirianneg	p e i̯ r j a n ɛ ɡ
peiriannol	p e i̯ r j a n ɔ l
peiriannwr	p e i̯ r j a n ʊ r
peiriant	p e i̯ r j a n t
penddu	p ɛ n ð i
penderfynu	p ɛ n d ɛ r v ə n i
pengwin	p ɛ ŋ ɡ w ɪ n
pen	p ɛ n
pentyrru	p ɛ n t ə r i
pêr	p eː r
perseiniol	p ɛ r s e i̯ n j ɔ l
perthi	p ɛ r θ i
pert	p ɛ r t
pesychu	p ɛ s ə χ i
peth	p eː θ
phaith	f a i̯ θ
pharoted	f a r ɔ t ɛ d
phen	f ɛ n
phengwin	f ɛ ŋ ɡ w ɪ n
pheth	f eː θ
phinc	f ɪ ŋ k
phobloedd	f ɔ b l ɔ i̯ ð
phont	f ɔ n t
phopty	f ɔ p t i
phrif	f r iː v
phryfed	f r ə v ɛ d
phum	f ɪ m
phur	f iː r
pibgorn	p ɪ b ɡ ɔ r n
pibonwyen	p ɪ b ɔ n u i̯ ɛ n
pib	p iː b
piglas	p ɪ ɡ l a s
pig	p iː ɡ
pinc	p ɪ ŋ k
pîn	p iː n
pìn	p ɪ n
piso	p ɪ s ɔ
piws	p ɪ u̯ s
plant	p l a n t
plastig	p l a s d ɪ ɡ
pleidiol	p l e i̯ d j ɔ l
plu	p l iː
plwm	p l ʊ m
plwyf	p l ʊ i̯ v
pobloedd	p ɔ b l ɔ i̯ ð
poblog	p ɔ b l ɔ ɡ
pob	p oː b
poena	p ɔ i̯ n a
poenen	p ɔ i̯ n ɛ n
pont	p ɔ n t
popty	p ɔ p t i
porchell	p ɔ r χ ɛ ɬ
porffor	p ɔ r f ɔ r
post	p ɔ s d
pren	p r ɛ n
pridd	p r iː ð
prif	p r iː v
profiad	p r ɔ v j a d
prydael	p r ə d a i̯ l
pryder	p r ə d ɛ r
pryfed	p r ə v ɛ d
prys	p r iː s
pum	p ɪ m
punt	p ɪ n t
pur	p iː r
puteindy	p ɪ t e i̯ n d i
pwyll	p ʊ i̯ ɬ
pwynt	p ʊ i̯ n t
pwy	p ʊ i̯
pydredd	p ə d r ɛ ð
pydru	p ə d r i
pyglyd	p ə ɡ l ɪ d
pyg	p iː ɡ
pyjamas	p ə d͡ʒ a m a z
pymthegfed	p ə m θ ɛ ɡ v ɛ d
pymthegnos	p ə m θ ɛ ɡ n ɔ s
pymtheg	p ə m θ ɛ ɡ
pysgod	p ə s ɡ ɔ d
pys	p iː s
pythefnos	p ə θ ɛ v n ɔ s
rai	r a i̯
rech	r eː χ
rew	r ɛ u̯
rhacs	r̥ a k s
rhaff	r̥ aː f
rhagddodiad	r̥ a ɡ ð ɔ d j a d
rhagfyr	r̥ a ɡ v ɪ r
rhaglenni	r̥ a ɡ l ɛ n i
rhaglen	r̥ a ɡ l ɛ n
rhagrith	r̥ a ɡ r ɪ θ
rhaith	r̥ a i̯ θ
rhannu	r̥ a n i
rhan	r̥ a n
rhaw	r̥ a u̯
rhech	r̥ eː χ
rheg	r̥ eː ɡ
rhew	r̥ ɛ u̯
rhif	r̥ iː v
rhinoseros	r̥ ɪ n ɔ s ɛ r ɔ s
rhin	r̥ iː n
rhi	r̥ iː
rhith	r̥ iː θ
rhiw	r̥ ɪ u̯
rhodia	r̥ ɔ d j a
rhodio	r̥ ɔ d j ɔ
rhodiwch	r̥ ɔ d j ʊ χ
rhodri	r̥ ɔ d r i
rhod	r̥ oː d
rhofio	r̥ ɔ v j ɔ
rho	r̥ oː
rhos	r̥ oː s
rhosyn	r̥ ɔ s ɪ n
rhudd	r̥ iː ð
rhufeiniwr	r̥ ɪ v e i̯ n j ʊ r
rhuthro	r̥ ɪ θ r ɔ
rhwng	r̥ ʊ ŋ
rhwyfo	r̥ ʊ i̯ v ɔ
rhwyf	r̥ ʊ i̯ v
rhwygo	r̥ ʊ i̯ ɡ ɔ
rhwyg	r̥ ʊ i̯ ɡ
rhwyll	r̥ ʊ i̯ ɬ
rhyddhaf	r̥ ə ð h aː v
rhyddid	r̥ ə ð ɪ d
rhydd	r̥ iː ð
rhyfedd	r̥ ə v ɛ ð
rhyfel	r̥ ə v ɛ l
rhywiol	r̥ ɪ u̯ j ɔ l
rhyw	r̥ ɪ u̯
rif	r iː v
rod	r oː d
roedden	r ɔ i̯ ð ɛ n
roeddet	r ɔ i̯ ð ɛ t
roi	r ɔ i̯
ro	r oː
rw	r ʊ
rwyt	r ʊ i̯ t
ryddhaf	r ə ð h aː v
ryddhau	r ə ð h a i̯
rydd	r iː ð
rygbi	r ə ɡ b i
ry	r iː
rywun	r ɪ u̯ ɪ n
saer	s a i̯ r
safbwynt	s a v b ʊ i̯ n t
safle	s a v l ɛ
saith	s a i̯ θ
salamandr	s a l a m a n d r
sallwyr	s a ɬ ʊ i̯ r
salm	s a l m
saltring	s a l t r ɪ ŋ
sant	s a n t
sawl	s a u̯ l
sbaeneg	s b e i̯ n ɛ ɡ
sbaen	s b a i̯ n
sbectol	s b ɛ k t ɔ l
sbwriel	s b ʊ r j ɛ l
sef	s eː v
seiclo	s e i̯ k l ɔ
selotep	s ɛ l ɔ t ɛ p
serch	s ɛ r χ
sêr	s eː r
sesiwn	s ɛ ʃ ʊ n
sgandinafia	s ɡ a n d ɪ n a v j a
sgarff	s ɡ a r f
sgert	s ɡ ɛ r t
sgîl	s ɡ iː l
sgìl	s ɡ ɪ l
sgiwen	s ɡ i u̯ ɛ n
sgôr	s ɡ oː r
sgrech	s ɡ r eː χ
sgwâr	s ɡ w aː r
shibwnsyn	ʃ ɪ b ʊ n s ɪ n
shwd	ʃ ʊ d
siaced	ʃ a k ɛ d
siân	ʃ aː n
sillgoll	s ɪ ɬ ɡ ɔ ɬ
sil	s iː l
siôn	ʃ oː n
siopa	ʃ ɔ p a
siop	ʃ ɔ p
si	s iː
slej	s l ɛ d͡ʒ
smygu	s m ə ɡ i
snwcer	s n ʊ k ɛ r
stopiem	s d ɔ p j ɛ m
stopio	s d ɔ p j ɔ
stopi	s d ɔ p i
stryd	s d r iː d
stŵr	s d uː r
swllt	s ʊ ɬ t
sŵn	s uː n
swnt	s ʊ n t
swper	s ʊ p ɛ r
swyn	s ʊ i̯ n
sw	z uː
sychu	s ə χ i
sylfaen	s ə l v a i̯ n
sylffwr	s ə l f ʊ r
sylwi	s ə l w i
symudliw	s ə m ɪ d l ɪ u̯
syrthio	s ə r θ j ɔ
tad	t aː d
taen	t a i̯ n
taeog	t e i̯ ɔ ɡ
tafarnwr	t a v a r n ʊ r
taflod	t a v l ɔ d
tai	t a i̯
taith	t a i̯ θ
tâl	t aː l
tân	t aː n
tâp	t aː p
tarian	t a r j a n
tatŵs	t a t uː z
tatŵ	t a t uː
tawa	t a u̯ a
tawel	t a u̯ ɛ l
tawe	t a u̯ ɛ
taw	t a u̯
teg	t eː ɡ
teigrod	t e i̯ ɡ r ɔ d
telynor	t ɛ l ə n ɔ r
terfyniad	t ɛ r v ə n j a d
terfynol	t ɛ r v ə n ɔ l
terfynu	t ɛ r v ə n i
tewach	t ɛ u̯ a χ
tewed	t ɛ u̯ ɛ d
tew	t ɛ u̯
teyrn	t e i̯ r n
tgau	t ɡ a i̯
thad	θ aː d
thalcen	θ a l k ɛ n
thal	θ a l
thâl	θ aː l
thân	θ aː n
thaw	θ a u̯
theigrod	θ e i̯ ɡ r ɔ d
theigr	θ e i̯ ɡ r
thei	θ e i̯
thewed	θ ɛ u̯ ɛ d
thew	θ ɛ u̯
theyrnaddoliant	θ e i̯ r n a ð ɔ l j a n t
thi	θ iː
thorrent	θ ɔ r ɛ n t
thorrid	θ ɔ r ɪ d
thor	θ ɔ r
thrawant	θ r a u̯ a n t
thre	θ r eː
throes	θ r ɔ i̯ s
thrwydded	θ r ʊ i̯ ð ɛ d
thud	θ iː d
thu	θ iː
thŵr	θ uː r
thŷ	θ iː
tir	t iː r
ti	t iː
titr	t ɪ t r
tiwb	t ɪ u̯ b
tlawd	t l a u̯ d
tlws	t l uː s
toddf	t ɔ ð v
toes	t ɔ i̯ s
ton	t ɔ n
torheulo	t ɔ r h e i̯ l ɔ
torra	t ɔ r a
torrem	t ɔ r ɛ m
torres	t ɔ r ɛ s
torrid	t ɔ r ɪ d
torri	t ɔ r i
torsen	t ɔ r s ɛ n
torth	t ɔ r θ
tor	t ɔ r
traddodiad	t r a ð ɔ d j a d
trais	t r a i̯ s
tra	t r aː
trawant	t r a u̯ a n t
trefgordd	t r ɛ v ɡ ɔ r ð
treiglad	t r e i̯ ɡ l a d
trên	t r eː n
tre	t r eː
trist	t r ɪ s t
tri	t r iː
troen	t r ɔ i̯ n
troes	t r ɔ i̯ s
troet	t r ɔ i̯ t
troid	t r ɔ i̯ d
trois	t r ɔ i̯ s
troi	t r ɔ i̯
trôi	t r oː i̯
troli	t r ɔ l i
trom	t r ɔ m
tros	t r ɔ s
tro	t r oː
trown	t r o u̯ n
trwsgl	t r ʊ s ɡ l
trwydded	t r ʊ i̯ ð ɛ d
trwyth	t r ʊ i̯ θ
trydan	t r ə d a n
try	t r iː
tsimpansî	t ʃ ɪ m p a n z iː
tud	t iː d
twll	t ʊ ɬ
twmffat	t ʊ m f a t
twndish	t ʊ n d ɪ ʃ
twrch	t ʊ r χ
twr	t ʊ r
tŵr	t uː r
twymyn	t ʊ i̯ m ɪ n
tybaco	t ə b a k ɔ
tybio	t ə b j ɔ
tybiwyd	t ə b j ʊ i̯ d
tydy	t ə d i
tyfu	t ə v i
tymor	t ə m ɔ r
tyndra	t ə n d r a
tynnu	t ə n i
tyrru	t ə r i
tyr	t ɪ r
tyst	t ɪ s d
tŷ	t iː
uchelwydd	ɪ χ ɛ l w ɪ ð
ufelai	ɪ v ɛ l a i̯
ulyfai	ɪ l ə v a i̯
undeg	ɪ n d ɛ ɡ
uniawn	ɪ n j a u̯ n
un	iː n
utgorn	ɪ t ɡ ɔ r n
uwchben	ɪ u̯ χ b ɛ n
uwd	ɪ u̯ d
wain	w a i̯ n
wair	w a i̯ r
wario	w a r j ɔ
weld	w ɛ l d
wella	w ɛ ɬ a
wel	w ɛ l
wennol	w ɛ n ɔ l
wfft	ʊ f d
win	w iː n
wiwer	w ɪ u̯ ɛ r
wlad	w l aː d
wnsach	ʊ n s a χ
woc	w ɔ k
wrth	ʊ r θ
ŵr	uː r
wybr	ʊ i̯ b r
wychach	w ə χ a χ
ŵydd	ʊ ɪ̯ ð
wyddion	w ə ð j ɔ n
wŷdd	w iː ð
ŵyl	ʊ i̯ l
ŵyll	ʊ i̯ ɬ
wylo	ʊ i̯ l ɔ
wŷn	w iː n
wyn	w ɪ n
wyres	ʊ i̯ r ɛ s
ŵyr	ʊ i̯ r
wŷr	w iː r
wysg	ʊ i̯ s ɡ
wythfed	ʊ i̯ θ v ɛ d
ychen	ə χ ɛ n
ych	iː χ
ychwanegiad	ə χ w a n ɛ ɡ j a d
ydfran	ə d v r a n
yf	iː v
ymarfer	ə m a r v ɛ r
ymdeimlad	ə m d e i̯ m l a d
ymherodr	ə m h ɛ r ɔ d r
ymlacio	ə m l a k j ɔ
ymyl	ə m ɪ l
yna	ə n a
yn	ə n
yng	ə ŋ
ynn	ɪ n
yr	ə r
ysbyty	ə s b ə t i
ysgawen	ə s ɡ a u̯ ɛ n
ysgaw	ə s ɡ a u̯
ysmygu	ə s m ə ɡ i
ystad	ə s d a d
ystifflog	ə s d ɪ f l ɔ ɡ
ystradwel	ə s d r a d w ɛ l
ystyried	ə s d ə r j ɛ d
ysu	ə s i
yw	ɪ u̯
